F K Z B P X A | P B A F Z X;K
P E Q R C N S | S P Q E C R;N
Z M I P R W X | Z M W P I X;R
F J A Y E I S | J Y I A E F;S
C A B D Z L Q | L Z Q B C A;D
Q F S W E I B | W S E I Q F;B
L R S N F X Q | Q L S F X N;R
F S Z W K B Y | K S Y Z F B;W
S H V D F J B | J H B V S D;F
F P N W C S L | C N F P L W;S
K F R N H I J | R H K I J F;N
U R A K S W L | U K L A R W;S
U M W T S A V | U M W S V T;A
I G A U V M X | A I V U X G;M
L H E Q N P T | T H N L P E;Q
V C P A U T X | T X P A C V;U
P B L N X Z R | X Z P N L B;R
T Q I D S E Y | T E Q Y S D;I
G B Z E X H W | X E G Z H W;B
B U E G F Y N | E N U F B G;Y
P J W F I S D | S I W D P F;J
C Y K G X V H | H C Y G V K;X
R I E S K T Z | I R Z K S E;T
B O Q S L K H | B O Q K L H;S
N V G O M Z Y | N Y O M G V;Z
H E B F G I O | G F E H O I;B
Y L U G D Z I | D Z G Y U L;I
P X W J D L Y | Y J X W P D;L
R E K F T P M | R P E K T M;F
D E O S P C F | P E S D C F;O
I E K M C P J | M K E I P C;J
M S L Y P O V | M Y O V S P;L
G D Q Z U X L | X G L D Z U;Q
X J V F T Z W | F W J V T Z;X
A E M S B J Q | E M Q B S A;J
N J G Z M W U | Z J U W M G;N
W V Y O A E Q | Y E O A V Q;W
Y D O G K W R | D W O G K R;Y
M E N S K L Z | L S M K E N;Z
A F Y C I W T | W C I T F A;Y
L Q I P Z N A | A L Q P N Z;I
Z H Y N O T A | A N T H Z Y;O
R Z Y J Q W O | Y Q R O W Z;J
X Z L C R K Y | X L Z C Y K;R
D R L Y B C M | L R C B D Y;M
I M E U S C G | U E I S C M;G
B K A H I E Q | A I H K B E;Q
Y E O K V R P | O V R P E Y;K
I Y M K B Z W | B K I Z W M;Y
Y M I W J N H | J Y I N M H;W
K Q Y J V O S | J V K Y Q S;O
R I J V L B D | R B L D V I;J
M N F I Z Q E | M N E Z F Q;I
C V N O T H E | H N E C V O;T
R O W M Y Z U | M Z W R U O;Y
S N T Z B I K | K B S N I T;Z
K R Y B S J H | S H B Y K J;R
R Y Q F E S P | F S Q Y R E;P
P O Y S M D W | S W Y D P O;M
C L Y P K B N | K Y N B C P;L
C R L B E V S | E B S L C V;R
Q W J Y S Z D | Y D Q J S W;Z
R S N X V T G | G S X R T V;N
B F X G V D Q | V G D B X F;Q
M A J F U O B | B F U J O A;M
Y G O J Z R A | Y R Z A J O;G
M A I X W J D | W J A M X I;D
C Y Z J R M G | G J R C M Y;Z
V C E A J O P | A O C P V J;E
I L F O R H J | J O L F I R;H
N U L O W E T | N T E L U O;W
N C I Y A P S | I C Y N S A;P
Z N D K C G Q | K Z D N Q C;G
X F I L H Z P | H X F L I P;Z
S C U X Y Q W | C X W U Y S;Q
L C Z Y N F W | C N F W L Z;Y
K D C T G Z S | Z C G D S K;T
C D Q M V N K | N Q M V K D;C
O W F R Q N V | Q V N W O F;R
T P U S Y I J | J T Y P S U;I
B I Z M Q O X | Z I B O X Q;M
G C T Y D W N | N D C Y G W;T
E I Q Y R O L | I R L O Y E;Q
Z F K O U W D | U K Z D F W;O
A Q H F U S Z | H F U Z A Q;S
F D Y G U O M | U O F Y D M;G
C K Y D J R I | R D Y C I K;J
L A J Y D N S | S A N Y J D;L
F J V K A B Q | Q J K A F B;V
S W O F A N M | M W N O S F;A
U R Y G Q I D | D R Y G Q U;I
M X S B I Q P | B Q P X M I;S
N K C R V F O | C K F O R N;V
O E H A Y J T | O J T Y H E;A
X F Y L S A I | L I S Y F X;A
G T L K N R W | G W T L N K;R
Z I U E W O D | O W I Z U D;E
K P X C O F G | F C O G X P;K
J Z E V F Q R | E F J R V Q;Z
N V Y A R C U | U C R A N V;Y
C F J O S H I | I J O S H C;F
G C L X M H S | S H M L X C;G
D E Y V R A S | S V R A Y D;E
W Z Q G U S X | Q Z X W G U;S
R K L Y J Q D | J K R Q L Y;D
C N O G E P Z | Z O G P E N;C
J K E S R D A | D A R S J K;E
B W E Q F K R | W R F E Q B;K
Q J N T H E U | Q T H U E N;J
X K S Y R U W | S K R W Y X;U
R B P D T G L | G D P R B T;L
F M S G A X D | M G S A D X;F
H D P X U A L | D H X L A U;P
G U O N L Y K | O N U G Y L;K
F T O E G Q U | Q O F U E T;G
E D H M K G R | G H E K M D;R
D B X F P Q H | D B F P Q X;H
U E P B K A H | B U K P E A;H
X P U D R A K | U X D P K R;A
B H W X I F Y | I B W X F H;Y
Y E B D G P K | Y K B D P E;G
H G N J F P D | J P D N H G;F
C N S Q H R E | C N H E Q R;S
I J O E R K X | E X I R K O;J
M O P V C K X | C X O V P K;M
P Z S B T F W | B Z T S F W;P
O V R P N Z C | C N P Z V O;R
O T N S W Y P | Y N O W S T;P
U S V E D F T | T V U D F S;E
V M U K N Q G | K V N U M Q;G
U I P G D M N | M U D N G P;I
Y O Q M W F A | Y F W O M A;Q
E V W J D P O | E W V O D P;J
G N Z M P E R | P M G Z R N;E
P R O Q G J X | Q G O X P R;J
Z Q O K E S D | D S O Z E K;Q
P Y U M O X Z | Z Y O U P X;M
F Z G M J K N | Z G N M F K;J
O I A U P W X | W A O U I P;X
V G Z B S C D | D G S V Z B;C
X Z C O M I V | X I O Z C V;M
D O R N P I S | O S I D P R;N
A Y O M Z N R | O M A Y N R;Z
I H T C Y K X | T C H X I K;Y
R V E C W O Z | W V Z C O R;E
D T M J X W U | U J W T D X;M
Q V O Y M P F | Y P O V M F;Q
G W T S D N L | G T D L S N;W
R F K T M L Z | L R F K Z T;M
B Y J D V A T | A T Y B J D;V
E J D Q C T I | E I D T C J;Q
X G P C I Q E | X I G E P Q;C
Y V K C G B X | V G Y K B X;C
F H Y E U X A | H A E X U Y;F
X N Z W V F B | W N B X V Z;F
F I P M Q O U | I U M P O Q;F
A E F U R B Q | U E R F B A;Q
Y M V F Q D X | D V F X M Q;Y
K P N Y O W D | D O K P Y N;W
F A V R H P M | M P R H F V;A
Z D C L Y T W | L C Z T D W;Y
B G O E T M X | B M X O E T;G
U I R F C L P | F I R U P L;C
C V Z U W K Y | K V U Z W Y;C
T C Z D F E R | T Z E D C R;F
N H R Y O U M | O H U Y N R;M
A F X U Z O Q | F X Q O Z U;A
D Z Q N Y G B | Q N G B Z D;Y
C A G Z W V H | Z A H W V G;C
D B A P I E L | I L E D A B;P
I K C H W X Y | C H W K I X;Y
L Q U D N E W | N E L W Q U;D
V U O G J X L | V J X U L G;O
P X Q K O G A | X K Q P A O;G
E K Q X P B Y | E B K Q Y P;X
R I T N Q C H | T I H R C Q;N
J N V O X Z P | V P X Z N J;O
Z O Y B M G D | G M D B Z O;Y
H I N C P M F | C H F N P M;I
E Z I F G P H | I H P G E F;Z
F E K R I C A | E C F K R A;I
T E K Y C G R | Y K C G T R;E
U R S E Z L I | L E U I Z S;R
E Z A T I F C | I A T F Z E;C
W O L X S R A | L X A S R W;O
D Q M N W X S | Q S M D X N;W
G J C M N A B | J M G N B A;C
G F X Q R I C | G X Q F R C;I
J W T O L V F | V W O F L T;J
X O R Q K V S | R K V O X S;Q
H J R V O M L | M V J O L R;H
Y W M B N X P | P Y W N X B;M
O I M B W L U | M W B U O L;I
C G L J H X Z | X Z H J G C;L
O B A V P M N | B P N V A M;O
S D L X N U O | D X L U S N;O
M X C L U F I | X U F I M C;L
H S T F O D B | D B F O H T;S
J E L N U K M | M U K J L N;E
G W B M R O V | V R O M W B;G
A B W C Q E Y | E W Y B C Q;A
T Q R W G L V | Q R W T G V;L
R U C B E X Q | U E R C B Q;X
H S L K E C Y | E C S Y H L;K
M X U S G C T | T S M C G X;U
N V J A W K Q | W A V K N J;Q
N U I T W Y V | U N T Y V I;W
Q B D T U W P | U D T W B Q;P
K P E V S N R | V N S P K E;R
W L S D B G O | W O L D B S;G
B O X G K R N | O B N G R X;K
U W Q F M I R | I M Q U F W;R
J S N K R T X | J X N S R T;K
N Y G R Q P S | Q G N P S R;Y
A H G B U P D | A G P H B D;U
F P R A X Q K | P R A F X Q;K
D P O G W S J | G S W O P J;D
S X I U O R K | R O K I X U;S
W H A I E T V | T W I H E V;A
P X N B C E Z | E P X N C B;Z
B A E H S O N | H O N A E B;S
C I U D V Q F | I Q C F V U;D
B D K M L J E | K B M E J L;D
J A Z B W E U | W U Z J B A;E
J L D Y R W Z | Z Y L J W D;R
W T J I A Z Y | Z I A W T Y;J
N P W U Q D K | D N W K U Q;P
U G M W D Q L | U L Q M W D;G
V Z R E G J Y | Z G E J Y V;R
C G V F K A O | O C G A F K;V
W K H C E D T | T C D E W K;H
B X Z L S D H | L X S H B Z;D
F D W J B M Y | Y B W D M F;J
P I T Z V Q G | P I T V Z G;Q
M E Z Y U J N | N E U J Y M;Z
U S H G X O E | X O E G U H;S
F S H L G Y I | H L F G I S;Y
I H Z V C O J | V C Z J I O;H
G O T Z Q V L | L Z G V T Q;O
W P G R N B J | W B R G N J;P
O Q L F N H U | F L O Q H N;U
F A N B I H W | H W B F N A;I
M Q I Y F O V | O Q I M F Y;V
A U P Z D C H | U H A Z P C;D
N D L J Y T O | T N Y J O D;L
C E X B Q D A | E D A Q B X;C
L N D B F P K | K N F B L P;D
A N U I V M X | U X V M I N;A
L E H V Q P I | E H P L Q V;I
N I V S W Q F | V Q W N S I;F
D W E B T H P | H B W D P T;E
R X K G H J E | E H R K G J;X
G A K Q E C M | K E C Q G A;M
I P X E G H R | E R P H X G;I
D A L Y S R Q | L S Q A D R;Y
M A F Q N Z X | N Q X M A Z;F
G L Z B I K W | Z K B I W G;L
D H Q S C I T | Q H T D C I;S
Q X C V S P G | C Q S G X V;P
H U O Z W M T | O U W Z H M;T
L W S P J Q C | J L W S P Q;C
V Q A P T N E | T N Q A P V;E
U X D O Y R I | I U O D Y X;R
U P B C T A X | X P C B U A;T
R O E N L Z V | Z L R V N E;O
K P C J Y Z T | K T C P J Z;Y
N B M I D H G | N M I G B D;H
X K T I A B V | I T V X B A;K
P T Q N V W O | O V T Q N P;W
K R Z U H V M | U H M K R Z;V
K Y R G M D H | M K G Y R H;D
S L R T K G I | S K T I R G;L
P O H S W A Q | S P W Q H O;A
Y V I K Q F T | K Q T I V F;Y
T Q N V S X H | H T S Q V N;X
U A S H W B R | S A H R U B;W
K F A M T Z I | M Z A K I T;F
L E T S K J M | E L J T S K;M
F Z M X P R D | F R X Z D M;P
W I S B L A E | W I B L E S;A
V G N H O E P | G V N O P E;H
I U W O H K C | K W U O H I;C
F D K A N Z R | A K Z F N R;D
S H J O K I L | S H J O L K;I
F G W U P V L | P F V U L G;W
C P J L S Z U | P S L U J Z;C
F K V O R Z N | K F V N Z O;R
L W A M V Q B | Q A M V B L;W
M Q I H P V T | M H Q I T P;V
V U G D E W M | U E W M V D;G
O V P Y T I R | Y P R T O V;I
N E Z A H X C | X E H A Z C;N
Q B S M J P R | B S P M J Q;R
P U K J R B G | R U B G P J;K
A U N D C V P | C A U V P N;D
D U R K C N A | K R D N C A;U
T S M O L N W | T L O M N S;W
X Y I P Z S T | T X P Y Z I;S
I K G H X U R | R G H K X I;U
A U Z I N W D | W N A I D Z;U
Q S D R V N J | Q N D J V R;S
L Q P Z X C R | L X Q R C Z;P
K D F P B X O | K D B O P F;X
P A O W H C B | C H B O A P;W
H E L V F N S | S H F V E N;L
L X W K I Z M | M I K X Z W;L
H L I K V C E | L E K I V C;H
P Q C S I B R | Q B P I S R;C
S A L T C E J | A T E L S J;C
W H F Q V S R | W F S V H Q;R
L X A H V Z S | Z L X S H A;V
G O M Y L I Z | O L M I Y Z;G
Q K S B F R J | F K Q B S R;J
H A Y G C W B | G Y B H C W;A
A P R D B U T | T D U B P R;A
B E T O J X N | B X E N T J;O
I W L K J S A | A W S I L K;J
V R T N O B D | R N D B T O;V
D Y O M R Z N | R M Z O Y D;N
Y V B W R J L | V Y B L W J;R
Y Z D B S I N | N I S Z Y B;D
G L I C P M S | P S M C L G;I
N H O G Z E B | O E Z N H G;B
V P X Q I B U | V I U B X Q;P
M B C D O K V | K B O M C V;D
E U H K L J N | K J E U L H;N
A G S P H F D | H F P G D S;A
G T M H K Q N | G M Q T N H;K
F S N R V J H | V H R S N F;J
P T M F O A Z | P Z F A O T;M
K Z E C T D U | C D U K T Z;E
K O D J G Q A | O Q J K G D;A
H P W Q G K D | D P Q K W G;H
K J P I A F X | A F J I K P;X
N J O K G R U | J N G K U O;R
D S G H A M Y | Y D A S G H;M
D K R P W Q C | W K D C R Q;P
L W K D Y S J | W K Y J D S;L
O Z P H Y G K | O P Y G K Z;H
M X W Z B Q N | B M Z Q W N;X
F E O D N G X | F G D O X E;N
V S A I N T H | V N S I A H;T
Y P N J D R O | N J P Y D O;R
D C W K V Q A | K C D Q A W;V
K Y T S W L G | Y K W T S L;G
E I T B P W C | B W C P T I;E
V H C S I U G | G U C S H I;V
B I V G D Q O | B O I V D G;Q
T Y U O M L R | M T U Y O R;L
U Q C H V R X | Q R X C V H;U
Q N T R V J E | V E N Q R J;T
M W F A X O S | X F O W S M;A
R F J W Y E I | E J F R Y W;I
C V N R M L D | C D L R M N;V
Y H U S W G Z | H S Z Y W G;U
Y W R G M Q L | R M G Q L W;Y
E A M H S D N | D N S E M A;H
K M O P I Z D | K M O Z P D;I
I S E H A L G | G H S I L E;A
P E K Y A X W | X A K Y E W;P
C G W Q B I Y | W C Q I Y G;B
K V E O W S X | E O W V X S;K
N O B H X M F | X M B F N H;O
S K Y U B H R | U Y S R K H;B
B Z F J I R Y | Z B Y I F J;R
Y X E O N B U | E X Y O B N;U
B W Q L C I K | W C I Q K L;B
D I H Z B A T | D B T H Z I;A
T L P M V U R | T V R P L M;U
Y U K C G L T | K G L T U Y;C
X U H E D F I | H U D E X F;I
K N Q R L H F | L F N K R Q;H
A M D W O R S | S O R D M A;W
O R T B K N P | N T B R P K;O
I J S X H P Y | S J X I P Y;H
E V K Y N I M | M I K Y V N;E
D W X H N V E | E H N V X W;D
O P N F T G B | O N T P B F;G
Z F C T E Y M | Z C E M Y T;F
V W H P A O N | P V O H W A;N
P T W C A F G | T A F C P G;W
K X W S A U Y | A W K U Y X;S
D V T Q H G L | Q H T V L G;D
B D N J L A Y | D N Y B A L;J
Z Q E J K R X | K Q R J X Z;E
A U T H L E J | L J E U T H;A
J H L R D Z M | H L R M D Z;J
W V C R N X B | N C W X B R;V
I X S L A O H | S I H L O X;A
E V X T M U B | M U E B V T;X
D V W N C E R | V E N R W D;C
Y D H I L Q P | I Y H D Q P;L
D C V N Y Z L | V D Y Z N C;L
N F O X Q Y G | G Q O X N Y;F
M U O E W X V | E U X W M V;O
Y C P V O L T | T L O Y C P;V
V J U H F Z B | U V B J Z F;H
G R J F M Q X | X Q M J F G;R
Z U O C J W S | W O Z J S C;U
K I M G J H P | G J H I P K;M
B U D J I W M | J D I U W M;B
X B O S P G D | X B P O S G;D
X R I U Y G B | R U X Y I B;G
O Q K P I A G | I O K Q A G;P
I W T M S Q H | H I Q S W M;T
O J E D Y Q C | Y E J O C D;Q
O N B K H U A | O N A K U H;B
Y S U C V W O | V S Y O U C;W
A F M J Y Z R | A J M F Z R;Y
S D M B O H X | S O D B X H;M
G Z J O S D Q | O J Z D G Q;S
I A V G C F M | C A M G F I;V
Z Q S A K W E | Z K Q W E A;S
X K L D U Y A | A Y K X U D;L
R M P B Q J K | K M Q P J B;R
C N G U M H O | O G U H N C;M
U Z G D H C L | H D L C G Z;U
D E A Y I R C | I C E Y A D;R
X T A N D O F | A T D X N F;O
N P I Q G K U | I G N P U Q;K
J W I M U F Q | W U J M F I;Q
N Z Y L G W Q | G Y W L Q Z;N
G C Q M U N O | Q C M G U O;N
Q W B N O V L | O Q N B W V;L
C I R Q J Y T | I J R Q C T;Y
F K R M Z G Y | Z M G K R F;Y
Y J C X A W T | X W A T J Y;C
I W Z H Q M J | I M Q H J W;Z
C G J Q Z H R | G C Z J Q R;H
Z M R L F K E | K L E R F M;Z
D F C W E T R | T R C D W F;E
B V M D N T Z | T Z B D M N;V
V T C A E R G | A V G C R E;T
Z V F P U Y M | P Y V Z F U;M
H N X T C L I | T C X H N L;I
J S C W I K A | S W A K J C;I
T Q Z A C F I | T Z C I Q F;A
Q V S A D T J | Q S T A D J;V
D O F K A V S | V D S O A F;K
G F I Y S B P | P Y F B I S;G
U J V W E L Q | U Q V E J L;W
V Z O H P Q A | A H V P Z Q;O
U G D C W H A | C H G W U D;A
C H U W V B T | T C U V W B;H
F Y Q P C S L | Q F Y L S C;P
G W R X L I K | W K G R L X;I
I L T J W O R | O I R W T J;L
I U H J O R Z | H I O J Z U;R
N E H C W L M | H N M W C E;L
C L H V W D X | X C H V D L;W
C Z U E J K B | E J C U B K;Z
R M N Z W H L | H Z L M N W;R
H S D X N Q V | S D V H Q X;N
L C Q P I D N | L N Q D I P;C
Z N X F S U M | U M F N X Z;S
D T M J O F N | F N D O T M;J
K D E I P U Q | I P D E K U;Q
K B T H W A S | H W T B K S;A
G S H N K U P | G K N P U H;S
F L W J I N C | W J N C L I;F
F Y R M V T U | U F Y M T V;R
E L Z D H M V | L V D M Z H;E
Q J S H C N O | J H N O S C;Q
H R E X W Q P | E W R H Q X;P
C N J I K M F | M N J I F C;K
A K R W E B Y | A B W R K E;Y
H W M Q T L G | M T L W H G;Q
P T Z I R L W | R L W P T Z;I
D G U H R B A | B U G A R D;H
Y G F B E O D | E B O F G Y;D
Q D N A I F O | D Q A I F N;O
O K D A Y U X | Y K D A O X;U
Q C O B T P S | B P C T O Q;S
V B H P E Y D | H D V P E B;Y
G R T E Z L D | E R G L D T;Z
I D A J G X Z | J Z D I A G;X
H W Q M A C K | Q M W A H K;C
H V F E X A C | E X V C H A;F
O R E D H J X | H O R D E X;J
R N L G X Z Q | Q L N G Z X;R
C K S F Q H J | F H K C Q J;S
U Z A P T J R | R U T A J P;Z
E J Q T C P S | J P Q E C S;T
V O X Z E D H | V Z D O X E;H
U L C J I N W | U W L I N J;C
C E S Y R I D | D C R E I S;Y
U X Z H M D Y | H X U M D Y;Z
E H K V U D A | U H A K D E;V
P G N K S A C | A C G P N K;S
X N V R Y W Q | W N R Y V Q;X
G U Y V R J S | Y J U V G R;S
O S G P W U R | S G R U W O;P
U W X R Q A J | R U J X Q W;A
E Q C F B Y X | X F Q C Y B;E
K J Y O P E Q | O E Y J P K;Q
B H U L W Q C | B U H Q W L;C
T H O K P R L | R O H T L P;K
S H X E B U Z | Z X S U H E;B
L Z O G R C F | O G Z L F R;C
Z B R A P E I | I A E P B R;Z
C S L N A W B | N L S W C B;A
J M Y D U G I | M U G Y I D;J
I U T Q P E X | I E P Q X U;T
G Z L P S Q E | Z E L S P G;Q
J H X O Y Z T | Z T X J Y H;O
N T X Z Y O I | T X O Y I N;Z
G C W U Y E H | Y G C H E U;W
I X H T G J R | T R G J X H;I
A W E M K Q N | K W N A Q E;M
W D G F R B J | J B W R G D;F
R P I O L A C | R C P L I A;O
H N W P U V J | W P V U J N;H
R F Q G V L S | V R F Q G S;L
M F B P G I E | F M B I E G;P
A D X Q S K G | A G D X K S;Q
O K H L Y I Q | L O Y K Q I;H
M C F J S O A | S C O M J A;F
J L U Q F X P | Q L X U J F;P
C W Y L G N E | Y G E N W C;L
S Z B Q R P H | Z R P B H S;Q
T I O N L P F | T P I L O N;F
O V K U P D Z | K Z D U O P;V
V J O B P K T | B P T O J K;V
F C X B W Z D | W D C Z X B;F
U D A L S C K | U S C D A L;K
O X Z G U H Y | H O G Y X U;Z
O E R Z L D X | X D O Z R L;E
C N A T U J R | R N A J T C;U
C Q H F W I O | C Q F W O I;H
G S X W F B O | W G B S F X;O
F L H E U X A | U F E L X H;A
Y F C T E S N | S C E Y T N;F
J M K S Z G T | Z K G J M T;S
R J X U E Z G | X R G U Z E;J
O N L F C K G | O K C G F L;N
R D A I W K G | A W R D I K;G
E H X D F V K | K D H F E V;X
Z X O M I T V | I V M T X O;Z
M O K U Y S D | M D Y O K S;U
R K X A M C W | C X R K M W;A
N U Q D K I M | N D U I K M;Q
Y Z I O C B D | D O B Y C I;Z
T M K U G N C | M U T G K C;N
F W O I H L X | L X W H I F;O
U L M W S R D | M S D W R L;U
J U R E P W Z | R U W E Z P;J
T R W V J K B | B R T J V W;K
M I J O Z N D | D I Z N O J;M
Z H O L T I N | O Z H I T L;N
W N B P Z G J | J P W Z G B;N
Z J F M U C Y | Z F C Y J M;U
P L H S C X Z | S H P L X Z;C
B D L R U E Q | U B R D L Q;E
I R J F T B V | R V I B T F;J
Q N U W S B O | W S O Q U B;N
J T V E M H N | H J E M N V;T
T K W L G D M | T M D L W K;G
H L P E U O G | H E P O L U;G
D Q J O Y E C | O Q J C Y E;D
X L F H K M W | M F W K L H;X
P V X N Y A U | V X A P U Y;N
V L G W B U X | B W G V L U;X
F O D S R I Y | R O Y D S I;F
D J B Y N X T | X B N J T Y;D
H Q D O L M X | L O X H M Q;D
A Y J G X P O | P J Y X O G;A
R V S C Z Y X | X Y Z S C R;V
N C I K W V U | W V I U N K;C
K I G J Z X C | I G C X J Z;K
D Z S U K G F | K U G F Z S;D
P Z V B G L M | Z V B L M G;P
W P T M N V Q | N M V P W T;Q
B S Z W T U O | O S Z T B U;W
S U I F Z A V | F S Z V I A;U
H L Q W G I E | L Q I H W G;E
D A K R Q E O | R K E A D Q;O
C O I J R B V | I R B O C J;V
V B K A P R Y | P V B A Y R;K
O J V C X S U | X V U C J S;O
A O N D G Y Z | O D A Z N G;Y
Q U B E Z N O | N E Z Q U O;B
F E W P Z G H | F Z G H P E;W
K C O Q V S H | C Q H V K S;O
G Q Z O N V B | G Z Q O B V;N
G N D M S K O | S O M G N D;K
A U Y X P L T | L A X T U P;Y
Q V I Z W U P | U I W V Q Z;P
A F R L Q Y W | Q R W F Y A;L
T E N S A K O | O N E T A K;S
E Y T B O Z R | Y E R T Z O;B
A Y K E R F N | Y F K E N A;R
P C G R V W S | G V P S R W;C
A V J E P F G | F A P G J E;V
D T P A W Y J | J W A D T Y;P
A H O Q X S E | O A S H X Q;E
Z B P O F T S | Z F O B S T;P
L S D Z N Y C | C N L Y D Z;S
V X Y Z N M C | C Y M X N V;Z
J E S W D P C | W J P S E D;C
N B V U J X C | B C U J X N;V
B A Z K U V Y | Z A V B Y U;K
D A K Y E V O | E A K D O V;Y
F Q U Z E R X | R Z F X Q U;E
Y Z K J U F V | V Z Y F K U;J
S G T Z A P J | J A S Z T P;G
G K Z H J A P | J H Z A K G;P
U S E D F P C | C P U E D S;F
Y L P W J E Q | Y W Q P J L;E
I L O J E B A | A B I L J E;O
C T R A W E Z | A T Z E R C;W
Z I E F K P X | K I P X E F;Z
J F A R W K Y | J R Y A W F;K
U A C B Q T Y | U Y T B C A;Q
Z H T O F R D | T R F D H Z;O
N T H Q C V P | Q P H C T V;N
P D X J T G S | D J P X T G;S
S U P O E Y T | O Y T U E P;S
V C F D P B G | D V C F G P;B
G S Y W Q I M | I M G Y S Q;W
A U V W L Z S | A W S Z U L;V
O R Z S J C N | J R Z C S O;N
J S A D R F Q | D J F A Q S;R
K E W B M P Z | Z M E B W K;P
X Y R U V C D | R X Y V U D;C
X F O J S B V | J S B X O V;F
Z K E V Y F J | Y V J F E Z;K
V P M N Y H D | H D Y V P N;M
C Q I T F E D | T I Q E F D;C
Z F M W T A C | A M C T W F;Z
B Z H X A D C | H Z B C A X;D
H Q R J Z N A | Z J R N A H;Q
X J K L Z E D | E D L J Z K;X
A E R N J H Y | R J Y N E A;H
U H N O V S R | N V R S U O;H
Z Q R I A S G | R Z I G S Q;A
R G W K S P A | K R P S A G;W
U Z K H X N A | N K Z U A X;H
W B U A C D Y | B Y C D W A;U
S A P N Q D T | P A S T N D;Q
G F S C I W U | S U C F W I;G
N I T X Q W Z | Z I T N W X;Q
K H Q C T F M | T C H F M Q;K
B X Y A C V U | B V U Y X A;C
U K S C R Z W | U Z S K R W;C
F K E C Y W I | C W K E F I;Y
D W T B A L Y | Y T W B D A;L
F L M J H Z B | J Z B H L M;F
G J N P K I S | K N G I S P;J
S P O C W R T | R O W P S C;T
B J Y D W K X | X D Y K W J;B
K X F G A U O | F A U K G X;O
L O D F Q Y X | X F Y L Q D;O
U G O P J D X | G O X P D J;U
L X S C H Z F | Z L H C S X;F
W D C U L V N | C N V U L W;D
G B R N P Y E | Y B G R P N;E
Q T X C W G I | X I G C T W;Q
M Y X Z A N K | Z A N M K X;Y
Y D P B E U K | Y B K P D E;U
T W O A S Y F | O Y A S W F;T
V K L S R W M | K W S M L R;V
A J T O I U Z | O I A J T Z;U
E W Q X U Z G | W E G U X Z;Q
C Z M N Y H E | E Y Z H N M;C
B R J G A V N | B G J V N R;A
K O R Z U W C | W R U Z K O;C
J Y B A T N O | T O A B J N;Y
G S C Y I N Z | S Z I C N G;Y
H F I N O A Y | F N H I Y A;O
P E S Z N I K | E S P K I N;Z
I T Z K Q A S | I S T Z A Q;K
V J E K X A H | X E K J V A;H
Y J D A E S G | G S A D E Y;J
A T F Y K N J | K A F T J N;Y
Q C X B Y W Z | W X C Q Z B;Y
Q X T M A F L | F X A Q L M;T
U D Q L O M T | M Q O U L D;T
B A Q R I Z F | Q B R A F I;Z
M L F O Q I W | Q I W O F L;M
T L R E I K N | R L T K N I;E
U A Y E H V M | Y E H A V M;U
U R M L X G H | H L X U G R;M
O C D U A W V | O D U A C W;V
Q G E K F N O | N E O G K Q;F
V F B C M N K | V B C K M N;F
E S I V P R Q | I P S R E V;Q
D O C Y X F V | D F C V X O;Y
Y V G S F E H | S G V H Y E;F
K N O H T U L | T U H L K O;N
O K P D B S E | S D O B E K;P
A R M T V S D | V A S D T M;R
K B X F V N O | X O B V N F;K
B W H S E G M | W S H G M B;E
N D L B A S M | M D N B S A;L
K G B W X S C | C G W X B K;S
P D O J Q M S | Q S P O M J;D
Q S M Z K W X | S M Q Z X K;W
P E K B U R N | R N E K P U;B
D B H U P T Z | Z P T U D H;B
V C Y H I Q K | K H Y V C Q;I
I R L T K W B | W I L R T B;K
R A I W D U J | A D R U W I;J
I Y D G T U F | Y U G I T D;F
C S N O J E A | N J C E A S;O
Z V H B F A Q | V F Z A H Q;B
O D V Q M I C | O M D C V I;Q
I D W Q T R Z | Q T W D Z R;I
J B A U W Z F | B J W Z A U;F
I Z C W K R D | I Z C K D R;W
P G Z K R C A | A Z C R G P;K
Q D K M Z G L | D Q M K G L;Z
J B O F G U A | O J B G A F;U
R D I P U H M | I U P D H M;R
G R E F U J P | F P E R G U;J
T D A P U V R | D T P V A R;U
Q C S L K V F | S F L K V C;Q
M C S V D A Q | Q S A V D C;M
V D L P O S F | O D L V S F;P
J C Z T R K L | R K T L C J;Z
Y S R T E X P | P E X S R T;Y
H U O X K R A | U H R A O X;K
T M N E Z O L | N E T M Z O;L
Y D Q N F P O | P F Q D N Y;O
J Z K R W V B | J V Z B R K;W
D H M O E Y I | E Y O D I M;H
A H T U X I S | X U A S H I;T
O A S K W D U | D U A K W O;S
G H Y B W O T | O G Y B H W;T
D P N I F T L | L T F D P I;N
I Y P E O X L | X E Y L O P;I
N V U S T M J | S U T V J N;M
R I T C H Q O | T Q C H O I;R
Q X K O A T U | O A X U K T;Q
X F Q O C M P | F Q P M O C;X
J Q E X R F W | X Q W F R E;J
P I F O H B M | B F P I H M;O
C G A L Y E U | A E U C G Y;L
T X W D M H Q | X Q D W H M;T
A N V O K Z S | Z S K N V O;A
M O I Z Y H L | Y I Z M H O;L
Y D F U O N J | F Y D U N O;J
H K F A Y T V | Y T V H K F;A
G E C L K Y X | C X Y L G E;K
I C T P K W S | S P T I K C;W
Q Z I M B E X | B Q M E I Z;X
Z P A O I H R | R P A O Z H;I
W I P M T O D | T O W P I M;D
R H Q G T J P | Q G P R H T;J
Z T F W H N Q | H N W T Q Z;F
W C Z M Y P E | M Y E C P Z;W
Q G A Y V O R | Q G V Y A R;O
F V L S C A G | G L S V A C;F
U K F Y B W Q | B K Y Q U F;W
R Y S B P N V | V R S N Y B;P
K L Z G M F I | K L F M G Z;I
B S N P Z K F | F B K Z S P;N
B X C D K I G | D K G I C B;X
B S W X L U V | L X V U W S;B
F P D V M J Q | M P D Q V F;J
E I K P J Q S | S J Q P K I;E
M R I J K H A | M K I J H R;A
O Y M C Z G A | G C A Y O M;Z
A Q X T Z K B | B A Q K X T;Z
N F O P D K X | K X N D P O;F
E F L B P Z D | F Z B L P E;D
B D V F Y P N | Y F P B D N;V
Y N W D F P I | I Y N P F W;D
V B E F T M P | F V M T P E;B
Z E N U G T B | U Z B G E N;T
J X F S H Z A | S F H J Z X;A
B E X C D H T | B T E D X C;H
L X C U I J K | L U K J C I;X
U G S V R I H | S V G H R U;I
S M B P I G U | B S G M I U;P
J G W A X R M | M W X J R A;G
O M E U L Z I | O E I L M Z;U
X E K Z D U H | D X H Z E K;U
E B H Q A R P | R B Q A H P;E
I G C A L K J | A K G I C J;L
C P Q X R S V | C X S Q P R;V
D A P N I Z B | P D Z A N B;I
N F V D Q B Z | N Z V D B F;Q
W T G O I K U | I G W U T K;O
A Y G H V N W | G V Y A N W;H
N G Z O C S Q | C Q N O G Z;S
B F N P Z E L | P N F E Z L;B
I Q K L A J N | L Q I A N J;K
U K B P W T Y | P U Y W K T;B
H O X T B E U | X E T O B H;U
I F P Q M N Z | M P F N Q I;Z
V N R T S Q A | N Q T S V R;A
D M S Z K E B | B K E D M Z;S
Z D G B H A Q | B Z Q A G H;D
D U Y C Q M J | Y U Q C M D;J
S M D A L V N | M V D S N L;A
U S G P W T B | W S G U P B;T
C Q Z S U A V | U Z Q V A S;C
A X B J U I O | J X O B A I;U
F U W M R I S | W S R F U I;M
K N M L Y P R | N Y M L P R;K
G C H O T V P | V C H P G T;O
W I D M V J G | D M G J V I;W
R N Z W D G O | W Z O N R G;D
P C D U Y Z R | C U P D R Z;Y
V I Q L D X F | I F Q X D L;V
X K R S I Q F | R X F S Q K;I
P L E N U T K | K T P E L U;N
I N V A P D O | V P A I D N;O
W L V D T S H | L S W D H V;T
U X K P N G A | A K U X G P;N
F I O A D C V | F A O V I C;D
Q O X K N U F | F N X O Q U;K
A E N V H R T | T E H R N V;A
A L U M B E Y | A B U Y E L;M
N S H Y D W A | S N Y D H W;A
E O R L Y X U | E Y L U O X;R
Z M V W N P L | L W Z M P V;N
Q C O W T V D | T O W D V Q;C
T F B V E W H | W E T B V H;F
Y O A C I E U | U E I O C Y;A
B T U Q C N X | T C B X U Q;N
G F Z Y J L B | F J Z Y L G;B
C R Q Y U Z H | Z Y C U R H;Q
J X S T O A C | A J C X S O;T
T Y K O V I G | Y V T O G K;I
F C N L I K G | G C F K N L;I
G V X I Q L K | Q G L V I X;K
A K F V U Y B | K F B Y U V;A
A T O W B J K | J B A W O T;K
V F H P O T D | V F H T P O;D
Y K D V B P C | Y P B D V K;C
E U Y P K M G | M P U K E Y;G
H W D N X M B | D B N H X W;M
K J T M I F U | M U T J I K;F
A D O I C G Z | G A I D O C;Z
P G L V X E I | V E P I L X;G
A R T Z N L H | T Z N R H L;A
Y O V E H A B | E O Y H V A;B
T L V K Q Y P | P Q K L T Y;V
O K L G A W E | O L W A K G;E
E U B Z O I M | U O M E I B;Z
S A R N W Q L | N A Q W L S;R
R H S O U M L | L O U H M R;S
Z G W S M H P | Z S P G M W;H
T U Q P I X R | R I P X Q T;U
E I O C T U X | X O I T E C;U
N Y J S T X F | N Y J X F T;S
O L E T J Q X | J X Q O E T;L
J T Y S H E B | J S B T H E;Y
A D X C K V S | V A D X K C;S
Q Y S U M K N | U K Q N M S;Y
S X C P I Q T | P S C I Q X;T
D M O E U F X | U M O F D E;X
U R Z N D W A | D N A R U Z;W
T N A K S J F | F N J A S T;K
A M T R W X F | M F X R A W;T
O Z I T E G S | O S E I T Z;G
L A B M T Y C | M C T Y B A;L
L B G N T Z V | G T B L N Z;V
V X Y L G Q W | G Y V Q W L;X
R D B P W V M | W M R P D V;B
G E L Z T X H | Z L T G E X;H
Z D Y G T N S | Z Y S N T G;D
H L Y E G O P | O Y E P G H;L
V K N E P Z D | Z D P K E N;V
V E B C L D P | B E L D C P;V
C Q F X D U Y | U F X Y C D;Q
P T N W G Y E | P E T Y W G;N
D K C H G E J | C D H G J K;E
T G C K Y L S | S C L G T K;Y
B L S E X T K | X S L E K B;T
B U V H J Y F | H F V U J Y;B
O A V M B J F | A F M O V J;B
W E Z P Q V A | Z Q V E W P;A
D E F P Z S L | D P Z F E S;L
F H D L R X B | B F X H D R;L
L W Z B J C D | W D B J C Z;L
B P F T A R I | A P T F I R;B
T F L B R K Q | T F K B Q R;L
E F O C N L Y | E F O Y N L;C
G W C V A Q B | Q A B C V G;W
N G O W S T Z | Z N S O T W;G
Z M X K S F T | Z S K X T M;F
M S Y U O E P | E S U Y M P;O
N O H C A G Q | G Q N H A C;O
E V G O Z N M | O V G M N Z;E
P N L R F K Z | F R P Z N L;K
G J K S E F U | S F J U K E;G
J X B E C N V | B V C E N J;X
J I O G E B S | J E B I O S;G
P U Z W O F C | W Z P O U C;F
Y O W T F U D | T U F O D W;Y
D Y N F V E M | F N Y D M E;V
M X Y Q V C S | X S Q V M C;Y
W X N O C Y P | X Y N W P C;O
A M C V R T S | A T M S R V;C
N U R P Z D H | R U H D Z N;P
T H X B L S P | S P L B T X;H
J E P N D X W | W D E P N J;X
I O A U E D K | U O E A K I;D
H Z B K G Y Q | Y Z B Q G K;H
A Q K Y R N C | C A Y K N Q;R
L O U K F S E | O L F E S U;K
S E F G D O A | E F D S A G;O
H C P E Y L F | P E C L F Y;H
P Z Q O D U J | U D Z P O Q;J
G W O H C Q P | W H O G P Q;C
W H D L E C B | W B H E C D;L
T Q E Z O H U | E Q O H T U;Z
P G J W I R Y | R W G Y P I;J
Y K Q F X S W | W K S X Q F;Y
F Y P S G V Z | Y G Z V P S;F
I T B R L G O | G R T B L I;O
D E V X C L W | X C E L V W;D
O B E I W L R | O W B L E R;I
X T J I B P M | X I J B P T;M
Q H O D R A M | D A M O Q R;H
Y I O V A X S | Y A V O S I;X
U R B C J Z O | R B C O J U;Z
H Y R I B L F | I F Y B L H;R
V J W M Y L P | Y W J L P V;M
D X O F V G Y | D G O V F Y;X
S C L D A R E | R S E D A L;C
Y N C D B V H | H V C D N B;Y
E I X L F B G | G X B I L E;F
K Y M P U H T | H P K Y T M;U
D A E L S R P | R E S A D L;P
D H I N L J U | L I N H J D;U
C E U N W H G | U G C H N W;E
U A I B Z E G | A U B I G E;Z
H Q Z Y E T P | T Z P H E Q;Y
N M E C W O J | O W J C M E;N
P Q M Y C K L | P C M Q Y K;L
Z H A W S N X | W Z N H X A;S
N B Y Z P Q K | Z Y Q N B K;P
L K B J A Y D | D Y L A K B;J
O F M Z I H Q | M I Q F O H;Z
T U O H K S Q | U H K T S O;Q
Q L F P E W G | L F W G P Q;E
T H U P B G C | C H P U G T;B
P Y X H V R E | H R P X Y V;E
E I D L N T R | I L T E N R;D
X V P A Z M I | M X Z I V P;A
D V F L R B G | B R V D L F;G
I R K H B E X | R X H I B E;K
E M L N A S H | L E A H N M;S
C F J Y X Q A | A X Q Y J C;F
E Z T O Y Q R | Y E R Q Z O;T
G M L D Z V J | D M V Z L J;G
C O Z G R K S | K R G Z C S;O
P Q E O W X L | P E L Q X O;W
T A J Y S L G | Y G J A L T;S
J I F D W R M | W J D F I M;R
J Z R K E O G | K Z J O G R;E
X F W D L R U | U D F W L R;X
G V B Z L J Q | B V L Z G Q;J
M O P X G N R | M O P G R X;N
D H U E W I X | E I U D X H;W
C Q W A E L P | W L Q E A P;C
S P T I X E O | I P O T E X;S
V I Q D K B E | B I V D E K;Q
P T L E A O W | T A P E W O;L
W C T U Q I R | I R U W C Q;T
C R X W U G V | U C G W X R;V
I T N W Z H Q | Q I N T H Z;W
L Z U C M T A | A L Z T U C;M
L E N T K R B | B K T R L N;E
E H W Z K A G | K Z E G W H;A
C J Q A S I E | J I S C Q E;A
A E H F X Z J | X A J E Z H;F
D M P J A Y T | A Y J D P M;T
Y Q C D L P N | Y Q C D P N;L
K A T V C G S | K S G A T V;C
I W L O R G D | W G R I O D;L
D S U B Y T I | B D I Y U S;T
H W Q U C X M | X C U W H M;Q
Z T A P Y G J | Z G J T A Y;P
V U Z N H G S | V Z S H N U;G
P W R E D J A | J R P A E W;D
C U D N K Y G | K D U Y C N;G
M G H R C A X | C A G X R M;H
A L B Y O U G | O Y L B U G;A
Z U W C J D A | D A Z C J W;U
M C E F N W U | C N F M W U;E
G B E K W S M | B G S M E W;K
W E F K D T Q | Q T D F K E;W
B Y R N K T C | C R Y T K N;B
B I P L V O F | P I L V B O;F
S O R Q P X T | Q X P T O R;S
L Y N Q I R T | R L Y I N T;Q
K Q W Z S X U | U X K Z W Q;S
U N S B Q H D | U Q H S D B;N
D Y A E K S R | D E Y A S K;R
D F X P Y A S | F P A S Y X;D
C T B N H Z Y | C H N T Z B;Y
J K N W R Y G | N K Y W R J;G
D U R E L M P | L D E U M P;R
W G D O V B J | D G W O J V;B
N J Z R F D O | O N J Z D R;F
G X B P S T L | L X P B T G;S
D G X K V Z E | X K V Z E G;D
X L N V F U M | M X F N L V;U
T Z R N L H U | N T L Z R U;H
X A U O L S C | O C X L S U;A
V B J D L N X | X D N V J B;L
T V G C E M D | G E C T D V;M
Z U V S X M H | U V S Z M X;H
F O J P A Q L | A L F O P J;Q
F R D I W C Q | Q D I F C R;W
U X T K Q G M | U G T Q M X;K
A B C G N S F | C F B S A N;G
M U I P A Z N | N U P I M A;Z
C Y K P D A G | K C A G D Y;P
J A W E S R Q | Q E W R A J;S
O N L Z V D H | H O D L N Z;V
D T R W U M G | M G T U R D;W
A U W Y L R J | U A J L W Y;R
H J I Y D M C | H C D I Y M;J
M I G P E R N | M N I P G R;E
U V X W A R M | V M U R X A;W
N I B M D Q G | N M G Q I D;B
V O B P E N U | N U V O P E;B
L R S T Q O H | S Q O T L R;H
A S I W E U G | E A U G I W;S
R A P I F M O | O M P R F A;I
V D P X M B Y | B X M D V P;Y
A Q R M J L S | S M A Q L R;J
N P F T Y C U | N Y F C P T;U
X L Z U P N O | X U O N L P;Z
G L Q A J V Y | V Y J Q G A;L
D H S I C L Z | Z D C I S H;L
T H F B C Z R | F B T C H R;Z
E C R I P A L | I R P L E A;C
S V A B W Z E | B S A Z W V;E
U T W A P S R | U W S R T P;A
M N V B A X E | V X M A E N;B
L D S I B C N | L C I S B N;D
Z L J M A C K | K J A M Z C;L
D X I F N Z M | M D Z F I X;N
W G X Q I Y S | I S W Q G Y;X
B G W I X H S | H S B I X G;W
L T W F X Q P | Q X W T P F;L
R S I Y X N E | E I R X Y N;S
L R M N Q J S | R Q L M J N;S
R T W C E X G | W E G X T C;R
R K P I C W S | P I S K C R;W
G S M X Y U Z | G M S U Y Z;X
M S Q N U X J | S J X Q U M;N
T W H O C E M | M W C E O T;H
K W D B X H O | W K X O B D;H
K C X J S W Y | C W S X Y K;J
B U O M E Z T | Z U M T B O;E
X H T Y R U D | D R T Y H X;U
T K W J E P C | K C T E J W;P
F I W K G T U | F I T W U G;K
A T G B E P R | A E B P R G;T
V H I N C U P | P N I C H U;V
W Y Q K P G V | Q Y P G K W;V
Z E L V H D C | Z H C D E V;L
A O I X B Z W | X W B I Z O;A
K W M E V O U | V O K W U E;M
V G X H L C Q | X C V L H Q;G
R I S Y P M A | A R P I S Y;M
U A H L G R B | G H R A L U;B
D N J H P B Q | D B P Q N J;H
X H Y F O K C | O K C F Y H;X
L A F W U J X | A X L J W F;U
P V N J X M E | P J V N E X;M
M K D Q T J V | V K J T M Q;D
X J A N O D R | J R X O N A;D
P O X C R H T | H C X P T R;O
Y E A I L Z S | A Y Z E I L;S
N P T B M Y K | T K M Y B P;N
M Y R T H Z G | H Y M G R T;Z
K U S M I G J | M J I S K U;G
W Z K O J C Q | O J Z W Q K;C
P S Q T R B D | T Q D B P S;R
K I X O S Y J | O K I J X Y;S
B F Z O I D L | Z D O B I L;F
V A L T B W K | W V L K B T;A
F O E Y W N U | F N O W E Y;U
T M R F H J E | T F E J H M;R
Y R L U E X Z | E R U Z L X;Y
W X O U M C I | I M C O W X;U
Y D I J E A Q | I D E A J Y;Q
A J U H D S Y | H U A S D J;Y
Z K E D A U G | A E U K Z D;G
V U J E P T W | V P T J W E;U
U B L S V Q R | Q U V S L B;R
A H B E X U J | A H U E J B;X
Y Q U T L Z F | U L T Z Q F;Y
G T P D S M K | P T M K S G;D
X H Y N S R K | Y S H X R N;K
F V A H E B Z | V E H F A Z;B
H I N P L F U | I H P F L N;U
U T M K G S J | M J T U S G;K
B L X V K S G | K G V B S X;L
D V B C K G J | G J K D V C;B
G X J H Q D A | D G A J X H;Q
V L O E T C B | O C L B T V;E
O R H S G I M | G S O H M R;I
F B M U O S N | U B S F M O;N
L R Q T O U E | Q U O E R T;L
Q J G U M B W | Q M J G U B;W
R C B J U Z O | Z J R C O B;U
Z E G P B H J | E Z H G P B;J
J E G F D U V | F E G J D V;U
K V S T Y N J | T J Y S K N;V
O V B S J M L | M L B V O S;J
N S V L Q A U | L V A Q S N;U
Y K L B F M P | M K B L Y P;F
M B U L Y D S | D M U L B Y;S
F E R M T K U | K R M F T E;U
S H N X E D V | D X H V E S;N
W V M Z N B A | Z N W M A B;V
L N I F P Z U | L P I F U N;Z
J M C X Z N H | N M H X J Z;C
K X F I H O C | F I H C O X;K
O C M K B I D | C B K D M I;O
Q V N W T F P | F P T N V Q;W
D J W L H Q I | H J I L D Q;W
P O X N J V Q | V X J N Q O;P
Z A F T E D Y | Y D T Z E A;F
Y V A M H Q S | A M Q Y H V;S
C Q E F Z Y N | E Y N Z Q C;F
V U R I Z N M | Z N R U V I;M
Y E M H G B T | E M G H T B;Y
K D P S C X R | P X R S K C;D
O F U J N Z D | Z U J O N D;F
V X T Z O W E | E W T X Z O;V
O J B L H S U | B U J H O S;L
T J P C R V M | J T M P R C;V
S T X J O C P | X T C S J O;P
Y L R E G C A | C L R A G E;Y
W P T F G O V | O G P W V T;F
I B Z L G P Y | Z B G L Y I;P
K E Q D G I H | D E K H I Q;G
V S M K W G L | K M L S G V;W
C U Q E G S N | N G E U S Q;C
P D L H K W Q | K W D L Q H;P
N X D B W F R | B W F N D R;X
N M Z K P W Q | M W Z K N P;Q
D N S L K X W | N X S L K W;D
F J V Z X C B | Z V B C J X;F
J W I Y Q F N | J Q F I W N;Y
F P O H J B Y | O Y B P J F;H
K J I H X R F | K I F X R H;J
Q T I M L A E | T L M A I E;Q
F V K H P D B | B K P F H V;D
K N T V P B D | D B N P T V;K
C T U L V Q G | G L C U T Q;V
Z W R M U B D | D R W M Z U;B
I A P Q V N C | I P A C N Q;V
N I T P U O R | T R U O N I;P
I W E J Y A R | J Y W R I E;A
T P H B M D O | B T D H M O;P
H L I P V Y X | L V H X I Y;P
X B C M S A Q | C Q X A B M;S
Y D G S H P R | S Y R H G D;P
O E T M L I Q | O L T Q I E;M
M D P F G V I | G D M I P V;F
H V Z Q R K J | R Z V H K Q;J
Z G E R T M I | I T E M R G;Z
E F B Q C Z G | G Q F C B E;Z
C G T Z Y E L | Z Y E T L C;G
Q O F C L E K | O Q L K F E;C
X T J H I V Z | X H V T J Z;I
B J Y I C W V | B W I V C J;Y
J O F E B L K | K E O J B F;L
R G T C V H Y | H C Y T V R;G
L A C D E F K | F L C E A K;D
I B U X R S Q | Q R I S X B;U
D Q B P O T F | F T D B Q P;O
C O P A K L I | C K P L O A;I
E F T Y O V I | O T I Y F V;E
Y M F N R Q T | T R F M N Q;Y
V Y S R M P X | V X Y R S P;M
W S A B N O K | A N W B K S;O
Q J R F Y V D | D F V Y J R;Q
N U Z H T C J | J Z C U H T;N
I Z A G F C H | Z C F H A I;G
D Y N Q F P T | P N Y D F T;Q
H C B X N R O | C B H X O N;R
T C I P K R X | I P C R T X;K
O A W V D I H | W D A H O I;V
P V R O C S J | O R J S C V;P
M V D H J Z P | M V D Z P H;J
P E Z J C L Q | P E J Z L Q;C
P T F J L D A | A P T J L F;D
L G D F V K T | G D L V T F;K
J M U X E K R | M X K R E J;U
W U E S N R P | R U P N W S;E
R T J M Q V E | J R Q E T M;V
N I Z U E G P | G P Z N U E;I
V F I N S J Q | S N F Q V I;J
L D R I V W A | A I V D L R;W
M H L E T B I | B M I E H T;L
M T B O S H J | T J B H S O;M
A B U Q I O F | O B Q A U F;I
U R H F P M I | P M U H I F;R
K E H R Q O V | Q O H E V K;R
F G D O Q T J | T F J Q O D;G
T H D F L Y Q | T Y H L Q D;F
Y Z E I H C D | C H E Z D Y;I
H E C T O Q I | I E H C Q T;O
J K S U W E Q | W E J U Q S;K
W C L T H S R | C R W S T H;L
X G W C L B V | B W V X G C;L
E K Q J D N F | D N K Q F E;J
A G W I O X Y | A W O Y I X;G
Q Z J D K L F | Q Z J F D K;L
G I M R J D Y | R M J Y G I;D
X L G R D B C | R L G X B D;C
X M S Q G F N | M G N S X F;Q
Q D Z C B P F | Q C D B P F;Z
C T D A Q M N | C M T D A N;Q
R N F Q Z O U | Q Z R O N U;F
A X M B T O C | C A T O X M;B
V B Y Z E Q I | E B Y I Q V;Z
B I H Z Y C L | C Z B L I Y;H
R W K V N T F | T K V N W F;R
K I B O C J Q | I J K B O C;Q
Y S W P M N X | W Y N M X P;S
N E H G K M Z | G K N Z M E;H
M V C U K P D | K C M D P V;U
L P C Z H O N | Z H L O C P;N
T E F Z I Y L | Y F T I Z E;L
F Y Q X S K O | X Y O Q S F;K
L P G U W A C | U L P A W G;C
W O X N M P Y | M X P Y N W;O
T D S Q P N M | P T S D Q N;M
B X C P M O Z | P C X Z M O;B
X E U C H W I | U I E X H W;C
F O Y Z E Q U | Z Q F Y E O;U
L J K U R V C | U K L C J R;V
U F I Y L G H | F H I Y G L;U
S D E O C G U | D S C G E U;O
Q P N R V F E | N E R F Q P;V
D E Q V X G J | V G X Q D J;E
K Y P I X Q C | Q Y I K P X;C
K X E P H Q W | W E K X P Q;H
J B S W F R A | S A J R W F;B
C T B U X Y O | U X B Y C T;O
E W C M R Q G | R M C G Q W;E
N T I H E X B | H N I B X T;E
R S K G I C W | R S G I W K;C
O F T C Y U H | C H F O U T;Y
D E Z S R O J | D O S Z R J;E
F T D M W X J | M J D T W F;X
M A R Z J E O | M Z R A O J;E
N X B S W E R | N E S R W X;B
E X W Q S B N | W B S N E Q;X
I A H Q N Y B | N I A Q H B;Y
B W H G O V E | G B O W H E;V
N Z B D V J K | B V N Z D K;J
S Z E V T W R | Z T S V R E;W
H Z S U L D V | L Z D U V S;H
L D S E P R Y | P E D L S Y;R
Q F H A G E W | E H Q W F G;A
M Y D I W R V | R V I Y D M;W
C H K R Z J W | W Z J H C R;K
K D M J H Q Y | K Q M D Y H;J
V B N J F T C | C T J N V B;F
S F E O P A Z | F S A Z P E;O
V G N H L F K | G H N F L K;V
P B D O H K Q | K Q O H P B;D
R Y C F B U G | B U Y F R G;C
L K W J X C U | L K U W J C;X
E Q F V U D H | U Q E D F V;H
J X W M N F L | X M W J N F;L
L J F Z I H V | H Z L V I F;J
M O K S L Y I | K O Y L I M;S
X I K F M O Z | O M I X Z F;K
O P C U Q S R | Q S C O P R;U
Q F O M Z A T | Z T Q M F O;A
A V S H T U B | U V S B H T;A
I V Z N C P A | I Z C P V A;N
F K H B L J R | J B H L K F;R
X Z F Q L D B | Q F B L Z X;D
I C Z R G V T | I R G Z C V;T
P Q F Z Y E S | Z Q P Y F S;E
C Z A B W Y M | B M A Z Y C;W
D B Q H A F J | A J F H B D;Q
K Q F H S Y V | V K Q F S H;Y
F C G B J Q K | C J B Q G K;F
C F G H T M B | F M C B H T;G
K Y W P O L R | O W L R K Y;P
U G O F E C R | F U G O E R;C
W E U R I F K | U E W K R I;F
K H T C S M I | M K I T C S;H
H W A P N L Z | Z H A L W P;N
W Q O X A L Y | W Q X O A Y;L
W Q H L K J U | K Q W J L U;H
Y S N G P Z F | S P F G N Y;Z
S Y Q N O M P | O Q M P N S;Y
J Q I U R D C | J I C R Q D;U
F V E Z I H K | I Z H K E V;F
A G S F H N R | A H R F S N;G
X I E R D L B | D L I E X B;R
M D L U A Z H | Z M A L U D;H
T O Z G L F U | L F U G O T;Z
R Y M Q K S C | S Y K M Q R;C
M O A X L Q G | L O G Q X A;M
N H L T Z R K | N Z R T L K;H
W M O D I Q G | G O W M Q D;I
F Z I B V A H | A V F I H Z;B
M K A V Y B S | S A Y M B K;V
I E M P Z T O | Z I E M T P;O
N Q B D K J V | J K D B Q V;N
Y P H U C J O | C Y P U H O;J
Q Z G B K J U | B Z G U J Q;K
K T V U M O W | T V M O K U;W
O B Z F K J A | F B Z K O J;A
F W Q Z B H A | H F Z Q W A;B
K B M F V L N | N V B K F L;M
N R P L Y W H | P L H R N W;Y
T N Y H R J A | J H T Y A N;R
F E L W B D T | W T D L B F;E
S L W Z D T K | W L T S D K;Z
V R U D W K L | D U L V R W;K
E C N K S F R | F K N E C S;R
C A F J Q Z K | Z F A C K Q;J
L S P G C M E | M C E S P G;L
A H X D W U L | X U L D A H;W
P B F Q X D I | I B D F Q P;X
T D X P Y H O | T X Y H P D;O
L W G I P H E | H P G W I E;L
F D C H M I P | I M H D F C;P
L S U W P D Y | W D L S Y U;P
X V J A B O Q | J B V Q A X;O
J X R A K D W | X A K R J W;D
B Z M N S J F | S B Z F M N;J
C U E H J T A | H A U J C E;T
R K C J H B Z | K J R C Z H;B
G F P Q B J H | Q G H B P F;J
P C J U N L Q | U J N Q C L;P
B Y H V P K F | B F K P H Y;V
B N Z P Y I C | B P I N Y Z;C
A H M C J L T | A L M J C H;T
A B S I K D M | I M A B S D;K
N O M U K R B | N U B R O K;M
G C Z W K E U | K Z W U E C;G
H F C Y Q I S | F Y C I Q H;S
P Q M F O W C | M O C P W Q;F
F U T D A G K | K D F A U G;T
K D Z J E G I | E J G D I Z;K
U J A O F K X | J U A K O F;X
R X Z N J L D | X N L Z J R;D
T Z I V H K C | I H K C V T;Z
Z Q X C M R A | X R Z M A C;Q
R K M Y E U C | C K E Y M U;R
W L G V X R E | L R V W E X;G
B L Z F R G T | R F T Z B G;L
V L D U X A R | R X U D V A;L
R V U K G P Z | Z G R K V U;P
V X K G M H Q | G Q X V K M;H
I Z L K D S A | A I L S K D;Z
E O A C U H J | A E U O J C;H
Q R B E G U H | U G R E H Q;B
S R B H E P U | P H B U S E;R
A X F R M Y Z | F A Y X R M;Z
I N J E U F B | F E I N B J;U
J A C F Y B K | K B C Y J A;F
I K T Q C J S | J Q C K S T;I
J T U Y V P E | U V P E Y J;T
P X F W T Q Y | F Y P Q W T;X
P J Z H D W X | X D P Z J W;H
H O B E K D G | D B E H O G;K
Q S K Z N Y C | Y Q Z K C N;S
V C L X G Z W | Z L G X W C;V
W V O X K Y R | K O R V X W;Y
A C M E V Q K | V Q C E A M;K
O Q J L C N R | N L J R Q O;C
U J S V C I X | X C S V I J;U
J N X O I W Y | J O Y I W X;N
X B A K T H E | E T K H X A;B
V S D A G Q X | A V Q G X D;S
M I W K S U E | S I U W M E;K
L N R W Q M Z | N L Z Q M R;W
L J M F D T R | J T F L M D;R
H I L R Z F P | L H P F Z R;I
K G Z F R T A | G K F R T Z;A
I N Q O L Y M | O I Q M Y L;N
X K R S V Y W | S W Y R K X;V
H U P T W L Z | H U P Z T L;W
Z T H R A E W | E R Z H T W;A
I Z F O T H D | T Z D F O I;H
A J M W R Y U | U Y J W R A;M
G N D O Z U M | G U O M D Z;N
Q A C U P M R | U C A P R Q;M
B T L U N D Q | D B N T Q L;U
J X R A D I Y | R A I X J Y;D
F P Q T C U V | T Q C F U P;V
O N A G E S W | O A E G S N;W
S F G O I P W | P S W I F O;G
W V K N A L Z | Z V L W K N;A
C H O J V Y W | V W C O H Y;J
M N Z J E R Q | E Z N R M J;Q
I Z L F U B N | U B L N F I;Z
R Y P E Q L T | Y R P L Q T;E
V T I C D A K | K C I A V D;T
I N U S L Y Q | N S L I U Q;Y
R V N F X I C | F X C V R N;I
C U Y T X V L | X V T U Y C;L
J K Z G B F R | Z J B G K R;F
W C M Z U A P | A P M C W U;Z
O C F X P H S | S P O H X F;C
M N G F Z A I | F M Z A G I;N
B O Z N P E S | B E P N S Z;O
K O S Z E L Q | S K O Q Z E;L
S W I B G K H | G K B H S I;W
L O V D X C Q | V L D C X O;Q
M B G A I T R | G A M B T I;R
V K L W P G E | W K L V P G;E
O Q I W Y H B | O I Q W H B;Y
P A O N D G J | D J O A G N;P
S F T D Q K P | T F K S P Q;D
U P E B T D V | P B V U T D;E
B Z U M R E F | M E F U R B;Z
L T U R X V N | U N T R X V;L
B F X V T G N | X B V N F G;T
E P R S J Z C | P R E S J C;Z
C Z O T I S B | C Z T I O S;B
D O K B F S Q | B D Q O S K;F
X F Z G H B V | X B H F Z G;V
T M A O X D N | X O M A N T;D
V R D U C M H | U R V D M C;H
Z B H M D K W | H W D M Z K;B
B P E H A O T | A H P T O E;B
Q L B H U G I | G Q I B H L;U
N D C F R T J | N C R J F D;T
Y N E M H X J | Y X H M E N;J
F G O N B X C | N O F X B C;G
L T Q S V E O | S T L E Q O;V
Z K E O U H X | K Z O X E H;U
I Z Q L U W X | Q L W U X I;Z
M P E R F S Y | E Y M F S P;R
K X E L Z Y V | V E K L X Z;Y
W O J D T C S | W J T O C S;D
R D I V Q J W | J I V Q R D;W
K U Y D A P O | D A U P O K;Y
K S H P F G V | H K F G S P;V
C L Z I V J P | P C V Z L J;I
O M N D P F J | P D N F O M;J
H W O L Y I S | L W H Y O S;I
P C W U Y N D | W U P N Y D;C
Q N E I A U L | N A L E U I;Q
K C W G R D S | C S K D G W;R
W M N C B S Y | W M C N S Y;B
D Z A H R V M | V H M Z R A;D
Y T X P I A K | P T I A Y X;K
Y J I O D Z F | J Z Y O I D;F
C M E R L V T | C T V E M R;L
Y A Q C M G R | M G Q R C A;Y
Y U N T D B O | U N Y D T B;O
W O G C Q U Z | Q C G U W O;Z
S Q O X B I K | S X B O Q I;K
J E X K O W C | W K C O J E;X
W U X D V H Y | H D Y V W X;U
A O U V D K N | N V O U K A;D
H E V A R I B | E A I R V H;B
T P O V J L R | T O P J R V;L
S R A O B D M | A S O D B R;M
N Y J W G O K | K J W Y G N;O
T Z Q K A L Y | Z T K Y L Q;A
S R A T E L U | U S R L A E;T
L Z H G X I Q | H L X G I Z;Q
J W R C Y H T | H J C R T Y;W
O T Z D W B M | Z O D B W M;T
C S O Z F N T | F N S T O C;Z
T M G Z N Y A | M G Y N T A;Z
H M D E V Y X | D M V Y E H;X
F V E J N Z Y | V E Y N J Z;F
M J Q B W F Y | J W Y F Q B;M
G M S K Q H L | Q G K L M S;H
R P O S N F V | V S O P N F;R
Q D H E I G O | I O E D Q G;H
P T X L W R Q | R X L P T W;Q
T I F G E K U | F T G E I U;K
L M Y T H Z X | X M L H T Z;Y
W Z Y K M P F | W K Y Z P M;F
T R N P I K E | P K T N R E;I
X Y Q V I M U | X V U Y I Q;M
R E K W J T Q | Q E T W J K;R
C Z L F X G P | G L C Z X F;P
J T E S F V D | T J S D F V;E
E O A N P T L | L N O T E A;P
I U O X A E K | K X U I O A;E
Z J G D F U L | G Z D U F L;J
A B H L K W V | W H B K V L;A
B M J W P H X | J W M B P X;H
H K D Z I L C | H Z L K I D;C
Y I J P A O Z | J P O A Y I;Z
H O X W Z T V | H X W O Z T;V
J T L U P V C | P J C U V T;L
K S Y M O N F | M O F N S K;Y
K A R J M Y X | J R M X K A;Y
P M R G X V I | X G R M V I;P
G J K L E V P | L V K G P J;E
Y V Q L I E J | L Y E I J V;Q
E G I U K A M | I U K A E G;M
X V E W P K R | K R P X V E;W
L B H F T U A | U B F H A L;T
Y C X R I F H | H X Y F I R;C
W X M D K P O | M P D O W X;K
Z G E I P Y K | G Z K P I E;Y
A C L M I R Z | L A M R C I;Z
K E L C S I V | V L C E S K;I
Q R D P A I C | A P I Q C D;R
A H I M X C V | A C V I M X;H
M F U N X L E | N M U L X F;E
B X Y F G U L | U L Y G F B;X
L H U P S J O | U H J O L S;P
E H N K T G D | G K T H E N;D
R W G L O S M | M S G R O W;L
H A R W F C I | W R A F H C;I
H V G D W Y Z | W Y Z V G H;D
C R I G D M Q | D Q G C M R;I
G F C M I J N | N M J F C I;G
G M A S I V Q | Q S I G A M;V
C L K Z A W B | B L K W A C;Z
A C M J Z H O | C J A H O M;Z
G R Z T L K N | R K Z N T G;L
J Q T M F C R | M F C T J R;Q
V A S R F E P | R P E V A S;F
Q U I K A W Z | Z Q K U I W;A
D V H N A U E | H D A V U N;E
S Y M C H G N | H Y G S M C;N
D T H U C N E | N U E T H C;D
R I G Z D U E | R E G D I Z;U
V T H D N L E | L E D V N T;H
F H J N M Y G | G J M N H Y;F
P J G F V U I | F G U P V J;I
E M A Q G X N | X E N A G Q;M
T A K M G U Y | Y U T G M A;K
K M G L Q V P | M V K L G Q;P
N V Z F X H S | H Z V X F N;S
I K R V E U Y | K U V E Y I;R
B E U O D K G | O K U B D G;E
Z T R X L I O | O R I T X L;Z
C M T P X O E | T C O M P X;E
U G E K Z I L | Z E L K I G;U
B A Y J L K V | L K A Y J B;V
X A M Y T H J | Y H T A M J;X
Q D W S X P L | W X D P S L;Q
W S V J G Y I | W Y G V I S;J
G Q Z Y E A R | Y G Q E R A;Z
M S O T J K A | J O K T A S;M
S A O B N K J | A J K O B S;N
Q U J Y G I H | G U Q J I Y;H
K N S P A C E | N C K E A S;P
U R Z S O M D | M Z D O U R;S
I S H G R O J | I H R S G O;J
O Y Q L M A H | O Y H M A L;Q
V W F R M O J | F W O V R M;J
M E S T O Y Z | O M T Z S E;Y
D H L J G X W | W H L D J G;X
V N C B F S E | E V C F B S;N
K P X N F M V | K P N X M V;F
H S X V W G Q | S H X V Q G;W
K D F M S V Y | M V D Y F K;S
H F A T Y V J | F V A J T H;Y
R K F C T J B | T F R C J K;B
S Q H N U V J | N U H S V Q;J
V U O D R C N | N O C D V U;R
G Z C F B U A | A C G B Z F;U
K D T P J L O | D P J K O L;T
G V R X Q D Z | R G Q X Z D;V
Q M O R Y J T | T J O Q M Y;R
X Y E O V L Q | L Y O E V X;Q
D W N F Z B R | W R N Z F D;B
V U S Z D P L | P Z L U S D;V
Q Z J D E N H | N E Q H Z D;J
G S H R N P Q | Q R P G H S;N
Q A X H B U P | A Q P U B X;H
D X P C K H E | C P D K H E;X
V I H X P E N | X I E V P H;N
U L T E Q O W | O L Q T U E;W
U H M C T A E | E U T H M C;A
Z C E L N K O | Z L N E C K;O
M T L V R W D | D R W V M T;L
F Z L S M N C | F M C N S L;Z
W C Y R O Z Q | R C Y O Z W;Q
R N Q E U G T | U R Q G N T;E
E A D R U V Q | Q A U R V E;D
H X Q J E L A | H Q E A L J;X
F Q T M H E N | F N T Q E H;M
D M K J U F N | M K D F U N;J
N B T A H R C | H A N R B C;T
J I Z D F S G | F G J Z S D;I
T R O D Y W E | R D Y T O E;W
J O L B X G C | X L C B G O;J
A B F E T P O | A E O F P T;B
M W O L X R T | L O W T R M;X
D R W P N U Q | R Q D W P N;U
X F I V D P H | F D X H P I;V
J E D C B P M | B P J C D E;M
H C O G Z T E | E T Z G H O;C
X V P E A L O | A L P E X O;V
P C I Q O H Z | O C H P Z Q;I
S V A U Z I M | V U Z M A I;S
O F V M B E I | V F M O I E;B
E L T U J S F | F J E S L T;U
P N B C A L K | L K A P N B;C
M L T V A B Z | M V T L Z B;A
A N F C U Z K | A K N C F U;Z
V N G A E D C | G C E V N A;D
X G Y B W P E | B E G P X W;Y
D O Q E A R T | Q R E A O T;D
Q I K O S B T | I T B K O Q;S
T G W B S D H | D B H S T W;G
Y C N T D S K | K N S Y C T;D
D F U Q Z O R | R U O Z F Q;D
H T Q F C S K | T C F Q S K;H
H J X D M A Y | M H D X A J;Y
D B E I Z C H | I D H B C Z;E
F V L C Q N Z | V L N Z C F;Q
L F G Q A K P | F K G L A Q;P
X U P C O M K | O C U P K X;M
Q T A G P R S | R G T Q A S;P
X S I A J R U | R J X I U S;A
B A H Y D K M | H Y D A M K;B
D A B U I K J | K U A B D J;I
V R S G Y D N | D N S G R V;Y
Q Z U O I C W | Z C W I O U;Q
O S Q P L X T | P O X Q S L;T
Z H G Q B O K | H B K Z O G;Q
C X K U S B D | U D B S K X;C
D N X A K R C | C R A D N K;X
Y G S B N L U | Y L U N S B;G
I Y P U D E J | J U I Y E P;D
Z L Y D X E I | D Z L E X I;Y
A G H N V B P | B A N G H V;P
B V J I X P R | V P X B I R;J
U T S C H Y E | H E U T S Y;C
B F D L H W X | W B F D L X;H
U Z G B I A F | B Z G A F U;I
V J F T X G I | G V X F I J;T
K O B D X E M | K O E B M X;D
T B C N P E G | T G C N P B;E
L D V J X S W | V D L X W J;S
A S K P C N V | V A N C K S;P
J Q I K S N M | J I S M N K;Q
A B D M R W Z | Z D W R M B;A
V L M U S F B | V L F B M S;U
I G P B M Y C | B P C Y I M;G
T M J O W L B | J W M L O T;B
K X O P B F Q | F Q X K P O;B
R H F O K Z X | H F Z O X K;R
P W L M A T I | L T W I M P;A
M G I S Z A E | G A I Z S E;M
J V K E T W I | W V I T J E;K
I Q B G J Z M | Q B Z G I J;M
U D M E H P G | M G U E H P;D
C F R X V O M | V C O M X F;R
L D G S X B N | X L G D N S;B
Z L J T Q E F | J Q Z T E F;L
F H G V D K J | D H V K J G;F
F W V L B C E | F B V W C L;E
Y G E R P C B | R E G P Y B;C
W L S D M E O | E W M O D L;S
C E U W D L V | W D C V L U;E
J K M H T N X | K M N X H J;T
D O Z P R L S | D O Z S P R;L
V J X A N R Y | Y V X A J N;R
A V H J Q X Y | X Q V J Y H;A
F B X A J V K | J K F A V B;X
C V U D T R O | D T U R V C;O
G Q O I S A D | S G Q I D O;A
S T H F P I C | H I T C S P;F
A D B G L Y J | A Y D L J G;B
L I F Z M H K | F L I H Z M;K
T V S C X W A | X A S W C V;T
Z U J C B O R | B O Z U R J;C
A U T K B Y R | K U Y B R A;T
E Z C F V I A | A I F C E V;Z
S X P M G Y E | X G Y E P M;S
P Q H V Z E T | Q V T P H Z;E
K O V W Z A T | O Z V A K W;T
N A F P J V S | S F P A N J;V
K X Z T F A P | K F A Z P X;T
Y Z Q S O W E | O W E Y Z Q;S
J F Q W V M R | R F W M Q J;V
H C J O P L N | P O N J L H;C
W M H A X K E | E A W X K H;M
D I K S J P O | P D O K J S;I
S C U N J G O | S N G U O C;J
T G P I Q M B | M B Q P T I;G
C X S Z J A W | J A W Z S C;X
D F R N V E X | D V F E N X;R
R H Q K C M J | M Q R K C H;J
R M A E X C O | M O C R A E;X
G T E O V I C | C E T I G V;O
F T L H W G O | T H W O G F;L
I B L Z O A D | L Z I D O B;A
S J F O W Z K | O F W J S Z;K
H F V T E D A | D V A E F T;H
M S N R K D B | M K D S R B;N
X F H B W D O | O F D W B X;H
O I V K R B J | I V B O K R;J
E C M Y R A K | A K Y C M R;E
D U Z W F K Y | Z F D U K Y;W
D O L P A K I | I K L A P O;D
L T Z B K I N | I Z L N T B;K
Z I G W Y D N | G D Z Y N W;I
A S U T Y G W | T S U Y A G;W
J C T G K D W | G J D T W C;K
Q U B S W F P | U B Q P F S;W
D S O I U H W | O S U W H I;D
F I O B K A T | A F T O K B;I
M S E N L B I | B M L N I S;E
H K E Y U O J | H J Y K O U;E
S R H U A Q W | Q S A W H R;U
T R I S D G N | N I D R T S;G
A H X L O U E | L X A O U H;E
I A X T D Q V | V I D A X T;Q
K L G H C O Z | L K Z C O H;G
R N B W E V O | E V W R B N;O
N V B Y C S L | L B Y C S N;V
E C I D H A T | T H A D I C;E
V W X M S J B | W B S M V J;X
W O K R M L Z | Z K O M R L;W
I V K Y H W U | Y I H V W K;U
O J Z F X R I | F R Z J I O;X
Q S D K X R T | X S D K Q R;T
R O F M D Z A | O R A Z F D;M
V O P G T E M | E O T M V P;G
D A M K R Q T | D K Q R A T;M
M I D E W A Z | D A Z M I E;W
U Q Y X K P L | P L K U X Q;Y
Z J F X N E B | B Z E N J F;X
W E I N Z Q J | Z J E Q W N;I
D G R F C K U | R D C U G F;K
W P V A J T Y | W A P V Y J;T
I Q M F V J G | Q M V G J I;F
D Y V C S H A | A H D C S V;Y
J I N X V O K | O I K N X V;J
F D H S I K W | K I W S D H;F
I U H F B D L | I B H F D L;U
Y K Q I P D L | I P Q K L D;Y
H R W A Y J N | W J N R Y H;A
N X Z B F Y L | N L F Y X B;Z
J K V H Z A E | H K E V Z J;A
N O U D R J T | D N J O U R;T
L X T D A Y E | X D E A Y L;T
K A O Z G F J | G F K O J Z;A
A W S K J L H | W A S J H K;L
X B F O V H U | H F B O V X;U
W I K N M Z E | N I W M Z K;E
R W J S K C L | S K L W C J;R
J D P S N R C | P J R N D C;S
C X B Y G N L | Y N L G C X;B
L H M D R V O | O H V M R D;L
X I Z M Q J V | I X M Z Q J;V
L A Q Y X Z W | Z Q X Y W A;L
W S B Z V F N | S Z N W V F;B
Z S L I V X F | I X L Z F S;V
R L P K U B Z | B K U Z R L;P
M F G I J E X | M F E G I J;X
Q A F X M C L | A F C Q X M;L
L W N E M V B | M B V N E W;L
D U Y H L O V | O U D Y H V;L
M F Y J K R Z | F Y R Z J M;K
S Z B M A U T | Z B S T A U;M
W H R D I A F | H D W A F R;I
Z Q M N E X R | R Z N Q E X;M
K T V J P Y Z | Z P T V K J;Y
Y N R Q T I J | Y R J N I Q;T
P X Q F R G U | Q P X F U R;G
M H Y V E Q K | K Y Q E M H;V
M S N F U P R | F U P R N M;S
O S A B G N M | A M S N G B;O
H Z X Q P C B | B X C Q Z P;H
S Q E Y W X B | S E W Q X Y;B
K T B J A I V | T B A V I K;J
D U S V W I X | D I W U V S;X
C G X L E W N | X G W N C E;L
E L K W A Q N | Q E W N A K;L
F P U X Q R K | F K X Q U P;R
J C S K R Z P | S J K P C R;Z
U V O J R D Y | V U D R J O;Y
R M G Z W J T | J Z T M G W;R
W R X H G K D | G X R D W H;K
O P T G J W S | G W J O S T;P
W D E M I B L | W D E M L B;I
G O R T F X I | X G I T F O;R
E S A F O C B | A E O F S C;B
B W S M Y L K | Y S M L K W;B
Z X M H G Q K | Z G Q H K M;X
Q C K B T W F | K W C B Q T;F
E G V P U X C | C E X V U G;P
V I N L A M S | V S I M A N;L
A I Z M L S Y | S L A M Y I;Z
S B V Q L A Y | A B Y Q V L;S
P S U N E G Q | E U Q P S G;N
R W K P N I J | J R P W N I;K
J F K O R X G | K F O J X R;G
C G S W Z R L | G L C W S Z;R
Y E J O C H V | Y C O J H V;E
Q G K C N M A | C A N G K M;Q
L C J H Y A D | A Y C H J D;L
F P C W A R Y | C Y W F A R;P
I O Z N L G V | V N Z G L O;I
Q R G J Y N O | R G N Y J O;Q
Y L W B T J U | W Y B J T U;L
K Y D R L Z T | T Z D Y K L;R
I G M S C D L | C I S M G L;D
V S O N M U J | N V U M S O;J
R Q S A D W V | S D W V Q R;A
L K F A Q W X | Q X F L K W;A
Q X E Y L I T | T L Q I E X;Y
S V I B D W M | D S I V M W;B
O T C N E U I | C U N E O I;T
B X P W S J N | S J X B W N;P
B X Q V R L K | V B Q X K R;L
F C T Q Z W A | W C F T A Z;Q
N C Q S E X T | N Q S C T X;E
X N E W S B D | E B N S X W;D
B U Z W O I M | B Z O W I U;M
W Y R M P E Q | P Y W E Q M;R
F R X H W E T | W T H E R F;X
N F E J H R X | R F H E J N;X
I V C H J Q W | I Q V C J H;W
M E U J N A S | S U A J N E;M
Z W A O N F M | Z A W O F N;M
A E I V S G B | E A S G I B;V
G M V B I L N | L I V N G B;M
M N J C A S P | J M P C S N;A
I K G Q P Z O | Q Z O I G P;K
K Z W E O R Q | W O E R K Z;Q
Z C K E V G W | C K V G W E;Z
V W K T B Q J | W Q J T V K;B
K V L F I M O | I L M F K O;V
R O B M X V P | X V P R M O;B
H V A T P L Z | T L H A V P;Z
T N U Z A Y F | A Y N U T F;Z
A B G X F Q J | X Q F J B A;G
T X L J Z F E | J F L Z E T;X
A D B O Z J X | Z X O J B A;D
P D R T I Y Q | P R I D Q T;Y
S J V R U Z H | H S Z U J V;R
O Z R P K S C | S K C P Z R;O
C I M T R D V | M V C D I T;R
I Q R X A Y Z | X I R Y Q Z;A
M O N Y J G C | J O C M G Y;N
X Z W V G E S | G W V Z X S;E
H U O A W I S | O H U I A W;S
S W H E I K U | H I E S K U;W
Y T D A L X Z | D T X L A Y;Z
Q S T C B E N | N S E C Q T;B
O J A K D U W | A J U K D O;W
Z A V I N E O | N O A Z I E;V
U Z T B Q J M | Z B M T U J;Q
B A W O X R C | W A O R C X;B
W X B F Z A V | V Z W X B A;F
T A E W H V Q | T A W V Q H;E
R X Z Y G I W | G W Y I Z R;X
O B Q M W C D | B W D M Q O;C
M E S R F T P | S M P T E F;R
K J I D T R N | R K I D T J;N
W N M U O E S | W S U M E N;O
P X B N J F Y | F B X P N Y;J
M U X T E H B | E H X U M B;T
M X N D E O P | N D M E O P;X
K W A N T D M | K T D M N A;W
Q F H E L A V | A Q H F E L;V
O W D N Z X K | W N Z X O D;K
K L C O A R Q | L Q C O K R;A
W F G Y R B L | Y W R G F L;B
F Y S Z J O E | E Y Z O F J;S
Y C E G L S R | Y C G L S E;R
Z V T H C Y F | Z V T C F Y;H
F S Y M L K W | W K S Y M F;L
T W A J I Y M | T I Y J M A;W
K H J F M A Q | H A F K J M;Q
S N C P K T W | T N P S K C;W
I Z G B K T F | F T B I G Z;K
G K J F I R Q | K Q G F J I;R
M L Q G H I D | G L D H Q I;M
G M Y J D T O | T J D O Y G;M
K C X P Q A F | P A K C X F;Q
S G U T I K P | G U T P K I;S
A X N C R J I | C X N R A I;J
A W C Q K P T | K T C Q P W;A
T R B F Z U A | U A B Z F T;R
T L F W Q D K | F K L Q T W;D
O Y M F C X E | M Y X E O F;C
P R U F V I C | P R I F V U;C
B E P M W O S | W B E O S P;M
W Z D B I U M | D Z I M W U;B
Q A L V K B P | L Q A B K V;P
D T R B Y G C | D B Y C T G;R
S U D I C Z O | O I S U Z C;D
J S G I N X L | X N L I J G;S
J A F G X R S | S A J R G F;X
M K I D Y H E | E Y I K D H;M
W K V Z F N O | V F N O Z K;W
H S G N U E B | H G B U E N;S
B M A T R X W | T M R X W B;A
V S L O A U J | L J U S O A;V
K J U D H O C | C U K J O D;H
K Y Q S B W F | Y Q B S F W;K
D U V W Q J E | J D E U W Q;V
E S I K O G F | G K S E O I;F
M N I X P F A | F A I M P X;N
Q U D A F M G | A M G F D U;Q
H R S I U M F | I M F U R H;S
C M U A W F N | C U N A F M;W
S P F C Z I R | C Z P I F S;R
H F S E I C P | S P F I H C;E
W K H P O G L | G P W K O H;L
H K C P D N E | C P N K H E;D
N E U Y S H G | H S E Y N G;U
M F N R O U C | M C F O N U;R
M N Z T X V B | V T X Z B M;N
Q K J P H R O | J K Q H P O;R
Q L K R B C X | K B L Q C R;X
U W C J O H P | U C J H O W;P
H G Y N Q A B | Y H Q B G N;A
H P C R S B O | S R O H B P;C
O K Z V M S P | K O Z P M V;S
Z O L D Q F M | O M D F L Z;Q
F Z U N V R B | F B V R Z N;U
J H D N E M P | J H E P M D;N
G C W I H Z A | A G Z H C I;W
R H T M E S N | N S H T M R;E
H S X A N M D | H N A S X D;M
C B M I O N W | N O W B I M;C
E M I L V J Q | Q E I V M L;J
Z F B G S C X | Z F G B X S;C
O Z I D G J R | R J Z I D O;G
Y S P C X R E | E R Y P S C;X
V U E J H T N | H E U J N V;T
Q A C L J P W | J Q L P C W;A
J P A H U Z Y | A Y U H P J;Z
S G J Y Z C Q | J C G Y Z S;Q
G W R D C O E | C E W O D R;G
S X Y F L V Z | Z X Y V F L;S
J V Y P S K C | C K S J Y P;V
O J Z M Y V G | Z G V M O Y;J
P S W O V N E | P N V S W O;E
G B Z X M Q S | M Z S X G Q;B
G K I X Z V Q | Z Q V G X I;K
A Q C O B G K | Q O K G C B;A
E M P Z B A R | B E M A P Z;R
L P Q H R D O | P H L D O Q;R
W P D Q G E L | E G Q L D W;P
S W U Y B A K | B W A K U Y;S
N Y W C U F K | N Y U W C K;F
Y V F S R N L | S V L Y N F;R
N D W P O Y A | P Y O D N W;A
V S R Z B M A | B R A Z V S;M
U X T V A Z M | A V M X T U;Z
S O T Y V U G | O U V S T G;Y
F E H N Q P U | N H P Q U E;F
Q K W E C B N | K W N C Q E;B
V C G I J Z P | G Z C P I J;V
H E S L Q G T | S H Q G L T;E
J X L W S I C | C L W J X S;I
I A Z J D Q U | Q Z U I A J;D
I L J E S V Y | I Y L E J V;S
H W L D U X V | W D U X L V;H
P C U G D V A | G D A C V P;U
F W T G H M V | W F M T G V;H
U C B K R W O | C W K U O R;B
Q O S D H N M | H Q N M S O;D
W X L A N Z E | L E X W Z A;N
W C E Q H I S | I C E Q H W;S
E U Q D F P G | D E U Q F G;P
N C G H Z V K | N Z K G H V;C
U F T J C I O | J O C F U T;I
Y M F T W J O | O J M W T Y;F
A P D Q L I U | P A U L D Q;I
S U E T W V N | W S V T N E;U
F T L H E G X | F E G H T X;L
D W Q I G P K | Q W I D P K;G
M V S W J K I | W V M S J I;K
F Q N R B V O | V F R B Q O;N
G C I B T M Q | C Q B I M G;T
V B N C R Y Z | C B V N Y R;Z
I R E W C M U | M U I E W R;C
X W N S I B A | I A B S X W;N
M J X B T K F | M J X F T K;B
O A N F P X M | F X O P M N;A
S C B J W U E | S C U B J W;E
X Q C N R E S | X N E C Q R;S
J G K U D W M | J D G K W U;M
T X O Z C R B | X T O Z B C;R
S W M D U Y G | D Y S M G W;U
U K W I V T S | S U K T V I;W
B N J Q C G X | G X Q C J N;B
Z Y K R V F N | N Z Y R V F;K
K V G D E S H | S G D E V H;K
D U E N L C P | E N U D P C;L
Q I B N Y U X | B N U Y X I;Q
G P I Z V H E | P V G H E Z;I
N E K D J C P | D E K C N P;J
O R A U P V F | R F A V O U;P
A W J Q F H K | Q K W H F J;A
H S C K A V N | N S K C H V;A
A W K I N X T | A K I W T X;N
R K Q Z H X A | Q K A Z H R;X
F T B M X D H | F B X M T D;H
V B F D O Y K | B Y F O D V;K
F T S Q C D O | F D C O Q T;S
V X Y P W B A | B P Y V A X;W
A G L C S Y D | L A G Y D S;C
U P R G Y O X | U G O P X R;Y
H G R O X N Q | N O H G R Q;X
A T I X F N H | I T A H F X;N
M R I O B U K | M K B U I R;O
F N E M X V P | V N P F X E;M
H T D F P R K | R H D P F T;K
O S V C T G H | H C O T G S;V
U Q A N B K J | B A U N J K;Q
A C F S U E V | C A E U V S;F
Z J S H V P N | V J Z H S P;N
Y S A N U O B | Y B O U N A;S
Z S R P B X E | R B E X S P;Z
A T B M I W G | T W G M B I;A
C W O N Q L R | O L N Q W C;R
U Q X L C P H | H C L P X U;Q
J F Q P G H U | J F G P U Q;H
P B Z W T D M | D P Z W T M;B
V M D I Y E F | D I M E Y V;F
B K S G A N U | K S B N U G;A
M Y X Z N F P | Z N F M X P;Y
A D T B M W P | T P A W M D;B
A F K D S T G | S D T G A K;F
X G S V Q U D | X U S G V Q;D
F K G L Q M I | L F I Q G K;M
N T M D U W O | W D U O M N;T
L Y J Z B N D | B D J L Y Z;N
M T Y W U Q C | U Q Y M C W;T
S E N Q I T O | N O Q T S E;I
G A F B Q Y R | F Y G A B R;Q
L Q M X Z U A | Q X A U L M;Z
O L F D J Q P | F P L J O D;Q
T H G I J P L | I J P T G H;L
U C F X P J I | I X C F U P;J
G N J A E K O | N O A E G J;K
S T F P M Y K | T F K Y M P;S
K M T P D C R | T K R M P C;D
E W P V G A H | W A V H G E;P
L H V Z Q S T | Q L V S H Z;T
O S F L C D J | O S C F L D;J
E C O H Y K X | C K H X O E;Y
C P E U Q R H | R P E U C Q;H
A R F P J L Y | L R Y P F A;J
P U G C Y O R | P U O G C R;Y
L T I A H W C | W T H I C A;L
Q L A E M N H | H N M Q E L;A
F N V C X B A | V N X C A F;B
U F C V D P E | F U C V E P;D
T R H M O V Z | M R H T O Z;V
A L I E T O F | T O A F L I;E
X L B G C D Q | G B C X D Q;L
D Y G Q J P N | J D Q G P Y;N
F X Z H L S Q | H F X S Q L;Z
M K V U G S T | M U S T V K;G
W Y M D Q X R | Y X Q M D W;R
Z D A I L N M | Z A D M N I;L
D Q L P A B G | L B Q D A P;G
Q J S R L D O | L Q R J D S;O
W Y N X H E I | E Y N W I H;X
U I K X M L P | I P M L U K;X
U M I Z O D V | U I O V M D;Z
I J P N G B E | J E P G I N;B
E V J S M R D | J R V M E S;D
D V T A S Q R | V D Q R A S;T
I F J Z G V S | S F I Z V J;G
H F Q T Y C R | F Q Y T C H;R
G Z V D T A L | Z D V G L A;T
H Y C I T R B | R I C H Y T;B
R K W P A J M | A P J M R W;K
C S E Q U L H | C L Q U S E;H
G X Z T R I S | X T S I Z G;R
K W T R A Y G | W G Y R A T;K
J S Y F K W M | W M J K F S;Y
K N D T I Z W | W N D Z T K;I
J I M N L R Q | M Q I J R L;N
J L I U R G M | G J L I R U;M
W G C E H M B | C E B W G H;M
A V R Z W X G | G W R A V X;Z
Y M A X D K W | Y D M K W A;X
X P U J O N E | J P E N X O;U
R Y V M J N W | M N Y R V W;J
H K V Y B Q S | Q Y H S B K;V
W P B V L F X | L X B F W P;V
G Q Z N H E U | U G N E Z H;Q
X D F V E L M | X M E F V L;D
F I Z R P H M | F I H R M P;Z
Q H Z O E B J | H J Q B O Z;E
D F C N A P J | P D F C J A;N
I U R M S Z Y | S Y Z R U I;M
S Q X U T D M | X S M T D Q;U
C N L T H F B | N H C B L T;F
Z E W D F M I | D Z E I W M;F
M O L D N B S | M O S N L B;D
W Z B P M I L | P M Z L W B;I
L E H Q I D K | Q I K L E H;D
W F C X Z D Y | D F Y W Z X;C
K X T J V H C | C T J H X K;V
D T U H J I C | D J T I U C;H
P D Y Z N L H | Z H Y D L N;P
O E D A P B T | T P A O B E;D
H M P T L D G | G D P M T H;L
U C F L M X B | C X F M B U;L
M K S V L J B | L S V B J M;K
M G U F V B Y | U M Y F B V;G
R W P J Y O D | Y O D W J R;P
I J Z G A M R | G R A J Z I;M
Q G R C I O L | R Q I C L G;O
L W D X J B I | L J B X D W;I
C U W E G I P | C G P E W I;U
R B W K Q I S | B W Q R K I;S
D H G F Z L U | Z D U F H L;G
E P N V R Z Q | N V P R Q E;Z
L I C F A K R | A L K I R F;C
V K W Y H A O | A V Y O H K;W
F O Z C U R E | R Z O F U E;C
B X I F E K N | I N X B E F;K
U Q B M H D S | U D M Q S B;H
M K E L I O T | K O E L M I;T
A O N Z T E B | Z E T B O N;A
C S W M O B I | S C M O B I;W
Z T R F Q S P | Q S Z P T F;R
I A P N X Z R | P I X Z R A;N
W E O V M R U | E V U M W O;R
X C S R F E O | R O F X S E;C
U V H Z D R Y | H Y Z D V U;R
K H P C I R V | C R I H K V;P
N S H Q M D R | D Q M S R N;H
A W O E F C Q | O W C E A Q;F
V Z G F S E L | F L V E Z G;S
N O Q D B I V | O V I Q B N;D
H W C Y N V S | S C N V Y W;H
V F S B H N L | F B V H S N;L
L P G E F R N | F G L P E R;N
Y C D Q B A W | B A Y C Q D;W
J C I D L N P | L D J P I N;C
I T A S O H P | P I O A H S;T
W C H M S Q F | F W M S H Q;C
L G U P Q J D | G U P D Q J;L
A W E C J M K | K E J W C A;M
V Q T W J H B | W V T H J Q;B
V Q P L X A R | L P Q V A X;R
G Z X Y L J K | Z G J L K X;Y
E W H V S D L | W V E L D H;S
A S G Q T O X | X S Q O G A;T
K S F W J H N | W J F K H N;S
K W C Z E T I | W T Z K E C;I
X O D L E C K | X L C K O D;E
S E R V U L D | D U R V E S;L
M D H B Q L W | H W L M Q D;B
V R U A E M I | U V I M E R;A
M U R W Q I Z | W M U Q I Z;R
B M C V L Q Z | M Q C Z L V;B
S W D H V F R | F S W H V D;R
E O X U W L M | E O X U W L;M
X C P Q T E S | C T E Q S X;P
K A V X W T G | V K X T A W;G
B S K P L G C | P S B K C G;L
R N H C J S D | N D C S J R;H
F T N S K B L | S N B L F T;K
U Z G P Y E Q | Q U Z Y P G;E
U R Q E A B K | A Q R E U B;K
H Y B T P K N | T H B N P Y;K
N X T U I V H | V I X T U N;H
Y C E U A H T | T U C A Y E;H
V E D W K R U | V U D W K E;R
N V E R Y A P | N E R P Y V;A
S K R Q T P V | Q T R P S K;V
W T Y P G N S | W P G Y T S;N
R A H V W D T | W H D T A V;R
T C R E S Z P | P T R C E S;Z
K E T I B D W | W B D I K E;T
S D Q P O E T | Q T O D S P;E
W J F V Z N S | F S J V W Z;N
L J A P E B Z | J E B A Z P;L
M U Q W X K H | K U W Q M H;X
F D R Z E G A | A Z E F R D;G
F K Z J C B V | J F Z B C V;K
M Y X G D K V | V Y K M D X;G
L Q C T V R O | O C T V R L;Q
V H K R E J N | H J V K N R;E
V M L W A F Q | F A Q M W L;V
H D L W I N G | I G D L W H;N
G Q Z P A X T | A X P G Z Q;T
F P X Q Z L K | X P Z Q K F;L
Q Y E N H S T | N S Q E H T;Y
V A X T Q H W | A Q V T W X;H
T G P C A R M | C A P G R T;M
V S G U O Q Z | U V Z G S Q;O
F K N Q H S B | F B K S N Q;H
Y A S B K R D | D K S R Y B;A
E D S F A L H | D S E L F A;H
Z S G D N K V | G K D S Z N;V
C X J M Y R U | C M Y J U X;R
W E B X D N Z | E B N D W X;Z
T I U S K L D | K U I T L S;D
G J S Z C N K | S K G C Z J;N
K E U O S W X | S U E W K O;X
G L I U K V Y | V U K L I Y;G
Y Q L O W N C | Y L C N O Q;W
R W L U N Y Q | Q W L N U Y;R
O W I P B F Q | Q F B O P I;W
N H L Z O B W | L Z B N O H;W
J E O Y Q A D | Q Y O J A D;E
O W I E F V A | O A I W V E;F
J H E U R P Y | U P J H Y R;E
L Q W D V K G | W D L K Q V;G
A O S T L H B | H O T B A L;S
C A E L P U J | C J E U L P;A
P W S V K I M | S I K M P W;V
P D X B E U Y | P B U Y E X;D
Q X J C K G O | O K J G C X;Q
E F W C B D Y | B Y W F D E;C
K G J C Y M R | J Y R C M G;K
T J O I L Y X | X O Y I L T;J
V D T J S G A | G D V T J A;S
Y P X U E Z L | Z Y E X U L;P
M F V N J E B | N E V B F M;J
B F P N E L Y | E B Y P F N;L
V J S R B Q Y | Q B R J V S;Y
N O K L D P A | D K A L O N;P
L J P W K Y F | L P K J F W;Y
Q V E A O X M | X O E V A M;Q
P Q E D G T O | D Q E O P G;T
P Z C G T X E | Z E T C P G;X
N L Z M I H D | H Z L D M N;I
G O A W C U V | G A V C W O;U
U R Z N X M W | X R N M U Z;W
H W R Z Q V G | H Q Z R W G;V
L P Q A K X H | H L Q K X P;A
V Z I R T G S | V T I S Z R;G
Y D R A H C P | C P Y A R D;H
K D S Z U G O | U K S O D G;Z
I F J M B X P | J F X I B M;P
O L F Z Q H Y | Y H F O Z Q;L
V X U G K M J | G V J X M K;U
Z T F Y L P J | F J Z Y L T;P
K X R F Y E O | R X F K Y O;E
D M Q V F A U | D U A Q F M;V
O A R I L C N | O R L C N I;A
Q W I C D K H | H K D I C Q;W
G D H R V I C | V D H G C R;I
V G Q F T P D | V P D G Q T;F
A R B Z G E J | J G B Z R A;E
M S O X Y Q K | O X S K M Q;Y
G D K Z O Q E | E O G Q Z D;K
V K P X Z T S | K X Z P V T;S
M H C V Z Y J | C J Z M H Y;V
B M R X H Y E | E Y M R H X;B
S Q M W K J V | K V S Q J W;M
N J Y I D X P | I P X N Y D;J
T L G F Y E C | Y F C T G E;L
H P M R Q J G | M R H G J P;Q
N F I Z G D R | N Z I G D F;R
P V T Q I E R | V P I R T E;Q
E G P M F N K | M N E K P G;F
T L V O Y S J | T V J O Y L;S
I D P T Y V E | E V Y T I D;P
N T H I E D P | E I H T D P;N
B P R T I M Y | B P T I R M;Y
O V C F N L M | C V O M L F;N
F W O U L B M | W M B L U O;F
G J V I L R A | L I J G R A;V
V B Q U K C N | Q K V N C B;U
J V N G R I D | D R I J V G;N
D Q A Z C V P | P Q V Z A D;C
S R O Y I U C | O Y I U R S;C
V U C O X L W | V X C L W U;O
K B E X R L T | B X K R E L;T
F K R M Q U G | G U M K F R;Q
N P Q R T J O | P Q T R O N;J
G N D P I T F | T N F D I G;P
O W N E U Q H | W U E Q O N;H
O B C L H W K | B L C H O W;K
E R W T Y M F | W F T E M Y;R
O T M I Y K Z | Y I K O M T;Z
F P E O A Z U | A F U E O P;Z
T A Q Y E N U | N A E U Y Q;T
M V E I Q N Y | Q V M N I E;Y
N F C T W J V | J C T F W N;V
X H C U K O T | O C X K U T;H
M J A Y W T F | F W A M J Y;T
Y A X J V Q C | J V A X Y C;Q
T I P R A Z B | R P B I A T;Z
A S W I C M R | C W I R A S;M
S T Q O J L F | T F L J O Q;S
W D P N V B I | W B N D I V;P
P Q T F U E Z | E F U Z Q T;P
Y V T L P X O | V T P O Y X;L
O L G F U E S | F E U O L S;G
I D N R J X O | D R X I J N;O
R Z X E A Y K | K Y A R X Z;E
G M O U P J E | U P E O J M;G
W X L S I N U | S N W X U I;L
M U A N C Q D | Q N C M A D;U
D V R J A U F | R F A D U J;V
Q G M N C J V | M V C Q G J;N
U J P B A D L | J P B A U L;D
T X N B Z S V | X T V Z S B;N
M N S I U L G | N G S L M I;U
F Y W N P I H | P W I H Y N;F
W V P K G Y L | V W Y P G L;K
K T P V Y L G | L Y V T G P;K
J M X O Z A K | A X K O J Z;M
K Q B M H Y E | E H K Q M Y;B
J U Y C Z I V | I U C Y V J;Z
W Y C Z F D L | L D Z C Y F;W
N P H A O Y E | P E H Y O N;A
Q J X M O L W | X L J Q W M;O
D W B H J Z C | J C W H B Z;D
F L A J T P M | T F M A P L;J
E K L V N J W | J L K N V W;E
V U B I D J K | B I D J K V;U
H V K F Z L X | K F X L V H;Z
U R Q I G V Y | Y R U I G Q;V
F T H I B X S | I F X B S H;T
B C H X M Z P | B M P Z H C;X
V D O M E X R | E R O M D X;V
P U K B E R D | P R K U D E;B
P J T L Z Y F | J Y F T P L;Z
N X L M K J U | L K X N J M;U
F B Q P A J S | A F Q S P J;B
U Z I M T R S | M R Z U T I;S
X L M N A G J | N J M A G L;X
S K I Y B U T | I U Y K S T;B
L N U V K C F | L C F V K N;U
W F L Y O E P | L O E P Y W;F
T O R J U I X | U J R T X O;I
N P U B I Y O | I U N O P B;Y
C P I A W B F | I W C B A F;P
N D X K P A H | N D A P X K;H
R G S Z E A U | U S G R A E;Z
S M H L W X I | M S W L I X;H
L J Y D E C Z | Y E D J C L;Z
Z Q S N G T O | S Q T N G O;Z
D Q U R F S Z | D F S Z U Q;R
O B A F Z V M | B O F Z A M;V
A D I X S W R | A W R S D X;I
R M D O Q L W | L M O D Q W;R
T J N D A S P | D S J N A P;T
C Z N S K R L | R L S K Z C;N
Y D F M A X L | L D X A F Y;M
M U L Q F V B | Q F V B M U;L
Y U V Z E S F | Y V E S U Z;F
B V E O N U Q | U Q V E O B;N
Q A S K B W H | B W Q S H A;K
X I A B E W Y | W A B X Y I;E
F V O Q S Z N | N S O Q Z V;F
O D F B X K S | O D X K B F;S
W C V Y S R N | W V S N R C;Y
G H Z Y F I X | F Z G Y X H;I
E G P X S L F | S F G L P E;X
P H C E M W L | C H L E W M;P
V Y A G I D T | D Y T G A I;V
N T I O A L Y | A I O L T N;Y
P W Y X M I H | W Y M X P H;I
P E Z C Y K W | P Z W Y E C;K
L Y V Q E D M | Q Y E V L D;M
Q M T I L P K | I P L M K T;Q
R J B I Z H X | R I B J X Z;H
J A H B W N M | M B N W J A;H
Q B I U K J P | U I B J K Q;P
T R H G P E L | T L E G R P;H
A L B O S R D | R D L A O S;B
C B J A D R P | J A R P B D;C
N E B Y I U O | U O B N E Y;I
Q L R D K B S | Q R S L B D;K
I L S J U G T | G I S U L J;T
U X K M C A F | X M F K C U;A
H R W J U X O | X J U H R W;O
H F Q P I A J | H A J I Q P;F
Z F E J H B U | J F U H Z B;E
Y X L K F R A | F Y X R A L;K
G O R T P J C | G O J T P R;C
A C Q G X F W | Q X G A C F;W
N D F L K M A | L N D F M A;K
C K I F X Y W | X C Y F I W;K
C D A Q K O U | D U A K C O;Q
O Y B X U I G | B X G U I Y;O
X L D Q B W Y | X B Q Y L D;W
C Z J L W U O | L J Z W C O;U
B Y R W E G Q | Q B R E G Y;W
Q F R A G I V | I V A G F Q;R
E U V K Z J Y | V Y K E U Z;J
I V R M H S C | M V H S C R;I
K C Z Q N P O | P K Z Q O N;C
E W I P X R Z | P R I E W Z;X
U E Y X N Q J | X E J N Q U;Y
M V K G E L A | V A M G K E;L
T G Q Z A U R | U R G Q Z A;T
Z E F M I U Y | F I E Y Z M;U
I A X H R G J | R G A H X J;I
V E O Q B G A | A B Q O E V;G
S I K J R V A | K R J V A S;I
L F H C Z J G | F J Z C G L;H
A R N Y P B K | N B P K A R;Y
W O G Z V R M | Z G M R W V;O
Q P C H M L F | H Q L F C P;M
A I O P H X U | O H X P I A;U
Z O B T X V H | B H T Z O V;X
G R H O M B T | O R M B T H;G
U B I D N A R | D U I B N A;R
R C A L F Q O | C R Q F O L;A
E B Z L V C D | E B C V D Z;L
I G C Y Q P R | C Y R G Q P;I
V J S D U L T | J V D T L U;S
I O P D Y S N | I P S N Y D;O
V C W N R L I | R C L I N V;W
O V Y G J N Q | V Q O G Y J;N
G M Z O K X A | Z K O G M A;X
V L W H G K R | G H R K W L;V
K V C D E F L | E K C L V D;F
Y P L J S X T | J S Y P T X;L
L A I W E F K | W L I F E K;A
X C Z N R H S | N H Z C X S;R
L U N E S B J | E B U J S L;N
B G M T V H C | C G M H B T;V
K B D M P Q Z | M K Z P Q B;D
R E O N A F G | E R A F G O;N
X R W Y L D S | Y L S W X D;R
L R V P J B D | V L B D P J;R
K P U T C A O | K U O T P A;C
N C G A O J F | F C O G J N;A
H B U Z S Q G | B G Z H U Q;S
D B T U Z L R | R T B L Z D;U
N E X O Z G H | E Z H G X N;O
Z E T B D R Y | D R E Y B T;Z
H P F B L G Y | P B Y H F G;L
G D Z R S N W | Z R N D G W;S
Y A F V C I R | F C A I V Y;R
N I M V O B T | I T O B V N;M
D C Z M S T I | C T D Z M S;I
V M A C T R I | R A T I M V;C
Y A D R Z I N | N I Y Z R A;D
L M R B G C P | B R G P L C;M
V A P F D J Y | J P V D A Y;F
L Z A U E P O | O Z A U E P;L
H O L C F E T | E L C O F H;T
O G N V S Y L | L V G S Y N;O
P U D Q S H E | E P Q H D S;U
Z F J O G C N | Z C G N J F;O
C K Q A S P G | Q C P G S A;K
N W G X K Y L | K N W X L Y;G
M S K X O Z B | Z M S K B X;O
N M I O R H B | R H B M O I;N
X U J G Q F T | Q F T G U J;X
C K B Q N Z L | B N K C Q Z;L
H Y T V M A B | Y V H M A T;B
U G E T N S L | E S G T L U;N
N S Y P T C O | T O P N Y C;S
J I E B X L U | E L J I U B;X
S X E L Y P J | E L S Y P J;X
L U G D R H O | H U R L O G;D
T K C Q X I G | T G Q I C K;X
C T B K F S O | T B F C O K;S
O Z W P Y U M | P Z O U Y M;W
G V W Z O D P | V W D Z O G;P
Y O L S K N M | Y N O K M S;L
Q F L Z P I G | Z F L G Q I;P
L Y B S M I V | L I S Y B M;V
B A J F P Z M | A F P J M B;Z
Q Y U Z W T X | Z U Y W T Q;X
Z G L W I F P | F P W I L Z;G
G I L D A F W | L W I A F G;D
P O J Z Q X C | X C Z J P O;Q
G Y V P I C D | I P Y D C G;V
D Q C E O R H | Q C R H D O;E
B U Z Y E A H | Y B H U E A;Z
J Q L X D E P | E P D J X Q;L
Z K A X D B Y | A Z K Y B D;X
I A P L K R W | K R I L A W;P
X U K Z A T J | T Z X J K U;A
E H U I F K S | S K F I E U;H
Z P M Q C X R | M P R C Q Z;X
D G H O W Q P | O G W Q H P;D
J U G O T V Y | J G U Y T O;V
P B U A O H F | A B P U H O;F
K Q G P D V W | D V G Q K W;P
L M I W A T D | T L I M A W;D
A D R E K B W | R A W D K E;B
Y J W U R M Q | M Y R W J Q;U
N Z W R B L E | N B W R L E;Z
L E Y S K A M | K S L Y M A;E
H C U B M D T | M C D U T B;H
K B P G X N V | P G B V N K;X
W X F H I Z V | I W F Z V H;X
N Z Y C P V J | C V J Y N Z;P
U F D E M V I | D F M I U V;E
B Q A V E H J | B V E H A J;Q
B D Z S C Q R | B Z Q C D S;R
F M V W L Z N | Z M W F N V;L
L V D H J U Y | J Y L V D H;U
L N A P W H T | A H N L T W;P
D X K Y O W R | D K Y O R X;W
T H F B Q I Y | I T F B Q H;Y
T B I S U R V | T S U V I B;R
L M J F H A Y | A L J F M Y;H
U I T R Z M D | R I T Z M U;D
Z Y E F U C J | Y E F U C J;Z
Z U F E W J T | F U T E Z W;J
T K L U N Z C | T U K Z L C;N
L H G Y W K Z | Y K G L W Z;H
Y I R C P M N | P N Y M R C;I
K P J F S H G | H K S F G P;J
V O P I S U G | I U G O V P;S
V H J P S X Q | J P Q H X S;V
G F V A J X E | J X G E F A;V
K H O Y J U W | H Y U O J K;W
R Z C N B I H | B H Z R N C;I
V F Z B P H S | V F S P B H;Z
E N G T B Q Z | Q B Z T E N;G
P Y A Q T N S | A Q T P N Y;S
W D C Q S F R | R F W C D Q;S
I M D Q U Z C | D C M Z U I;Q
X W H D F S B | B F X D S H;W
D N P O E J C | E P D C N O;J
T Z K Y E V M | K Y T E M Z;V
J T Y S P V L | V J P S T L;Y
Q T E W V L S | V L W E S T;Q
B D Y J K C L | J C K L B D;Y
A P S H R Z O | R P O H A Z;S
D T V R X O J | D V T R O X;J
X L Y M O S P | M X Y L O P;S
X K A Q E S N | X E K Q S N;A
A V Z G K M H | G A V Z M H;K
O S G R F Z H | S G H R O F;Z
Q K N H A M P | H K P M N Q;A
S M R E G P D | R G D P M S;E
W D P C F H O | W O C D F P;H
J C H Z I G N | G H Z J I C;N
F U V S Y M H | H U Y M F V;S
K M S Z B X E | Z B E X K M;S
U C Y H N S O | N U O H Y S;C
T G U P S D A | D G P U S A;T
J D I Y Z H P | Y Z I P H D;J
L W F C Q V T | F V W L C Q;T
O A X Y H K F | H F X A O Y;K
T Y U J P R V | U J T Y P V;R
I T S W A K C | A C T W S K;I
D X J A O Z V | V X O D Z A;J
Z F L V W E Y | Y Z F E L V;W
R P X K D W A | W P A R K D;X
I W H Y F O B | I O H B W Y;F
A Z O T W P H | P T O H A W;Z
P N H R I T X | T P N I H R;X
Z Y Q N E B V | N B Y V E Z;Q
U T S A R V Z | T R S Z A U;V
K H J M C I O | H M C J K I;O
Y D C I J H T | Y I T H D C;J
I C L G X P T | X G C P I T;L
J U Z O L C F | J C U O Z F;L
W U G S F L B | U W S B L G;F
P M K D L C U | L K M P C U;D
H X N A I F O | I H N F O X;A
S H W O D B C | O C H W D B;S
I X U T A F D | D F U I X A;T
K I M Q T C S | C Q I T S M;K
N Y O M J T D | N M O Y J T;D
P T M F Y G N | Y T N M G P;F
R E Z M D U B | B M Z D U R;E
A B D U X S L | B X D U A S;L
K O W B U N M | O N K M U W;B
Q Y C H R I E | C Y R E I H;Q
T V N B X G Z | N G V T Z X;B
U X L S J H Z | H U S Z J X;L
K U P Q I E D | I D K Q E U;P
B V O R N A J | A J O N V B;R
P G I A R Q W | A I W P Q R;G
E H D O A W U | O E W D H A;U
D C Y M K L Q | Q C M L Y K;D
A V P J Q U E | V E A P U Q;J
P V W K R L X | P L W K X V;R
Q F M N R S B | B S N M F R;Q
Z J P V M U H | H M Z V U P;J
I B N G J T C | B C T I J N;G
N K J U S W A | U J K W A N;S
K S O Y U F M | Y K S M F O;U
U Q E J L I O | I U J L Q E;O
J P L Z E Y U | Y P E J Z L;U
R I H M Z Q U | U M R Q I H;Z
D F E W Y X B | X B E F D Y;W
M F E A V Z N | N M F E Z A;V
L V D H C N Y | N Y H D L V;C
G L Z F C R Y | F L R G Y Z;C
C G M A V E T | G M A V T C;E
C U L R O X J | O U J X C R;L
B T H K G S R | H R G B T S;K
X F S I N G M | F X S N G M;I
C H S P Z A O | O A P C H S;Z
S K D M Q L A | A S K D M L;Q
T X J Q R Z W | J R W Z T X;Q
I O C Q D S E | O D S E Q I;C
N Z Y S R X G | R X N S Z G;Y
W G P S Z A R | R P Z W S A;G
N R S U L H D | D U N S R L;H
K B Q W U J N | W U Q N J K;B
Z D J S C W U | S W J Z C U;D
R I U K C T Y | Y C R K I U;T
G X E J A U H | A H U J G E;X
I F D E B Y S | B E Y D S I;F
O W R A Z B Q | A W R Z Q B;O
I Q Y U E J X | I U J E X Q;Y
U W J A X P S | X P A S U W;J
Z T Y R L N U | U N L Z T Y;R
P U A K Y M X | X P U M A Y;K
A B F K O N X | B A F N K O;X
P Q I E U Z R | Q U I E P Z;R
U G X P J Q E | Q P X E U G;J
D L Q Y T P W | P Y Q W D L;T
D X Q P H G F | Q F P H G X;D
U O W X P K B | O U W K B X;P
F K U Z S E P | S F K E U P;Z
R J D Z V A E | A Z V R J E;D
X Z U G B I A | I B Z G A U;X
O Y F I T M L | T M O F L Y;I
I X Y O W U D | X I O W Y U;D
K P F A D M E | M K P F D E;A
B O D N F V U | N B V U D F;O
H D O Y J G E | H G E J O Y;D
E C U H P N Y | H C P E Y N;U
F R S X W I K | S I R W X K;F
T P R I U W D | R I W T D P;U
C N M E U I L | U E M C N I;L
C M O Y R J E | R Y J E O C;M
F P K C L S R | S P R L K F;C
J M U O E L I | L M O E U J;I
I E O G R V D | D E V G R O;I
M Q J H Z X N | X J H M N Z;Q
F T I Y U P O | T Y I U O F;P
F V T B Y M Z | M V Y F T Z;B
X D Y F C I N | N X C I F D;Y
V B Z Q M J H | V Q Z M H J;B
A J Y Z Q O R | J Y A Z O R;Q
P D L S H F U | H S P L U F;D
H Q A E L W V | Q V W A H L;E
G R X W O K E | O E X W G K;R
O T N J A I P | N J P O I T;A
O G B E N Q T | O N B T G Q;E
W K Z O Q I M | O K Z I W M;Q
O U H Z V G N | O V N G H U;Z
R N K W O Q Y | K N W O Q Y;R
Z U D W J Y M | J Z W Y M U;D
K O E A U X C | E A U X K C;O
B L F Z S K N | S N B Z F L;K
Z H W B G E A | H B A E G W;Z
U N Y P B Q L | U Y P L Q B;N
T N J E P O L | E J T L N O;P
W S T I Y J G | Y I S J G W;T
X F J A D L M | X D M F J L;A
U H G B K N W | U H G B W K;N
N C O K G E W | G N O C K E;W
P O D M R L V | D M P L O V;R
I Y O R S N J | R S Y I O J;N
E X V B R C Q | X B R Q E V;C
D L N E G I T | T D E N G L;I
Q A B Y O F X | Q Y F O B X;A
T O C H M L K | T L K M H C;O
K D F C I T Q | D T C K F Q;I
L G S F X V E | F E L X S G;V
G E S C N Y I | Y N E C S G;I
X A C P M B U | U P X C A B;M
I M S T F P A | I S T A M F;P
N I C B Z G A | B I A N Z G;C
Q S X F H G Y | F S H Y X G;Q
Y O M H X C J | J H M C O Y;X
Y L E Q I J X | L E I X Y Q;J
J Q W C Y H I | C Q H J Y W;I
K U W S L D P | U W D K P L;S
H A Z E N L D | D H Z A E N;L
T Z M E G I H | M I T G Z E;H
J G K Z R S U | K U R S J G;Z
L R U C W O J | R L O C W U;J
A T C W Q H Z | Q W Z C A T;H
E M J S Y A G | M Y G E J S;A
L P D N Z F B | Z D F L N P;B
J Q C M N B X | J C M N Q B;X
J U R P O X H | J U P O X R;H
Y X C K L J P | C K P L Y J;X
O A Y V Z D E | O Y E Z A V;D
S N U X P K R | P R S X U K;N
E Q S X H T D | H S D X T Q;E
E I U D V N F | U I D E N V;F
M Z D X E N L | X L Z D E N;M
T E N W V I O | I V O W T E;N
D O H X M B P | O M P D X B;H
M D J G Z U Q | Q D U G Z J;M
U Y M X V D P | X P D V Y U;M
C I H T W V K | I H T W K C;V
S I K D V G F | F D I G S V;K
G Y K I N Q A | N Q A Y I K;G
H B O K X V U | B O H U K X;V
O H X L U F G | F L X U H O;G
R O J C P H G | H O P J R G;C
O E M C F B A | B A E F O M;C
V A Q W R S G | A V S R G W;Q
Z C A V F L J | V Z A C F J;L
M X Q S J N A | M N A J Q S;X
I J Q G P T C | T C P J G Q;I
W O X I G P U | O G X I W U;P
J Y T E A Z I | A J Y T Z E;I
E K N P W Z F | E W N K P F;Z
D X U I H M P | D X P U I M;H
O T G S L N Y | Y N S T L G;O
A N K P F V G | P A K N F G;V
V F M E S J C | M V C E J F;S
E K D J U Y M | Y E D M K U;J
P S Y F U T H | S Y U T F P;H
L T Y F K J Z | K Y J F Z L;T
C N Q M E V I | E I V Q M C;N
B F H E V Z O | V F O H E B;Z
N Q J Z C H K | K N Z Q J H;C
S W Y Q G V R | Q R V W G S;Y
D X C G F I H | G C I H F X;D
Y I G C T Z B | B I T Y Z G;C
P A G O I E C | G C E P A I;O
G N U R X Z Y | Z Y U X G R;N
Z I V K G R Y | G R K Z Y I;V
W D B P X L Y | Y P L W D X;B
O T R Y I Z K | R Z O I K Y;T
Q O H W N M K | O K H N Q M;W
L W C X T Q N | C W T L Q N;X
M V W T Z P H | H Z V P W M;T
G S M A Z L J | M L J Z G S;A
S J N G R E W | N J E S R G;W
F A B X E C K | A K F X B E;C
O B L Z D H U | L Z O B D U;H
W F V G Y A Q | Y Q G A V W;F
C H O F Y S Z | O Z F C S Y;H
U K B N D E Y | D B K N U Y;E
U O S F B N D | U D S N F B;O
J B C V X K G | V C X J G B;K
Z I S V W T B | V I B T S Z;W
V A G C E T Z | A C T E V Z;G
L V D K Z X M | D L K M V X;Z
I L P B A O C | P O L I A C;B
Z J I A R O F | R O J I F Z;A
M O Q Y N S I | I N O Y M S;Q
X U V Y T K G | V G X T U Y;K
A S G Y T H V | V S Y G T H;A
L I U D R P Y | I R P L Y D;U
C X D U E H K | X H E K C D;U
M K E U Q W A | E A Q W K U;M
Z Q V J N B F | Z F N B Q V;J
B Y A L V F J | V J A B F Y;L
B C T A P L Q | P Q C A T L;B
L S Q A U K R | K S Q U L A;R
C Q I J G L V | I L C G V J;Q
O D R J Y B K | D B Y R K O;J
J N F P M K D | M J D P F K;N
H R Q O Y K I | Q Y O H R K;I
T N P Z Q U B | B Z Q U P N;T
H V L Z Y P D | Y P D V Z H;L
X Z I F L A W | L I X F W Z;A
J V P E A M B | M J V A E P;B
R Y Q U Z E O | Q U O Z E R;Y
W P B X D E V | P B E D V W;X
J W R V X B E | B V R X J E;W
Y W L Q B C E | L E C Q B W;Y
N G I H C U A | A C H G N I;U
L N O C R E A | E C O A R N;L
X M A B N D O | X O N M B A;D
F O U S E Z I | Z O F I E U;S
V F K X O N C | F X O C N K;V
K X V W H T S | W T X V K H;S
Y B Z P V E U | V B Z U Y E;P
N O J F P X H | H P X J O F;N
G Z A E J W T | E Z W J G T;A
B R K C N F G | B N R K C F;G
B X G Z P F I | X Z G F B P;I
F L E S R J X | E F R X S J;L
I V Z N A O K | N O Z I A V;K
N C S G F Y W | G W F C S Y;N
R Z G P J S T | P S R Z J T;G
R A J E P S Z | E J S R Z A;P
C P H O T K F | F H K O T C;P
F B O X D C J | O C B D F X;J
A Q M X J U F | Q J X A F M;U
Y L V S F M E | S M Y E V F;L
U P X B T K E | B T X E U K;P
K X J D L Q R | J D X Q L R;K
J N Q L C T X | T C Q L N X;J
W L T V P X H | P H V X W L;T
U P N O F M G | N P F U M O;G
L G Z J D U Q | J L D Q U G;Z
M A S Y N I B | B Y M S N A;I
K U F N S Z C | U C F S K N;Z
F S A H R C T | C F T S R A;H
Y E H I K C G | H Y E K I C;G
B X C E M J F | B F M J X C;E
P K X D Z W H | X Z W D K P;H
P M W J B U G | J U G M B W;P
U V N G X Z H | V X N G Z U;H
P F T H Y V A | H A Y F P V;T
P V Z I X F A | A X F Z V I;P
O E Q I N L B | N B I L E O;Q
A Y C P G L E | G Y E P A L;C
M C E B J D X | B J E M D X;C
S X H R K E F | E H S K X F;R
F J W C N U R | U F R J C N;W
Y K S D P Q F | D K F P S Q;Y
H A W G E T V | V A E G H T;W
N F W J D Y M | W J N D Y M;F
Z Q T I P Y S | P I Y T Q Z;S
U V W N O A Q | W Q O V N U;A
K S T H D E W | E D K H W T;S
R X C F D I G | G X C I D F;R
Z B H E F Q I | H E I B Q Z;F
T I C R H E V | E H V I R C;T
B S R K X N H | B H N R K S;X
E Q F W U O S | U W S F O E;Q
W F N Y M J C | J M N F Y C;W
T D I Z N R L | L D I N Z R;T
U B H N Z X F | H F U N B X;Z
E J K X U N Z | U N E X Z K;J
A M H U T C R | C U R T H A;M
A H D Y G M J | Y G A H D J;M
C I K X H J Z | K I H J C X;Z
S L P Z M T Y | L T S P Z Y;M
X F Z D U S Y | X U Y S F Z;D
Z K Y E G M S | Z K M E Y G;S
Y S P U O V N | Y P N O V U;S
N Q Y O W U M | N W M U Q O;Y
B U J A K S X | A B K J X S;U
R W L H G Y U | W U R G H L;Y
S J G H B R E | S B E H J G;R
G E T F I Q S | S I G F Q E;T
W O S X I P E | W S X O I P;E
Q J G P Y R O | O R G P Y Q;J
V O I S F B Q | Q F B O S I;V
B W Q J Z M V | J W Q M Z B;V
G Z J X O W N | O N Z G J W;X
X V H P E L R | V L E X R H;P
V Q B N U Z K | V K U B N Z;Q
L K F C W M J | J L K M C W;F
V Y B H U W D | W V H U Y B;D
A Z D S T C B | C D Z B A T;S
W X V B Y R Q | Q R W B Y X;V
C O D H Y X T | C H X O T Y;D
C R F E U X L | C L U R F X;E
E P G K A D S | E S G K P D;A
U Q P X Y F V | P Y X Q V F;U
V I F Y T H O | Y F I V T O;H
L M U K C P S | S C L U P K;M
P Z H E T J D | T E P Z H J;D
L I J V Y M C | V Y J L I C;M
U K J D O C M | M D K U O J;C
F B S W C N J | C S N F W B;J
K H V Z N B P | N P H V B Z;K
J M L D U I X | D L M J I U;X
P H I J W C M | H P M C W I;J
Q I X C S K V | Q S C I V K;X
L N O M P T Y | M N T L Y O;P
J Y G F E Z O | J E G O F Y;Z
B Q O G F E W | F E G W O B;Q
R Q T J U W D | D J T R U W;Q
G I Q J R O H | H O I R G Q;J
B O J C P T H | B O J H P C;T
R I H P T B K | T H B I P K;R
X Z V W S O G | Z S V X W O;G
F Q B Y A C N | N Q A C F Y;B
N K O U B A Q | K U A B Q O;N
V N B D C T Z | N B V Z D T;C
N V U J A Q Y | U Q J N V Y;A
H A F N W S G | G A N H S W;F
O J Y S W X N | S N J O Y W;X
I G J W Q Z X | W G J Q I Z;X
X Z U M B N E | M N B Z E U;X
K F C E T A Y | Y T F K C E;A
E G A J T L S | A G S E L T;J
O B G W V Z X | X G B V W Z;O
P M E Q R J A | E M J A P Q;R
Y Z T W L S N | T Y W Z L S;N
L G N P X Z R | L N G R Z X;P
G O M U R S F | F R M S G U;O
H Z I R D E J | J Z E R D H;I
R L F X I W V | L F W X R V;I
P N E H X B F | P H B N E F;X
I X C A K O G | O X I A G C;K
E T A Y I O U | U E Y O A I;T
P Z N U V G B | V U N B G Z;P
G B Q T S P W | S W B T P G;Q
V D Q R G I P | I Q P V R D;G
Z H E O P A S | S O P A E H;Z
A K O W I T P | O W T K I A;P
R H X Y O U G | H U O Y X R;G
D P U O X N A | D X N A P O;U
H Y E C O Q J | E H C Y O J;Q
L R N U Z T O | L U T N O R;Z
K S U N C H Q | U C Q N S H;K
A N H J E S W | N S E H J A;W
J F H L G P T | H F T G L J;P
M J K T Y X I | J T K Y X I;M
P I N A J C E | E A P C N I;J
S U X Q K D N | D U K S Q X;N
A R G H Q I W | H R A I Q G;W
E P X V D S J | D P S E V J;X
O I T E U R M | R I U O M E;T
Y Z C R P M U | Z R Y M C P;U
X F V Z W C S | V S Z W C F;X
N Y T K H L Q | N K T L H Q;Y
S H C D X N K | K H X D N C;S
N V U W D K L | U L N W D K;V
Q F X K Y L O | F L Q O K Y;X
V H D F K M Z | K V F Z D M;H
D F H R E S O | F O S D R H;E
X J C W H Y K | H K C X W Y;J
Z C L P V R X | X R C Z L V;P
Z E W M H G N | H N E Z M G;W
I O X K D N S | X S I N O K;D
Z S Y H W U A | Z Y A W H S;U
F D Q B P O G | P F G O Q D;B
A J S Y Q G B | G B Y J Q S;A
G I O C R S A | C G R S O I;A
A H I Q B Z F | H F B Z I A;Q
L Y Z S P A W | S A Y Z W P;L
Z N M P J O G | O J G N M P;Z
N J S T D Y U | N Y U J T S;D
R F Y S I V T | R I Y V S T;F
Q F J M U Y A | A Y F J U Q;M
L J Z D X O Y | X O D Y Z J;L
W T Y H M C F | W H M T C F;Y
J R W Y N Z L | Z Y J L R N;W
F G J Z R P S | F J R Z S G;P
A Y R W Z M P | Y Z R A W M;P
B I K W C D Z | I W D C K B;Z
B N K Z H F J | Z B J H F N;K
Z W A Q C R H | C R H Q A Z;W
G X Z J V U S | X G Z U S V;J
F N W O P B K | N B O P F W;K
N P G Y A T L | G L T N A P;Y
Q D M L V U I | I D Q U L M;V
F M X O H P D | P O M D X H;F
G P F Q K V M | P M K G V F;Q
A C E X V I J | J I E V X C;A
A S I J V F P | A F P I S V;J
L H T E F W A | H E A W L T;F
O C Q J X I A | J A Q O X C;I
L I O U C W F | U I L F C W;O
C K G X I R S | G X K I R C;S
G I K C L H S | C H K L S G;I
G D R C Q B Y | R Q Y B G D;C
W R G D P A S | G A R S P W;D
Z J P R I X V | V X I J R P;Z
R P A I K C B | P A R B K C;I
J I M W C U S | J C U S W M;I
S L G D X J Z | J S Z D L X;G
F O B M Z I A | M B O F A Z;I
D Y C V K U W | V C D W K Y;U
N P Z H W A J | A N H J P Z;W
R I E L P D A | L A D R E P;I
A B S Q E P M | M S A E B Q;P
K B E Z W L T | Z L E T W K;B
J R Q N M O C | Q J R C O M;N
U T W P G I R | T W U P R I;G
V E O R J H X | J X V H E O;R
D W Q L H Z E | Q Z L D E W;H
L K T G C V H | V C H K L T;G
U O J E L C Y | E Y L O J U;C
Y H B L A Z V | V Z A B H L;Y
R K U X C H D | K X C U D R;H
A J O Z I L E | O L I E J A;Z
H V J G R M B | B G R J M H;V
G A C J Y W Z | C G W J Y A;Z
W I D H L G Q | W D G I Q H;L
H D S E A N Z | S H D A Z E;N
P B J O A R Q | Q P B A R O;J
B Y G C N Z Q | N B Z C G Y;Q
S Z K C U R H | S H K Z U R;C
U V J L G X Z | Z G U L J X;V
T G R D S Z V | V R S Z D G;T
R W V H U B T | B R W H T U;V
R O L I X A M | O R L I X A;M
I L F P V G X | F L P V G I;X
Y K P T N L W | W L P T K N;Y
M S B V Y Q F | M B F S V Q;Y
V J Z E P W Q | W Z E J Q V;P
N Q B D T R E | D T R N Q B;E
S U C R Y N F | S N R C F Y;U
B Y N T X U K | Y U X B T N;K
H M J P V A F | A H F J P V;M
N V Z R T W L | N W L T V Z;R
D S N P W C I | W I S N D P;C
X J Z Q Y P G | Y P Z X Q J;G
G R X I S D C | I C D S X G;R
W B J U N F Z | U F W B N J;Z
Q T U P Y M I | I Y P Q M T;U
H B L D X Y Q | H Q Y L B X;D
K G C R E O B | E B G O K R;C
C T V Z U E G | E G U C V T;Z
N Z F H T D I | N T I Z F D;H
M D V O N E Y | E Y M O N V;D
F X J L C I O | I O L X C F;J
Q G J W P R O | Q G P W R O;J
F R Q N J V K | R Q F K V J;N
K L Z S E X W | X L S Z K E;W
U B S O D W H | H D B W S U;O
V K O A G D H | D G H V O K;A
T R E F B G Z | B T G E R Z;F
W D L H A F U | A L D F W U;H
Y X T M U Z B | Y X Z U T B;M
X W V G P S T | T W S X V G;P
Q W S J K V M | W K S M Q J;V
O N K Q C M G | C O N M G Q;K
Z X T Y N E H | N E Y H T Z;X
T R C I M G W | I T M G C R;W
Z O K G R D Q | Q O Z D R G;K
O A E M T S V | M O S E A V;T
B Z S G H D I | H S B D Z I;G
B L U R H X D | B R D U H L;X
N R L E Z V J | N V J Z L R;E
F M G U K T W | M W K U T G;F
Q Y O A Z S P | P S Q Y Z A;O
F U T G D S E | E G U S T D;F
H E W Z V T K | E Z W T H V;K
W O Z P N J X | X N P O Z W;J
G O I A N J Q | A N O Q I J;G
H S O B X I Z | H B O Z S I;X
M T S N K H A | A H T M K S;N
L U J X B D M | B D J U X L;M
N U E O A R Y | E U N Y R A;O
U O Q W X I V | X O V W Q I;U
J R Y M K F S | Y K R M J F;S
I N A M T X S | X T A I N M;S
C U W T H L B | T W H B U C;L
H Y F N X Q I | Y I N Q F X;H
E S W D C K G | D C G E W K;S
L I R V C Y S | S C Y L V R;I
P Q H E O S G | E Q G P H O;S
I H Y Q U V S | I U H Y V Q;S
N X Z U K A O | Z X U A N K;O
J H N F D M Z | D H N J Z M;F
K C T B S N O | O N C S T B;K
I F D A S T Y | D T Y I F A;S
I P O S Q D M | M S P O Q D;I
E I B V S K T | B V S I T E;K
O T K V P B N | N V T B K O;P
I K P W S U E | E K P S W I;U
R I T P H O U | P I H R T O;U
X G A N Z M T | M Z X G N T;A
G I J Y Z X H | Z Y H G I X;J
Z Q O U Y D N | Y Q O N D Z;U
A H P U J Z C | U A J C Z H;P
K X P J Q F M | P J X Q M F;K
Z W A R Q E Y | R W Q A Y E;Z
W G E R Q P Y | P Y G R E Q;W
G V O E M P J | M G J V E O;P
N F B G A X Q | F Q N A B G;X
E V N H M S F | E H V S M F;N
C D N R U G T | U D G N C R;T
D U A R N V I | V I D A U R;N
K F L N G V R | G V F N K R;L
R U C P N G M | G N U P M C;R
I M O G D A J | M D J O A G;I
C H I N J P D | J N D P C I;H
U L P Q N G W | N G L W P Q;U
D K V M S L C | V L C S M K;D
N Z J V Q S U | J U S Q Z V;N
C U B E P K A | P A C K E B;U
Q D I L K B G | I L D Q G B;K
L X T U E A O | L E A O T X;U
W P J K T X U | K T J X P U;W
U C V F M P O | C V U O P M;F
E R T C F B Y | C E F Y T B;R
D K U N B V X | U K N V D X;B
E M X A B T G | A B E G X M;T
Z Q F C M Y S | Z F Q M C S;Y
C K O S V M J | J S O M C V;K
K A I B S L Y | S K I L B Y;A
D B E P M T Q | B D Q P M E;T
W V S M P Z B | W P Z S M V;B
F G A L E J N | F A L N E G;J
Y J D L B G Q | J Y G Q D B;L
F Q L X A P O | L P A O Q X;F
Q D U T E C K | E Q K U C T;D
I B N J K F P | I P B F J K;N
M L B O A V X | X O V M B L;A
Y K C Q O D S | S D C O K Y;Q
S M K D E U I | S I D E M U;K
T M S Y Q A C | T S Y A C M;Q
C V Z R J U L | Z R J C L U;V
E G D Z N S Q | Q E G D S Z;N
A W P Z X J V | J W Z A V X;P
C R N B G O Y | Y C G N B R;O
B A F E G X Z | Z G A X E F;B
J N F M U P T | P N F T J M;U
H J O X K B G | G K O B H X;J
F M Z L U Y J | U L Y F M J;Z
O B Y Q W J Z | Y O Z Q B J;W
S A D E I F X | S I E A F D;X
Q B V N C O I | O V C B Q N;I
G R N U F O E | U G N R O E;F
Z A O C F L T | T L A C Z O;F
C D E A T Y J | T J D E C A;Y
M L X W D K N | M D W N K L;X
I Y Q K R F X | F I R K Y Q;X
B O I Z E H G | G O E I B H;Z
N B J A C I O | J C B O A N;I
M G E T H C J | G J M E T H;C
R U I M D P K | K U M R D I;P
G I X P N Z K | X P Z G N I;K
W I H G N Z S | H N Z I G W;S
L M X J E R D | L J M E R X;D
H Q Z V G N R | H V N R G Z;Q
I M B G X P R | M B P G R X;I
B E K V D T Y | V T E B K Y;D
C P Y O B V T | T V O C B Y;P
U M K O G I E | G K I E U O;M
E A M B C J N | B M J C N A;E
Y J M A R E I | R J I E A M;Y
V J U I Q C X | J X C V Q I;U
K O R N J S Y | K O J R Y S;N
M T X V A O U | O U V M X T;A
M P U H O W A | P A M O H U;W
J I A U Z E M | A J E M U I;Z
F V N C P S D | P F N V D C;S
V T Q S K H C | Q H K V T C;S
Z C L G Y U D | C L U G Y D;Z
J X H Y M L A | H Y X J M A;L
V E K F M X T | T F E K M X;V
E N K P A B D | N E P B K A;D
W V M G Z C U | Z W C M V G;U
O X N K D G R | G R X N K O;D
J C M L T H D | M D T H L C;J
Z T H L G M J | G M Z H J L;T
U O N M Y R L | R O N L M U;Y
O Q V I X T G | G T I X O V;Q
M B I D L F H | D B F H L I;M
Z U C A L Y F | L Y C A U Z;F
E P Y Q X R I | R E X I Q Y;P
Z L X D M E I | D L I X Z E;M
I E W T G D Y | D W G I Y T;E
I Q F S Y Z R | Q F Y S R Z;I
V J G P C M N | J V G P N C;M
T F G P C Z U | P C Z T G F;U
W Z E X J N L | N J W E Z L;X
H W T Z J P R | Z R P J H W;T
S K W J A Y I | W J S K A I;Y
Z P D V R Y A | R A P Y D V;Z
H L R V J F A | V A R L H J;F
N V B U K L S | V N K S B U;L
V L U H B K E | U L H V B K;E
Y V U W O Q E | V Y W U E Q;O
E Y P J A F L | A E J F P Y;L
L K W G U S D | K U W D S L;G
V F J K D H C | H J V K C D;F
M K E H C T J | C T J E M K;H
W H G Q L S X | X Q G W S H;L
R A E J M N I | A E N I R J;M
P T H G W Z A | A P T Z G H;W
L P D M V T Y | Y M L P V D;T
O Y D M R B K | M O Y K R B;D
G H C U X A J | U G C H A J;X
J S B U I F H | B J F S I H;U
Y A K I U E J | Y E A U J K;I
B U M D W K Y | M B Y K U D;W
Y P M G T F K | F G Y P K T;M
X N P S O U T | N S U X P T;O
H B I U X J T | U X J B H T;I
D A K L X F O | K O X D L F;A
L S J H N V T | J S T V H N;L
N X A M S Z B | B Z X S A M;N
L W A Y S X I | A W S X L Y;I
Z K O G M B A | M K A Z O G;B
F Z I S V X D | X Z S D V F;I
N C Y I R F Z | F Y Z N R I;C
P G D C Z H R | C H D R P Z;G
J G D I T L Q | J D I L T Q;G
O D V Y U F Q | V O F U Q D;Y
Q X V U F T S | V Q S F U T;X
C J T R G W N | R W J G C N;T
A S Z O H U V | V S O H U Z;A
O Y B X C E N | Y X C B E N;O
I K U X D N E | X D I U E K;N
I X C U R B O | B X I O R U;C
E M G R L A J | E M R G A L;J
W Q F E J G N | G E Q J F N;W
G F S L I Y R | G F R L Y I;S
G V M C Q N H | V M C G N Q;H
F W K U E D I | F U D K W E;I
C N Z O Q J F | J Z F N O Q;C
F D P C B R K | D R B F P K;C
E T P O V M H | T O V P E H;M
E W X T O N Q | E N T W O X;Q
V N G T R O Z | V N R T Z O;G
B U M Z X S G | X G M U S B;Z
W T A I B D Z | D W I Z A T;B
Y N I F Q V A | I Q A N V Y;F
F N Z H L I X | L X Z H I F;N
N I U C Y T H | H U Y T I C;N
N Y E M K C J | N M E Y K C;J
D R Q W Y M S | W D R S Q M;Y
L W D Z P F R | Z L F P W R;D
K W U L Z P F | K F L Z W P;U
S H Q L U P J | L Q P J S H;U
Z H R V X D O | R H Z O X D;V
P Q C M J X W | M Q X C J P;W
W E Y I J A X | I A X W E J;Y
G B J S P Q Y | Q P S J Y G;B
H I G V Q Z C | G C Q Z H I;V
Y U K B Q R C | C R Q K Y U;B
P I B U Y L Z | Z U P I Y L;B
Z I J M O D W | I Z O W D M;J
I C M N L J V | N M J I V C;L
D Y N B H K L | K N D L Y H;B
F C N J R D Q | C F Q J N R;D
A X U F G Q N | A N U Q G F;X
J N Y O B T C | Y B J T O C;N
P H A B Y D M | Y B A M H D;P
D P V F M J C | M C V J P F;D
P A H L Y B S | P S Y L H A;B
K I J V E B F | K V F E I J;B
E O J Y N V U | U E J Y V O;N
H T W L Q V O | W V O H L T;Q
N T P V X R O | O X V N R T;P
P J N E S Z U | J N E U P S;Z
E B I R Q G V | B R G E V Q;I
G F M S N L U | U L M N S F;G
M J Q R B I K | I Q J R M B;K
G U H O Q F N | Q H O N U F;G
U X C O I W N | O W C I U N;X
L Y Z Q F C J | L Q J C Z F;Y
Q W M V K R S | M S K V Q R;W
I Q V A H G S | H G I Q V A;S
O S R B W U Y | U W S Y R B;O
I G T C S R P | P I T R G C;S
C H U V S T Y | T U Y V H C;S
P Q F M B A R | Q A B M F P;R
X P Z M I S H | M H I X S Z;P
F U D M Y H A | U M F A H Y;D
P F Q I N T J | J F Q T I P;N
Q S Y F X C I | I S Q C F Y;X
E X Z B P K Q | K Q X P E Z;B
L K R O C A W | R W O A C L;K
V L F Z N B K | K V B L F Z;N
R X F K D B A | F X R K B D;A
M S L K V B E | E B S M K L;V
V H D G A E O | V E H G D A;O
I E T D H C B | E C I B D T;H
R Q W H M F T | T W F R M Q;H
Q T A V P K E | Q K E A P T;V
Q Y K U J E I | J Q Y U E K;I
M H I D Z O U | H D Z M I O;U
X T K E M F H | M E F X T H;K
T N F U S C R | R F U C S T;N
B K C J H M T | K J B T M H;C
T Y N X Q C B | Q T Y C X B;N
W O I C H S J | H O W C J S;I
S L Q D U O Y | S L O Q D U;Y
B K P R O L I | O P I B K L;R
Y N M I O P U | N P I O M U;Y
S C W D M J U | C U M S D J;W
O V X J S B G | J V B O G S;X
Z L W H U E F | Z L U E W H;F
Z E J U H T A | E A J U H Z;T
O Q J W G F X | Q F W X O G;J
X W Y U M Z J | W X U Z Y J;M
L I D O M W Z | D Z O M L W;I
N Y E T M C D | E Y C N T M;D
V F Q Y S B L | L B Y V Q S;F
G E M K O U N | G E K U N O;M
T M X B L O C | L C O M X T;B
Z I N T L E X | E Z N I T L;X
B X V Z H C U | H V B Z C U;X
X C O G Q K J | X C G J O Q;K
Z A D L H O Q | D L Z Q H O;A
S W J Q V X G | S X V W Q J;G
T R S Y M Z I | Y S T Z R I;M
F A D Z C V O | Z D A O F C;V
D K I G N U T | U G D T I N;K
Y D S A H C F | S F Y A H D;C
L X M Y V D G | D V L X G M;Y
J L R A V I G | J R A V I G;L
E G D R Q Y V | G D Q V Y R;E
H E O L U Y Q | O E U H Q L;Y
K I X J C Q B | C Q K X B J;I
T U K N V E Q | N K Q E T V;U
J Z H D L A G | Z G L J H D;A
O R Z M H I U | Z R O I H M;U
I Q G H E Y L | Q L H I G E;Y
Q H M R I P J | Q H J M I R;P
Q G T O Y H M | O Y H G M T;Q
B J D W F E N | F B J D N E;W
F O W A X B C | C X B W A F;O
E W B C M A G | E B G C M A;W
X W Y O A G J | Y W A G J O;X
S V U I Y Z O | U Z O V Y I;S
D Z L X V H B | B V D L Z H;X
M S X Q B V W | M V B X W Q;S
X N V U Q B I | U B N Q I X;V
S H P O I V N | N I P H S V;O
J R I H F D Q | H I Q R J F;D
V Y Z K S D W | K S V D Y W;Z
A V I E U F K | E U V A F K;I
K H N C Z Y V | C H N V Y K;Z
F Y I D E M Z | M I D F Z E;Y
E Q V L B D C | B Q E D L C;V
Q X W B L C S | X L B S Q W;C
D U W K L M P | D W L M P U;K
S X N K O E Y | K Y E O N X;S
Y A O M U J I | I A J U Y M;O
E K L W V R B | E R W L K V;B
G F P L X B V | F B G X P V;L
N W A U X B V | B V W A U N;X
W Z U D L H O | U H O Z L W;D
Z H U S I N B | I B N S Z U;H
S T N C Z H Q | Z H Q S N T;C
H E M Y B A Q | H B A E M Y;Q
B I H V A Y N | H V A Y B N;I
X J C P U H B | X B C P H U;J
F H K R N X D | K H R N F X;D
Q M J I F C B | B J C M Q I;F
W L T V G Q A | W T A V G Q;L
Y H B M W U O | B W O H Y M;U
O B K Q A X N | A O N X B Q;K
Q H G O Y X J | G H J X Y Q;O
V S L Z J A B | J S V Z A B;L
O T B F P Y D | P T Y B F D;O
Y J T S E B M | E J B M Y T;S
Z Q S Y N B C | B Z Y S C Q;N
B X P S U N L | X L S U P N;B
M W U E J S T | T S M J U E;W
F P M N C D A | D P C A M N;F
C I G X E P M | X I P C E M;G
T C B W U F P | U B W P F T;C
E Z R V I X H | V E I R H Z;X
B V G A M S D | A D M G S B;V
G Z Y Q I H X | Q I G X Z H;Y
G H F M Z A E | Z H M F E G;A
L O H V Z X Y | O Y V Z H X;L
R G Q A D J Z | R G J A Q D;Z
N E L D G T I | N L G E T D;I
N P D J R L O | D N P L J R;O
X S V U Z J P | P U X Z V J;S
O E C K W N D | C K O E W D;N
V A X D E B S | X D S E A B;V
G O T H Q S I | S G T O H I;Q
G Q Z A D C K | K C Q Z D G;A
B O T M Q X J | B T M J Q O;X
W H C U F K O | F U O W K C;H
E G C S L T V | S T G V L C;E
C I F Y P S T | T F P Y S I;C
V I R C J Q M | Q J V R C M;I
G I U B Q Z D | G Q Z B I U;D
O J F I V A E | A I J O F E;V
T C U S B R D | B C U D R T;S
B W Y D L E P | L D E Y P B;W
E X G V I O M | O G E M V X;I
U W O M H R K | O H U M W K;R
H X K T R Y P | X T R H K Y;P
P K N Q E D J | E Q N K P D;J
W Z Q S X I C | W Q C Z S I;X
H F M W R Q K | K Q W F M R;H
Z M D C U N F | Z D F U N M;C
T L Z Y I B Q | L I B Z Q T;Y
U B M A T G I | B U G A T M;I
E A C B X F J | X B A C J F;E
K W O A C U Z | K W A U C O;Z
X D P S R W Y | P W Y D R X;S
F X I R D Q N | D R Q N F X;I
J Y A M S Z V | A S V M J Y;Z
X A S I R Q K | Q R S K I X;A
K J V P N Z Y | V Z Y N J P;K
T J Z K M A D | A J T D K Z;M
W P E R H F Y | H W F R Y P;E
G P W L D B T | W T L P D G;B
O M C E D F Y | Y E D O F C;M
H S F R B U K | K R F S H U;B
L C V J O K P | L O K P C J;V
J R B A G T E | J B G A E R;T
S J F D H V R | F D J S H R;V
U X E F W R T | U F W R T X;E
F M D N W U Y | N W D Y M U;F
S M W R Q F E | Q F M W E S;R
Y A P E C Q T | A P Q C T E;Y
A I E H L M B | H E M L A I;B
Z V X O P R A | Z P A R O V;X
L D Z S P Q B | B D Q S L P;Z
Y R M U G E O | Y R M U O G;E
G Z W P U S T | W P T S U G;Z
D G X T Q U O | U T Q D O X;G
Y I J G C N D | J D I Y G N;C
W H I R D N A | W A N H I R;D
W M C U N B T | C T U N W B;M
M Q V E W B G | W B Q M E V;G
R G M V S A W | G W V S R A;M
M A E G T Q V | T E M Q V A;G
F B J R I T C | C R I J B T;F
O V C H Q P S | C V O Q H P;S
N S U D R Z A | U Z S N R D;A
I M O Z J G B | B M O G J Z;I
A V S P F B L | B P S L V F;A
X J A G S U R | U G R S A J;X
G S Y D L J H | Y D S G J H;L
I T M N A H X | X M T A I N;H
C B E Z L J R | Z C E R L J;B
A U E I W X J | X I W U A J;E
V S Q H U L B | Q L H S B U;V
K V Y P O U C | Y U V O C K;P
Q F T G W U N | U N W Q T G;F
T B E W N R X | R B W E T N;X
E J A C N U H | H J C U N A;E
Y G Z C T A P | T Y Z A P C;G
J E X T B W Y | Y W T B X J;E
Y X R E B A J | E Y A R J B;X
C R V Z M Q K | K M Q V C Z;R
R A C Y I J U | I A Y J C R;U
Q J S K N W Y | K Y W S N J;Q
R K Q J O Y I | I Y J O K Q;R
M S Z B V F R | V F S M R B;Z
P N B C T Z W | C T B N P Z;W
Y W N I F D U | F D N W U I;Y
R A M J B T F | M T F A R J;B
Q T B W U C I | W U C Q I B;T
E Y J U X T S | T S U X Y E;J
K T B F S R Y | K Y R B T S;F
D W U J Y N S | J N U W D S;Y
K N I U S A X | I A S K N U;X
E D B V L Y Q | L Y Q D B E;V
F I B L N E O | L I O F B N;E
C R M T F O J | C J M O F R;T
J Q I B R N H | J N H R I B;Q
Z M E H R O L | Z O L M E H;R
J L F E R U M | U R E L J M;F
M V G Y Q U H | Q U M H V Y;G
T G R Z O I X | Z R X O T G;I
M H K T Y W N | T M Y H W N;K
P E T D B I K | K E I P B T;D
J B H N Q U K | Q B N J K H;U
W X C Z M I F | Z C I W F M;X
N H D W J I Y | D Y I N J H;W
A C W I V N F | A N W C I V;F
F G B L N K M | K M F L N G;B
C H A R F T Q | H A C Q T R;F
U B J O W Y P | B J P U O W;Y
V J K T L N S | T L N J K S;V
F L C P U X K | K F P C X L;U
N K D L Z A H | Z K H D A L;N
J O A U X H T | J X H T O U;A
B I S O X V E | V I X O S B;E
Y K R C A W N | N C A R W Y;K
H N U K E O V | E N H K U O;V
T G B D L Q F | Q F T B D L;G
L W M Z I V X | I Z V X W L;M
Q C W P V G Y | Q P Y V W G;C
A T O Q V G Z | Z G T A O V;Q
B W V Q R S X | V S Q R B X;W
Z O I G K S Q | S K I G O Z;Q
I B C Q T Z E | I Q T E Z B;C
X K T D Y U H | U T Y K H X;D
G M Q O X F W | X W F O G M;Q
I B X G P V U | U V G P X B;I
S W P Y T F K | P S K T Y W;F
X O K M C I E | E I M K C X;O
N P Y F C K A | A P N C K Y;F
P A F T Q C Z | C Z P F Q A;T
D G R M Z N Q | G Z M D N Q;R
J V L R X C D | R V J D C L;X
N E R K C B A | B C E A K N;R
S T E D G I R | G I E D R S;T
D H W C A Z I | I D Z C A W;H
A M T Y L S P | A T P Y M L;S
Z P J B X W F | B P F Z J W;X
J G I K Z P S | P Z I G S J;K
Q G N C E W L | L N E W Q G;C
V O Y Z J M L | L Y O M J Z;V
X L D N W F B | B L F N W D;X
A N P O X D W | N P W A O D;X
T X J I H C W | H X I T J C;W
Z X S K U L M | K S U M Z L;X
X D P W C U S | S U P W D C;X
S R J I C F U | U I F S J R;C
B R U N V J W | W U J N V B;R
R U F T J I G | T R J G F I;U
R T M U X F A | R M A U T X;F
Q V I R B K X | V B X Q I K;R
K C N Q B Y G | Y N C K B G;Q
E T M D G Z W | Z E G T W M;D
X B F M A Y R | R M Y X B A;F
R B S N Q K X | Q S R N B X;K
I Z N F W V P | F Z P I V W;N
R V D B X J W | B D V X J R;W
U O Z W L H K | H K W Z L U;O
T I N V B R Q | Q I V R T N;B
F A S Q R K B | R K S F A B;Q
M F S T O Z E | F O M T S Z;E
I S O K M Z D | I S Z K O D;M
F K J V H B M | V B J M H K;F
T Y F V Q X N | Q T N V Y X;F
O X Q V K T L | T Q V X K O;L
D E U J B F X | X U E J F D;B
F D O A C M V | C A O F D V;M
M X N C O W U | N W X U M C;O
N I M P T O K | I N P K M T;O
W E B U R Q S | Q R S E U W;B
W N F H M L O | F M L O N H;W
X C D I F R Y | R F D Y C I;X
B R V X N K D | R X N V K B;D
I L B M S Z K | S L B M K Z;I
N B Q J R Z L | J R B Q Z N;L
H F I T G K W | K F H T G I;W
E A V F Y W S | V A S E W Y;F
S T W V X L Z | Z L V W S T;X
C X R K D Y Z | R D Z C K X;Y
L Y V P O Q U | U L V O Y Q;P
A K E M W Y O | Y M E A O K;W
M D B L O W N | M N L O D W;B
H U W F G I L | G L I U F H;W
X L D Y M R G | L X R G D M;Y
G R W A Z M H | A Z W R M H;G
I L A M W Y B | Y L B W A M;I
C A T X J K B | C A B J K X;T
R C Z A Y M J | C Z Y M R A;J
H R P U I O N | N H I R U P;O
K W A N Y T I | T I N K W A;Y
Q R H X P U I | R H I X U P;Q
I C B X Y U K | K I X C U B;Y
Y Q E J N I D | I D N E Y Q;J
P X B Y T G A | B P Y G A T;X
W M K X G A R | W M K X G R;A
N R K C D A I | R D I A K N;C
I U L O X V W | U I X O V L;W
E X D B U P A | U X P E B A;D
B Q F P L U R | F B Q L P U;R
Q I L K N G W | G L K N Q I;W
I K O C F B W | K I O F C W;B
T V F P J X G | F P X T J V;G
E I L U H K A | K U L I H A;E
S E J V M I Z | Z V M E I J;S
M H L O D C W | H W L D M O;C
N U X E R I Y | Y E I R X N;U
L T A J Y K D | J A K D L T;Y
S L F E D O A | E A F D S O;L
R G Q K V I X | Q K R X I V;G
P J V W Q C B | B W J Q V P;C
A B T W S O J | T O A S W J;B
R T N H A L S | H N A S L R;T
Q G W Y A J X | Y A W G J Q;X
Q T N A W L K | Q L K W T A;N
E A Q B M P D | E D Q B P A;M
O L Y K F I B | I F B L O Y;K
N I G S T E K | I K S G N E;T
E Z K C I H R | Z H E R I C;K
G N B Z E A I | B E N I A G;Z
T W P G X C M | T P M C X G;W
Q P L J K G Y | K P Q G Y J;L
H Q F L W N G | L H W G Q N;F
F G T R J B X | T F G J B X;R
X J Q Z S T D | T D Q Z S J;X
K V J I H T B | T K B H V I;J
H A W S R Q F | Q W F H R S;A
R V E L G Q T | E L R G V Q;T
N M Z O Y A Q | Y N O Z A M;Q
K Y C U M B G | U Y C B G K;M
E N F I M R X | X R N M I F;E
F S V E J N M | F N M J V S;E
X D N T S W O | S X N T O D;W
G H N J T L U | J U L G N T;H
C G T W L H N | W N L G H T;C
F Q U E M A H | H U A F Q E;M
G R J Y B M V | B Y R M J V;G
H Y E P I N U | P E U I Y H;N
U V M O F J K | K V J O U M;F
D Y I F A R Z | D R F Z Y I;A
F N H Y E R Z | Y Z E R H F;N
Y B T W I Z G | B G I W Y Z;T
V E X Y U L G | U X Y E V L;G
D H S P U T X | X T D P S U;H
J I U R X Z P | J Z P U I R;X
S O Y A E M K | A E O K M S;Y
Q K A E R N P | K A R P N Q;E
M V Q E W T N | W V T E M N;Q
H E U K T Y L | Y T L U H K;E
W S D K N C V | D S N K C V;W
G W L K Y F B | B G Y W L K;F
I J C X E V P | I C P E J X;V
D U P V G H K | G V H K D U;P
T L G W U I Z | W G U T Z L;I
C J G Z V F Q | F G Q V C Z;J
C I R Y X P M | P C I X M Y;R
E Y N Q B H S | B Y Q N E S;H
X T A N W F J | T N X A J W;F
U L D I W X Y | L Y W U X I;D
C W O L P G T | O W G T C P;L
V E B K A U W | E B A K V W;U
S R G J F A O | G O S R J F;A
R B N Y F E G | N F R E G B;Y
G R T X Q P N | T R Q P N X;G
Q N A Y R Z M | R Q M Z N Y;A
C L K G J D M | L G D C J K;M
Y T S W Z H N | S Y W Z H N;T
N J A X B Y H | H J A N Y X;B
Q K G E X U Y | Y G Q U X K;E
S A D O V P B | O D S V A P;B
E S T D W G I | G W E S D I;T
R U O L N J P | L P R U O N;J
A B D Y V U L | V B A D Y U;L
O K L I V N G | O N I G K L;V
X F M G Q B J | B X G M J Q;F
J P O B L H N | L H P O J N;B
L X F Z V P J | Z F L V P X;J
W O S N C U Z | S C W Z U N;O
L S R W Y H D | S D L Y H R;W
Q V K L O J X | O V J Q L K;X
X R L Y S J P | S L J R Y X;P
O E V Y N U P | O N Y V E U;P
U T A Y E X I | E A I U Y X;T
O U D X N K W | O K D N X U;W
K C N I O P V | V K N I O C;P
I Q K O M P A | K O M I A Q;P
H S R Z M G K | R M H G S K;Z
E C P T V Z G | C E V P Z T;G
J S Y N Z M I | J Z N Y M I;S
D J I B Y H W | J Y B H W D;I
B V U D P S L | S B V P L U;D
Q Y S I B U H | Y Q I B S U;H
A Q P R V S J | V S P Q R J;A
U O E I G S R | S G R E I U;O
V Q M B P C L | V L C B P Q;M
R Y W O B H J | H J W O B Y;R
B Q X U I R S | R Q I B S X;U
J B X R N L V | R X V B L J;N
X G N D B Q O | Q X D O B N;G
K X V M J C Y | J M X C V K;Y
N P O Q S B D | O D N B P Q;S
K T V O P Q U | T U O K Q V;P
C B V L H U X | L C V H U B;X
L P Z C E X H | Z L C P H X;E
X W V A Y N K | A K V X Y N;W
J I W A K H D | I K D A H J;W
B Z S X Y V L | Z V L X Y S;B
D I V W K M B | I M W V K B;D
N A C W I S K | N S I K C W;A
G J L A U N E | E J U A L N;G
V O Y N K P I | N O I P V Y;K
X N L U A K W | N L W A X K;U
K W E R T Z C | R Z W T E C;K
F I J A T M O | T O A M F J;I
B T Q M C U O | T M U Q B O;C
U K J X Q H S | K H Q J X S;U
T S G Q Y M U | S G M Q U T;Y
B A Y C R U W | A R W U B Y;C
G N T I E C H | G C I N T H;E
O H I V D E L | D L H E V O;I
J Q X W R V I | Q J W I V R;X
D J M R O S P | S J R D P O;M
F K P V T X E | P T X F E V;K
V M K W O U J | V K J W U M;O
Z V D I H X W | D X H Z W I;V
Y X Z W O K N | W O Z N K Y;X
Z E V T M I U | I Z T V M E;U
F Z N B G M D | Z B F N G M;D
M X C G J E V | M V G J C X;E
G O X T U M D | O G D M T U;X
B T O G F R W | W R F G B T;O
I Y A U W K F | W U I A K F;Y
H T U R Z S I | U Z I R H T;S
J Z S B X N O | O N B J Z S;X
B J L R W Z A | A W R L B J;Z
P L N B Q D S | B L D N Q S;P
H V D B J W Q | W J H B Q V;D
A C S L Y E X | E L S X A Y;C
D I N S W U R | W R S D U I;N
O H W I X Y Z | X O H Z W I;Y
F J O A S E X | F A O S E X;J
K G N I M U V | V I G M K U;N
A G U M O B P | U M P A B O;G
V K F P E Y O | V F P Y E K;O
E V R K T G X | V G X T K R;E
N G V A Q W H | H N V W A G;Q
K S X O V C H | K S V C O H;X
U S V J Q I F | V J Q S U F;I
K B L G I S Z | I B G L Z K;S
B X F L J K U | U F L J B K;X
E M Y O J G R | O E G R J Y;M
U D W P L I F | U D F L W P;I
M S V F H T W | H M T F S V;W
H Y C E R T P | H E P R Y C;T
S L W V U F J | V L U W F S;J
C F Z T B R L | R C Z L F B;T
Y O I R Z W K | R K Z W I Y;O
F V I B R J N | J V F I N B;R
P R C I F L N | C F R L P I;N
J M O G Q N P | G Q P O M J;N
Q P M V U B K | P V B K U Q;M
F T M V Z A C | V T M Z C F;A
C A Q F Z M R | F A C M R Q;Z
I A V K B H R | I R B V A K;H
U B G T S C V | T V S U C B;G
W C N S R K J | S R W K C J;N
T Y U N D X O | T U Y D N O;X
H U F S N K Q | Q H K U S N;F
F I Q E D O J | Q J F O D I;E
A X Y U Q P I | Q Y I U X P;A
Z D G K E R Q | G K R Q Z D;E
R V U D W P E | V R P E U W;D
G I P F U H D | D U H I G P;F
B A P O E L G | A L G E O P;B
E I O N B Y Q | E N O Q Y B;I
N P Q O G M A | Q P N M A O;G
M N L Q W H V | W V L Q M N;H
V W J S H E U | J V S U E H;W
B W P S F Q R | F Q B W P S;R
V A Z S D U H | D Z U V S A;H
Q S K I R A B | A S R B I K;Q
Y U T F H O X | T Y O F H X;U
J K O S I F R | S K J R F O;I
T N M B Q O I | Q B O N I T;M
A Y N M J X R | J N Y R X A;M
F V L W S P R | W S L V P R;F
J T L C H Z X | H Z X J L T;C
W K R T A D Y | D T K Y W R;A
N H G X E A S | N X S G E H;A
S N D F I A Y | I F S D Y A;N
F D S P Y J I | Y P I J F D;S
A P J C N B Y | B C P J Y N;A
X C L H Y R D | L D R Y C X;H
E G C A W L F | A C G W L F;E
N G F E J X C | N C F J G X;E
F X A J E W U | J E U X A W;F
E D T R L A O | T O L D E R;A
O F B J C V R | B O V F C J;R
X F E Y N Z Q | X E N Q Z Y;F
I O W N K L U | L N U W K I;O
K Y D P C F U | Y F P C U K;D
C A H Z T D Y | Y H C T Z A;D
J Q L V W P B | V J P Q L W;B
M D O V I P Z | P I M Z D V;O
K D R J I Z G | K I R J G Z;D
J Y X M T N L | Y T N J L X;M
A D T L B G J | G L B T J A;D
X T A G F W N | G F A N X T;W
G Y L H U E K | H E K U L G;Y
G K H Q W R F | W R F Q K H;G
X W N J F D B | B F J W N X;D
C L D B Y R W | R L C B W Y;D
H Z J M P X W | W P M J Z H;X
J G K N Z X U | J U K Z G X;N
S X F B P T U | X P F B U T;S
R Y G H Q J Z | Z Q J R Y H;G
O G Y R C L V | O C L R G V;Y
J L V U Q Z S | V U S L Z Q;J
S G R W P O X | P S R W O X;G
Z M T A R D V | R Z T M D V;A
R O U C V B T | V O T U B R;C
A D O C V B R | R V O A D C;B
N Q A J E K F | J K Q E F N;A
Q V K U S C R | R K V Q C S;U
L B I U N A M | L I B U A N;M
X C D R G P Y | R D G Y X P;C
K Y E X S D M | X S Y E K D;M
A N B Z I X H | H I X N Z B;A
R W B D F V Q | D Q F B V W;R
Q Z Y L T V I | Z Q T I Y V;L
D W V Y J E Q | E W Y Q D J;V
E L I S V G U | G L S E V U;I
A D E N P I C | A E P N D I;C
Y I R A E S U | U E R I Y A;S
T W S I V X J | J W I V T S;X
R Z X M J Y U | J Y M U Z X;R
S E M J F D G | G J D F M S;E
Q Z T S U P K | T Q P U S Z;K
H I K M R Z U | H Z R I K M;U
O E B R X M J | O E J B R X;M
S Y G F C A E | S Y F C G A;E
V R I M G D Q | Q D I V G R;M
X F J O B T A | J B F X T O;A
X Y J O T B W | O X T B J Y;W
E I B R X S N | R E I B N S;X
Q P J M Z S X | Z X P J S M;Q
Y N G P O W F | G Y O F P W;N
U S Q D V O K | U Q D V S O;K
V J H D R B E | D B R E J V;H
K Z H E I O T | T Z O I E H;K
A V P M E U D | V U E P D A;M
Q U F A O V Z | Z Q U A O V;F
B V Y Z U N H | N H Y Z V U;B
N V O S A R K | N R O S A V;K
G D E B O S X | B S X D O G;E
L M O T V C U | C U T M V O;L
P X D Z A J Q | D Z X P A Q;J
A S R Z L V D | D V S L R A;Z
N S M W J T Y | Y W S N M J;T
X V N U G M F | U F V X G M;N
N L V B J X S | S B J V X N;L
P S T D H X K | P S K D X H;T
N Y G O E M V | N M Y O V E;G
K Q P W T X L | X L Q K P W;T
I F D U H V N | I F D H U N;V
V T B Y S L O | B S L V O T;Y
K M R U F E Z | R F E M Z K;U
H X D K U Q O | K D H U O Q;X
M H G A X O P | O X A H G M;P
E J D Z X F S | S D Z F X J;E
Q G R O E M Y | G M E Y R O;Q
G K D P Y B C | C G P K Y B;D
N J L U P B R | N J B U R L;P
J M R K G L Y | L R J Y K M;G
X Z T C S V L | T Z L C S X;V
P L X G M E D | G M P E X D;L
T Q O R X C F | Q O X F C T;R
U A K J R S I | R U J A I K;S
E F J Z V L K | F Z E K L J;V
A E V Q Z T G | Q T A E Z V;G
R D P E G I W | P R D W G E;I
E O P N W D L | N W D E L O;P
U E M K V C W | W K M U E V;C
Q I U W L T F | F U T L I Q;W
W H F X J C R | X H C F W J;R
S P O Q B J D | D O P S B J;Q
J R I X S Z K | K I J S Z X;R
N S H B D I L | S B I H N D;L
E R M L P U B | R M B P L E;U
M E F R B X Y | R X Y F B M;E
C Z Y S T G J | G J Z C Y S;T
Z T D I N F H | N I T D F H;Z
K U P A G N C | C N U K G P;A
R Q Z C M X A | A C R M Q Z;X
K F P J N S Y | Y S N J P F;K
Z A L Q R P B | A R L B P Z;Q
K S B X H P L | B S K H L P;X
U J O C V T N | O N U C J T;V
R B Z F T C X | Z X R T C B;F
U Q L K E S W | K W Q L E U;S
G C E T L F V | E V L G T C;F
D A G T B L S | D G T A B S;L
Q C Y F V K P | K F C Y V P;Q
O Z N D A Y Q | A O N D Y Z;Q
Q M D C U J K | U K M C Q D;J
M V Z J F P T | T J P V Z F;M
Z O T B Q X N | X N Q Z B O;T
L H E J S N V | L H V N J E;S
K W L A R C H | W A R L K C;H
W L I K A Q R | A L R I W Q;K
R K S V O Q G | O R V G S Q;K
K L R F A E C | R C L K E A;F
Y L C W M A K | W K Y C L M;A
C O P R I G H | G I P R O C;H
U O H A V S W | H S U O A W;V
J B Q I D O X | I O X D Q J;B
D Y H E T Q V | V D E T Q H;Y
C K S H Q W T | T C Q W S H;K
W T P Z N C Y | P N Z Y W C;T
R V N D A K Q | N R V A D K;Q
W U D C G O H | O D C U G W;H
T S O U Q V B | B O S Q V U;T
L B U K Y M I | B K Y U M I;L
L Q G R F M T | T Q R G F M;L
C I O N S F G | I G C S O N;F
A O B K M S R | M R S B A O;K
A W K Y R P T | K A P W R T;Y
G I D O F K Q | I G Q D K F;O
L Y Q P C G E | E L C P Q G;Y
T Q U I K A N | Q I U K A N;T
N L I T W D O | O T W D L I;N
L Y A E J N I | J E Y I A N;L
A T I P V N Z | Z N P A I V;T
R Z H M O K I | I M K R H O;Z
P M H A Q E B | Q A M B P H;E
T E K S Q X B | B S X Q T E;K
J H X T A S M | J T M S X H;A
A E B G F M K | K B A G F E;M
G A U K T Q L | K G A L T U;Q
Y Q U S P F K | U Y K F P S;Q
Z B S N F X H | X Z B H F S;N
T J F Q Z C R | Z R C F J Q;T
D L P C O K H | O H C L P D;K
X I T D Q S P | X I P D S Q;T
Z N V G E Q P | G P V E N Z;Q
M R T P K C A | P T K R A M;C
V H U R L N S | L V H R N S;U
U Z I C X N A | Z A N C U X;I
Y P G Z X H J | Z H G J P Y;X
M U Q I K J C | Q J C U I K;M
N Q X D P E V | E X P Q N V;D
M K Y S Z X J | X J K Z Y M;S
N R O J B Z Y | J B R O Z N;Y
T H G J L P Q | T H L G P Q;J
M K N E C A G | N C E G K A;M
V D M R Q S B | M D V S B Q;R
D W E H Q I J | E D Q W I H;J
S K F L T E J | J K F L S E;T
U F E C L P W | P F W C L E;U
M W V E U Z Q | U W E Q V Z;M
V C I G L S X | V I S G C X;L
F I X S B G Y | F Y X I G S;B
D Q S X C R P | X S Q R P D;C
N I E Q D B L | D I N L B Q;E
A C V K T E Y | E C Y A T V;K
T A L I R N V | R V L T N A;I
F H T M E L Y | E H Y F T L;M
Y M P O E F G | G E Y O P F;M
W U O H F S N | O W H N U S;F
J H R N X D K | N R K D X J;H
J Z L C F Y Q | F Z C J L Q;Y
O G N L R E D | D O E L N R;G
D O Z Q B W S | Q Z W D S O;B
C W S P N R K | C K P W N S;R
E G D L R A C | L R E C A D;G
P X L Y E C G | C L E G X P;Y
V P K O Y N U | U V P O K N;Y
W C G U Z V R | G C U R W Z;V
D I S A W Y L | L Y D S W A;I
X G R W B D T | T B R W G D;X
R P D A E N Z | Z A E P N R;D
R A S M Z C H | R H S A M C;Z
H S W R X L I | X S R I L H;W
Q I Z N A S H | H Z I N S A;Q
T D Y E J R C | C J R D T Y;E
V P Y S I H T | H V S Y T P;I
M S A J I H R | R J S M I A;H
U O D N C K V | K V N O C D;U
C A G B D Q U | Q B D U C G;A
I J O T S C U | O S C I J T;U
D X Q Y U T B | U X D Q Y T;B
Y R A F Z H T | Y T H Z R F;A
T A C E N M F | T N C M F A;E
D P G N B O A | N P B D A O;G
M R P D K F H | F H K D P R;M
I M H Y C O D | Y I O C D M;H
L H T V F P R | R H F T L V;P
E U O W J F C | O J E W U F;C
A Q N K E U R | R E U K A Q;N
H P W I C U Y | C I P H U W;Y
J S C K X U F | U K F C S X;J
Z X V Y H M R | V Y R Z M H;X
V A B G X F O | F X V O G B;A
G I S W U T L | T I L W S G;U
U L H J M D S | U S H D M L;J
U K P Q G L W | P U L Q W G;K
H V L G O I N | I L O V H G;N
Q A V W O R I | V W Q A R I;O
Q K X U F V W | W Q K U V F;X
M B V F N S U | M F V U S B;N
G Z D C B E W | E B D G C W;Z
W O H Z N C T | O N W Z H T;C
Z S W K T A E | S A T Z W E;K
H Z F E D A N | E F H A D Z;N
S O D F H Z R | H Z R O D F;S
R I T Q C J W | C W Q I T R;J
V A F R M N O | R V O M A F;N
Y K S P M D C | Y C K D M S;P
Y I D T Q M S | D M T Y S I;Q
V W G T X D U | W V T D X U;G
U C V N B Y J | U V N J B C;Y
X C U B W Z K | W U B K X C;Z
G H D T N X B | B H G D X N;T
F J Y W M C A | M Y W C J A;F
I C D U T F R | U F T I C D;R
E H G J B R P | B E G J P H;R
K H W B O T D | B O T D H W;K
X F K V S Z N | F N X K V S;Z
V X Y E M R C | C M X V E R;Y
L K T X S I J | S K L I T J;X
N S V Y M L Q | S Q N L M V;Y
I D V N F W G | V I F W N G;D
D Q O N X L U | D Q O X L U;N
H T M Q E W Z | M W E T Q Z;H
I W X N Z P Y | I P W Z N X;Y
L J R P S Y V | R L Y V P S;J
V H W Y M P G | M P Y V G W;H
J F P W V D H | P H J D F W;V
B L C D W Y R | C Y L R W D;B
U W M N P J D | M N U D J W;P
G F V I D E Q | G D I Q V F;E
I R F M N K C | N R C I K F;M
X I N U B S Q | N I B Q U X;S
O F Y L A B T | B L T A Y O;F
D M C B E V Y | C Y D V B E;M
A X N C S Q I | X A C N Q I;S
K R M J N Z G | M K J Z N R;G
F B L Y W G E | L Y E B G W;F
D N Q Z B O T | D Q O B N Z;T
B K R I U Y P | P B R Y U K;I
A B I U R E Y | Y U I B R E;A
D G A V F L O | L F O A V G;D
T Q K C M N B | K T M B Q C;N
Z P G S E R T | Z R E T G P;S
Y I T J Q K H | T Q H I Y J;K
X R M N O T Y | T O R Y X M;N
V S C Y K I B | C S Y V I B;K
G X P F A B L | G X B F P L;A
G E D P W U R | R E P G D W;U
F W E Z V L S | S Z V W E L;F
N O J Y U W F | U Y F N O J;W
W U K L P T I | P U I T K W;L
F P D B U X O | D U O F X P;B
I D Z E Q X Y | I Q Z Y E D;X
V Z O D L A W | D L V Z A O;W
G V B M K A D | G M K A D B;V
A G E O L U S | U O E G L S;A
I M X D P R S | I R D X M P;S
K V M R Y X T | V K X Y T R;M
V F M K I J W | W I M J V K;F
F D Q E M U C | E M U F D C;Q
D W T U R Y I | I W D Y T U;R
A D G S M N I | S D A N I G;M
C I P L V F X | V C I P X L;F
H M Y B J E D | E J B Y D M;H
J Y N U I H T | N H U J I T;Y
X O P Q F A N | X Q N F A O;P
L V K Z N A X | K V A X N L;Z
W U X C G F M | X W M G C U;F
L S N X A Z H | Z A L S N X;H
Y G C W U L V | Y C V G W U;L
P F S C E Y K | K S E P Y F;C
E K D U R O J | D K O U J R;E
F L R N G V D | G F L V N D;R
K Y F Q P L O | O L P Y Q K;F
Q V J N K X P | K N X V J Q;P
X Q U Y T Z O | Y O U T X Z;Q
O X R C H P W | P C R X W H;O
U N Y W P A V | U Y P A W V;N
S R P Y T I W | R T S Y I P;W
P U V E M B I | M P B U I V;E
S N Q P X I L | P I L S X Q;N
Y S O V E L A | O S L A V Y;E
Z P L V K F R | Z F L V K R;P
X I N V U D G | N V D X U G;I
I E O C Z H X | O I X E C Z;H
B G X U Y S V | V X U Y G B;S
V R U H D Q X | X D Q R U V;H
C N V M J X F | J N F V X C;M
K U N I Z G C | C G U I K N;Z
O H A W B M J | B J O W A H;M
O S A G J U B | J B U G S O;A
U L F Z N W S | L U Z S W N;F
T V D M L Y E | L M D T E V;Y
E R N C P M B | N M R E P C;B
E O W Y R M J | J M W Y E R;O
R P V B L I X | X R I P V B;L
Z K T Y S Q L | T L Q S Z K;Y
Z L M B S V O | B V M S Z O;L
Y R U P D K C | U P Y R C K;D
V J P N R M Z | V P N Z M R;J
B D V P A U O | A U O D B V;P
T G I X Z W N | T X I G Z W;N
F B Z O U C E | O U B C F Z;E
J A Z U D N T | J D Z T N A;U
G S O M N A L | G A M O N L;S
G B I Y M E P | I E P M B G;Y
U B N A D V H | H B D U A V;N
O K S D L B I | B D S O I L;K
A Z D F L B Q | Q Z F L A D;B
K U O B I W T | O K I B W U;T
N F E X H Z K | Z E K H F X;N
X Q J K V B P | B V X K Q J;P
Z T I L H O N | T Z N L O H;I
O Z I K T V J | V Z K I T O;J
S W C B L Y M | W L M S Y C;B
P I J R K C Y | J K I P C R;Y
A R E B O G M | E A B O R M;G
A V Q Z X F N | N X V Z A F;Q
J K N I B X W | I K W N X B;J
H F K L T C X | T K F L X C;H
Q Y H E B G P | G E H Q Y P;B
J V Z W D E G | V Z E W D G;J
Q L R Z N F P | N P R Z F Q;L
R N E D L J Y | Y L R J N D;E
H S I D V Z O | I O H D S Z;V
V H C G A D S | G D H A S C;V
P Q Z G C E T | T G E P Q C;Z
F K N G H B S | G K H B N S;F
E N V Z S C P | Z V E N P S;C
C W D P Q E L | L Q P C D W;E
V U B H E Q C | B U H Q V E;C
C V E B M T S | E C B S M T;V
G Q I R X F Y | F Q I Y X G;R
L W T P K V D | D W P T V K;L
P U S Q D N W | U W S D Q N;P
S M I A O P F | A F O P I S;M
T V E U I G X | V I U G X T;E
J L R O G V W | V O L G J R;W
K Z X G W I A | Z W G I K X;A
W X J U L E H | H E J L X W;U
Q C J K O P Z | Q J K O C Z;P
D I S Q T U C | C I D T Q U;S
F G I W U N S | G S I U W F;N
J S H P I M Z | Z I M J H S;P
K E Y P I V L | I Y P V K E;L
B E U X Q R H | X R U B E Q;H
Y F P A O L G | G L A P Y F;O
H Y K Z I J R | H R J Y K Z;I
I S Y N E W U | N E Y S W I;U
A L O N W Y G | O W Y G A L;N
Q B W R L N P | B L Q P W R;N
A U R D E X M | M D E R U X;A
L G N W I Y C | C G W N Y L;I
Z I X W E U D | E I W Z X D;U
U S I H T F P | H P I T U S;F
L O E Q C I N | L N O C Q E;I
B N C Z A P M | C Z M P N A;B
C F U H N Y P | N U H P Y C;F
Z I P O F H B | B H I Z F O;P
Y H V J M D K | D J Y H V K;M
H F E D K G Y | E D F K Y G;H
D I W G T Z Q | Q I G Z W T;D
L U D I V F P | V I F U P L;D
K V I T P U D | K P V D U I;T
G A Z J K S D | D A G K Z S;J
O T P V D H L | H T D O P L;V
A V G W Z B T | B G A T Z W;V
L A G V J X Z | X V J G Z A;L
I M H J R E O | E H J M O I;R
Z W H A L F P | W P L A F Z;H
W A K B I Z Q | A Q B W I K;Z
Z J N W L A G | W J G Z L A;N
U A K S H Y O | H Y O U A K;S
T A D O F Z J | D A J O F T;Z
Y T L K Q Z G | L Q Y K G Z;T
R J Z T W M E | J M Z E W R;T
V S P K N R Q | K R P N S Q;V
F S B K T I H | B K H I S T;F
G J H V X Y K | G Y K H J X;V
S R J W P V X | J W V S X P;R
U Y Z Q J R O | Y Q Z R J O;U
Q I D G V N X | V G X I N Q;D
J R K C E Q F | R J Q C E F;K
B N A C E Z G | G C A Z E B;N
S U V B Z H P | Z H P V U B;S
G K V R T J U | V T J G K U;R
P Q E V G H U | H V G P E U;Q
I Z U Y D O J | O J Y D I U;Z
P N J W V S D | V J W D S P;N
B S Q Y K A R | B K S Y A Q;R
X D M U V O I | V I M U D O;X
I Z V N R F G | I N R Z G F;V
Q A H V S N Z | A S V N Z H;Q
M S P E O G K | E G S K P O;M
X Q P U B H I | Q X B P H I;U
A L V S Q C W | Q V W A S C;L
M W G I T R K | I G M W R K;T
K L J Y A E Q | K E L A Y J;Q
D B T P L A E | T B L E D A;P
Y N L U E T C | C L U T E Y;N
A T U V F K Q | Q K F U A T;V
A S Q K V R T | R V K A T Q;S
K N A D C B O | A K D O C B;N
F H N L E Q T | F N Q H T E;L
V Z M X E K J | V J X E Z K;M
R N V E A P J | J R A E P N;V
G C W I L H Z | C L W Z G I;H
N B U G W Y I | Y G N I U W;B
Q B N I S O J | Q J I O S B;N
U A L O N S I | U L S N I O;A
X H G L O K F | X L F K O H;G
R F X I H A N | N I H R A X;F
C A Y R J W S | C R W S Y J;A
R Y L X V A S | Y V A R L X;S
P A R Y L O E | O L R A Y E;P
Z I C U T P H | T U H Z P I;C
P L U F N A T | T P U F L N;A
H K C M E L Q | H M E C L Q;K
F N H B T Y Z | H B F N T Y;Z
Z A D U W H L | A U L H Z D;W
A G C M N H J | J N C M H G;A
X F T W N Y L | W T X N F L;Y
E X T H V K F | T X V E K F;H
L G E H O S Z | S G Z L O E;H
R I N C G J P | I R P J G C;N
X J W Z M V K | K X W Z J M;V
V C G F T D B | C V T B F G;D
O D J H X R V | V R D H O X;J
X M U T A O P | T M O U X A;P
W M G S R B K | K B M S W R;G
X O S V F C U | U V S X O F;C
H N B W P U C | B H N W P U;C
L X K Z P V Y | V X P Y L Z;K
C G X R K Q N | X R C Q K N;G
B M H S X D N | H D S X M B;N
B X L M G A N | L N A G X B;M
M B T S Z I W | S M Z B W I;T
N Q T G U X K | G N Q K U X;T
R B S G I O H | G S R H B O;I
U I V X Y T B | U V Y B X T;I
Z S G D U X V | V X D S G U;Z
X M Y U L Z F | X Z L Y U F;M
Q T B S C O V | Q O S C V T;B
R N Y G W F C | F G R Y N C;W
U P R F B E L | U R E P B F;L
E A F L U Y V | L V E U A Y;F
X C O P A N V | X N C A V P;O
C G Q L E J H | H G L C J Q;E
X N S W Z J D | N D X Z W S;J
N T U V H M X | V X H U M N;T
P Y U Z F J E | Y Z E P J F;U
M U W F Y D N | D N Y W F U;M
Y B X M O Q D | O Q Y D X M;B
K U P H D A C | C H K U D P;A
V T Q G S M X | G X Q V M S;T
S P M G V B O | G M P S B V;O
G U M C K J H | C K J U G H;M
Z W R I A T K | R W T K A Z;I
Q U E H S V G | G H V Q E S;U
A I L J C M Q | A J C M I L;Q
O A X B D K N | A X K B D N;O
O R M J I G L | M I R L O J;G
W H P U X L V | W H L P V U;X
C Z R J G U X | C G J U Z X;R
T J H D Q M Z | H Q J M T D;Z
O W H S G N F | G F W S N O;H
I D H U G A S | I A U S H G;D
Y R L P S J K | L R J P S Y;K
L H M I T V U | U H M T V L;I
T Q W P M B Y | M T P B W Y;Q
N Y X A V Z F | N V Z F A Y;X
N P F U Q C D | U C Q P F D;N
V Z U P D O S | P U V O Z S;D
K O X D V Z C | K Z C V D X;O
N Y G D V L J | N V J L Y D;G
H Q W C I X Y | Q W C I H X;Y
R J Y D Q K X | X Y K J R D;Q
U R Y X F A Q | X Y Q R A F;U
P K X L O Y U | K L P U O X;Y
G X L E Y B D | B L Y D G X;E
M G H F N E U | G E M U H N;F
X F Z M I N O | I N O F Z M;X
T K J O S L X | O K L X S J;T
G S W U P Q C | S U G C W P;Q
Q P C V J G X | V J X G C Q;P
X P E Z A G L | P X G E L A;Z
R E M O H Z U | O E R M U H;Z
N Y Z L T G Q | L T Z Q N Y;G
A M G T O S V | G S T O M A;V
U G R I T X L | U T R L I X;G
S P I B X A Q | I S B P Q X;A
W H P V Z C B | W C H V P Z;B
L S Z J N O V | V S Z O L J;N
M L W B F Q Y | M Q B Y W L;F
B V R J O P A | O V J A R P;B
J L K Z V W T | W K T J L Z;V
F X M U L A O | A L O M F U;X
T O H R F G Y | F G T H Y O;R
C Q D B X V W | X C W B D Q;V
O V P U Q Z A | V O A U Q P;Z
V L S B R A W | W L V S R B;A
A Q V N P Z W | P Q V Z N W;A
U H V K J E F | K H E F J V;U
N S H D P B T | T H D S N B;P
C E S F J K X | K C E X S J;F
B Z U P R K L | R L U K P Z;B
I X A O L J E | E I J L X A;O
T N K V B O C | N C O K B V;T
M Z T J W B Q | M Q B W Z J;T
U K O T I Q H | T H K O I U;Q
B K X R H E O | K R B X O E;H
N U X V F T R | V U T F R N;X
R G O A I C Y | I A G R Y O;C
C N O D Y Q I | O Y C N I Q;D
F G E X Y D N | F X Y N D G;E
I F C O Z U H | I U O C H F;Z
R B Y N X H D | B Y R H D N;X
R O S Q X D G | D Q G O R S;X
S I M P G B Q | M S G B I P;Q
X M V P S Y L | P L S Y V X;M
M A Z S I J U | J A M I S Z;U
D T Y K C L Z | D Z K C T L;Y
V E T C H J L | T C L E H V;J
L O B M F A N | L F M N A B;O
X O N E G B C | O G E B N C;X
Z X G N S Y M | N S Z G Y X;M
I M D C F O Z | F O I M D Z;C
R C J L X D M | M J R X C D;L
C S A Q B H I | C S H B I Q;A
Z Q N Y A D G | G Z Q D Y A;N
L F U W I G O | G W F I L O;U
N F M E Y W S | W E M N Y S;F
J N R U O X W | U J O W R X;N
P X I T S B G | P T I X B S;G
T B Y W J C I | J Y B I C W;T
M B J Q E O D | O M E B J Q;D
H N P T F W I | N F W T P H;I
R X J F U H W | X W H J F R;U
X W N I M A S | X A M W N S;I
K J A D C L N | K A C L J N;D
I H Z F T C S | Z H T I C F;S
D K S I O F N | I K D O F S;N
Q W N C G Z X | N W X Q G C;Z
C R L F Q W S | C Q R F S W;L
S B R U Y V J | S J U B Y R;V
B S Z F N R U | N B Z R S U;F
K S E T A Q Z | K Q Z E A S;T
J N W Y M P H | J Y P M H N;W
W B M N F J E | J B W F M E;N
P H T Y N A J | H N J P T Y;A
B U D R S A V | S U R V A B;D
O P W D V E H | O W D V P H;E
D S G N B O E | G E O D N S;B
G M S P Z V D | G M P V Z D;S
N G M J Q Z X | M Z N G J Q;X
M X B C J H U | C M H U X J;B
L G J A M Y K | Y L G A M K;J
L V Z I H U Q | Z Q L V H I;U
X L E I W V G | L W G X V E;I
C H I M S X F | S X I F C M;H
F X G N Z E W | E X F Z W N;G
R F X K D A E | X A R E K D;F
X A M D H G S | A H X D S G;M
I Y B Z O L M | B Y L M O I;Z
Q C R S P X Z | Q C Z P S X;R
P J T D K X G | T X D K G J;P
Y S K H C E P | C E P S H Y;K
F I W U P N X | W F I P X U;N
B J Q H E N U | N E H Q B U;J
I Y X C R Z G | G R X Z Y C;I
N C X D S J K | X J S N D C;K
J D O I G U Q | Q D I J U O;G
S L A U H Y V | V S L Y U A;H
W S Z Y X N L | Z N Y W S X;L
S F R P B Z L | L F Z R B S;P
F E I S H V D | F D E S H I;V
M U B Q V L R | V B M U L R;Q
I H A Q E C U | E U I C Q A;H
X T V P S N O | P T O V X S;N
I E K Q U L M | I Q L K E M;U
Z U W J S B K | B W U J K Z;S
O S P H C Z D | H C D Z S P;O
Y W X O J C L | Y C W X L O;J
O G F D V N Z | D G Z N O F;V
S A R Y L E B | A R Y B L S;E
L I H C F O G | L C F I H O;G
R L A P W N C | C W A L N P;R
I V O H N E P | O P N I H E;V
H Z Q L E T G | Z Q G E L T;H
V G E X A Y K | G A K V Y E;X
O M G X C W F | M O W G X F;C
X Q Z K H C E | Z Q X H C E;K
E R Z N G L S | E L N R Z G;S
C V Z P A U O | Z V U O A P;C
A S W B L E R | S W A B R E;L
F D P W J E B | B W P F J E;D
U Z O M C V R | V C Z R U M;O
B A S H U X L | L S A B X H;U
T N B G C R F | F N C B G T;R
B Y X J G M N | X N G M J Y;B
X T B F Y S G | F T S B X Y;G
O J G N T C K | T K G O J N;C
B C V F L O X | F O X L C V;B
O D Q S J V A | V Q O S A J;D
K G P O I C Z | G P Z C I O;K
N M V W C A K | N W C K A V;M
C W O L K I E | L K O W I C;E
X H A F G P M | G M H F P X;A
V G I X P L N | X L V G I N;P
L F M D J X C | F J M D L C;X
L U A M E Z X | L Z U A E X;M
N W F V M O D | O M W N V D;F
Q O H Y C L I | Q H L C I O;Y
D Y F S M W B | S W M D Y F;B
Q F O G I D L | I L G O D F;Q
C P A S L V O | V P A S O L;C
E J N G P U Q | N E P J Q G;U
Z M Q V D U C | M D U V Z Q;C
D H N Q O P R | H Q O P D N;R
A Y V X C J T | X C A T V J;Y
E T A D I B V | T I V B A E;D
D S N P U C Z | D S P Z U C;N
C T S F X A W | F T S W C A;X
D E J B R I N | D E N I J B;R
Y L S H G V D | Y G L H S D;V
X F K D G C Y | G K F C Y D;X
H T S W L X C | S W L C X T;H
G Z L B V J I | L G V B I J;Z
E T M W C S K | W T K C S M;E
G U V J H Q K | V K Q H J G;U
W A D L S I C | A D S W L I;C
T E V S G K P | G E V P T K;S
E W C T F V K | F V W E T K;C
W V R U E N X | R W V U X E;N
L X C B W N D | C X B L N D;W
O I M P B G J | I P B J O G;M
U V Z E S F G | S Z U G E F;V
W S L X M F Z | F X L W M Z;S
C O R U H J N | U O C N R J;H
C K V R H P Z | R C K P Z V;H
K I D A V M Y | V M A I D Y;K
G M U Y F Q J | J U Q G M Y;F
W D U G N P L | W U G N P L;D
Z Q O X N L W | X O W Q N Z;L
U O D R I E K | O R I U K D;E
G M N Y L T R | L R N Y T G;M
M Z B U K Q N | Z U N M K Q;B
M Z B F R H O | B Z F R O M;H
T Q D M I J F | T F I D J Q;M
L Z F C S E O | C S Z F E L;O
A G R S Z M U | G Z R S M A;U
X U C B Z M R | M C X Z B R;U
Y E F H U G L | H F L E G Y;U
I R Q E P G F | P F G E I Q;R
L J P T I B V | J L T B P I;V
T G O C W N E | C N E W T O;G
G R N I D B F | I R D N B F;G
Z G I X S U Q | I X U Z S Q;G
I X T S J V U | T S V I J U;X
V O G T M B U | B V U T M G;O
G N L H U W M | U W L M N H;G
L S C E Z U I | U L C I Z S;E
I L M T U D A | U M L T D I;A
B D E W S O G | E D B W G S;O
H A N W U O Y | N O U H A Y;W
L Z N Q C P X | C Z Q N L X;P
S A Q B C R D | Q C D S A B;R
Y Q S D J L R | Y S L J D Q;R
G T X D I M H | T D G M I X;H
D J R M F T Z | F T Z D J R;M
S E K Y L Q Z | Z K E S Q L;Y
E G Q Z P M D | G E P M Q D;Z
S B T Y L M D | M S T L Y D;B
Q Z W A F C V | V A Z W C Q;F
Q L Y G U Z P | G Q U L Y P;Z
Q L E Y W R V | R L V Q Y W;E
R K S P T A M | R P T A M S;K
L P J N M G X | M N L X J G;P
C Y T B K U A | C U B K Y T;A
Z N A G C W R | C A W N G R;Z
U M R N Q H C | M H Q U R N;C
F S H J O L U | H S O F U L;J
C Y N V O H L | C V Y H L O;N
Q G C X T Y D | Y X D Q C T;G
H P Z D R J B | D H J Z B P;R
A H W Z V X R | R A W V H Z;X
E J D H M X I | H J E M I D;X
T F X N W A E | F A T W N X;E
F G A K N J L | N L G J A F;K
R Z G X F B A | Z A F X G R;B
P O A Z D E N | E A O Z D P;N
K Q V E Y Z W | K Z W Y V E;Q
N R A P B L U | L P B U N R;A
Z H W R U S C | W R Z U C H;S
A G E N O J T | O T E N J G;A
M R F H G J X | G M X F R J;H
C K M X L D U | K X U D M L;C
F O X N I G J | O J G X F I;N
W K H A F G C | K F C G H A;W
U F C H Z X D | F H C Z U X;D
R Z C I W Y O | O R W Z I Y;C
G N T V C U L | L V C N U T;G
U D R B G W L | B W L G D R;U
X L K N R Q F | Q R N F L K;X
D R P K J W M | M K J P R D;W
T U G B W R Z | Z G T B R W;U
T C W R Z Q S | R C Q T W S;Z
M E I K Z B T | B I M Z T E;K
S A I C V Y G | Y C I V G S;A
U C Q L E I M | I E M C Q U;L
H S R W K Z J | S W H Z K R;J
B K N G R H Z | N K H R G Z;B
V C G W N I E | N I E G W C;V
F A N V H Y D | F A N V H Y;D
G F I D H O S | F D H S O G;I
Y F Q P E T D | D F P Q Y T;E
N F I B P H V | P F B H N V;I
S X W Z G I U | G W U I X S;Z
C B J M W G I | G M J I C W;B
K M X Y O E L | M X L O E Y;K
K R X H P B G | B K G H R P;X
D Y L T S X H | S L Y X T H;D
Y C J E U P Z | E P Y Z U C;J
L K W C M P T | W T L M C K;P
W L T A D J N | L D T W N A;J
D U K C N O P | K C O P D N;U
C I L S N G H | I C L S N G;H
F U J Y C P T | P F U J C Y;T
L J I U A H T | U J A H T L;I
P T N I V R G | P V G I N T;R
T S I N O B J | B S J O T I;N
M H I F S J W | H S W I J M;F
L P F U Y T B | B L U Y P T;F
E R F A N M O | E F A M R O;N
T Z X F R B Q | R Z T X Q B;F
O U W B A V F | V O B A W U;F
V F O M Z N C | N O C Z F V;M
H Z B U W F V | V F H U Z B;W
A E W Q N C V | N W C E Q V;A
A N S Q X V I | X N A I Q V;S
Z M R I P A C | Z M R I C P;A
X Y U O L A B | U B X Y A O;L
M S R L O F A | L F S O M R;A
O E X W S B Z | B S X E O W;Z
R M L U B H D | D U M B R H;L
H K L D A C F | K C A L H D;F
N K Z T H G Y | K Y G H T N;Z
P U Y I N R D | D U Y I P R;N
Q A G F H N I | N A Q F I H;G
N W L P E M Z | M N P E W Z;L
T F Q P H G X | P H F X Q T;G
S A Y N E K R | S N Y K A E;R
B C Y L D V P | D L C P V Y;B
C J X T E P V | J T E P C V;X
P R I U G Q E | I Q P G U E;R
T Q Z E I V W | Q W E I Z T;V
Q C H I R X A | C A I H R Q;X
T C O V E A K | O C K V E A;T
V Z P Q X H Y | P Q Z Y V X;H
M W I P B V R | B W P I M R;V
C S G P T E F | P G C E S F;T
Q J H M Z G K | K M G Q Z J;H
U L J O N C P | O U P N J L;C
Z N F L R W T | T Z L R F W;N
K Z D P A J S | A P D S J K;Z
X G W O S H K | W X H S O K;G
X E B A R M H | R X A M E B;H
N V Q B F U C | Q F V N C B;U
G V M P Q A H | Q P G V H M;A
C D Q G P S H | Q C P H S D;G
V O K A W X T | O A T W K X;V
O X F G P K J | X O F J P G;K
P S V D U R A | V A R U P D;S
D P S E K Y J | S D E K P Y;J
U L I V W M R | I R V L W U;M
A X V L O Y B | O B A V Y L;X
M O Z B F Y U | M Z F B U O;Y
I C F Z A W J | Z A F I J C;W
K H O V A D I | A D O V I H;K
F X V A Q M E | X Q M F E V;A
D Y I F M G V | I V D G F Y;M
L A Q P I K Z | A I Z Q K L;P
Q S C A P T B | C Q B T S A;P
V O L D N E M | O D M E N L;V
L U A W M X P | M U A W P X;L
W A E Y P M G | P G Y W E M;A
P C B S G L O | B P C O L S;G
L B J P Y M I | I B L Y J P;M
J R V K E O Z | V E K R O J;Z
U J C F N S R | C N J R F U;S
C T H A X M Z | C A Z X M H;T
T A L M G E U | A M T E L G;U
J Q H R G Y W | H W J R Q Y;G
S K U W C N M | C M S W U K;N
H J K Q Z B S | Z Q B S J K;H
M P Q D E N Z | Z N M D E Q;P
N V E X S Y W | S X Y N W V;E
P N T F I C W | C W P T I N;F
V S N M Q B Y | V B S M Y Q;N
M W Z K D S A | Z S W M D K;A
F A Q N Y W K | K F W A Y N;Q
R F Q M K X N | M X N R F K;Q
V F E H B T J | F B T J H V;E
X J Q V H B W | B H J Q V X;W
H S R Y Z J L | H R J Z S Y;L
U W J N B D Z | Z B U J W D;N
G L U S T A B | U A L B S G;T
F J M N L H D | F H D N L M;J
A F W Z M B Y | W M Z F A B;Y
C F M Z E N J | J Z N E M F;C
E G U J I D A | G A E J U I;D
Y D W F V Q A | V Q A F W Y;D
J G B C A I R | G R C J A B;I
F Q N P T O R | Q T O P R F;N
L K M X V I Q | V X M L K Q;I
B S E H N R G | N E R H B S;G
G V S F K H I | H F V K S G;I
Y V O Z T R F | V Z O R F T;Y
A B N J O L Z | Z N L A B J;O
W U F I L Z K | I K U F W Z;L
P M T G R V O | R M T V P G;O
J G C A Y Q I | J G I C A Q;Y
E P B L X S M | S P B X L M;E
F T S K O D V | O S F K V D;T
N I Y J E F W | Y E N J F W;I
O P W H B Z L | B W O H L P;Z
J Z P V K L X | V L P X K J;Z
Q L E B Y H X | Y Q X L B H;E
C O J N Z E V | Z V E C J O;N
T O Y S M H F | M S T H O Y;F
T O X I M S V | S X O M V I;T
V Q Y E T N S | S Y T N E Q;V
D B G Z U X P | B G U Z X P;D
Y L M C Q F N | F Y N M L C;Q
V A T L W S G | A L W V T G;S
R W X I G Y J | X J G W I Y;R
R S C B M T I | I R B M C T;S
B A P Z G T Y | G P Z B T A;Y
W M X I U N L | M U N X I L;W
Y O S Q N L F | F S O L Q N;Y
Z Y V F O I P | Z O P F V I;Y
L Y A S N B F | B A N S F Y;L
R U J K E F L | K U E L J R;F
C G E Z N O X | N C E G X O;Z
B Z N Q I J U | I J Q B N U;Z
Q D Z F P V S | D F V Q P Z;S
X S Z Y G I O | G X O Z S Y;I
L K C J R X P | K C R X L J;P
T H V W F K M | V M H T W F;K
G Z Q Y N P I | Q G I N P Z;Y
C T N O U D J | C T O N U J;D
K N U P X Q H | K Q N X H U;P
R A W B C P G | R C G A W B;P
L I P S Q A R | L A I R P Q;S
M J P W E B L | P M J L W E;B
G R O Z I F W | W G R Z F I;O
F G U Z R N T | F N T G R U;Z
M Q L K V U I | U M I L V Q;K
S F G M R U J | J S R F G U;M
E J H X F K O | H K X F J E;O
W F G Y O R V | F V W R G O;Y
F A J T V B N | T N B J F A;V
A Z D J S T L | T L S D A Z;J
B V H W A Q P | Q B H P V A;W
D O T A G I Q | I T A Q G D;O
H L E J U K N | U E L N H J;K
Q X N Z C R U | C Z R U Q X;N
X G B K R J S | G J R B K S;X
L Y X W J Q G | G X J Y Q W;L
A U R N C L G | G A L R N U;C
V E A L O J H | H O J V E A;L
X J I V E Y U | Y U J E X I;V
L Q I F S Y E | Q I L F S E;Y
W T D Z J M C | J D T M W Z;C
Z H S Q T U I | T Z S Q I U;H
Q S J G X R U | Q X R J G S;U
P Q R S U I X | Q X S R P U;I
G M B Z S V U | B U S G M V;Z
X G M L U T H | H T M U X L;G
L Q B M W H G | H L M W Q G;B
J A F T O G D | F A D T G J;O
Q K L H E G A | Q H K L E G;A
Y R B N U K W | K U Y W N R;B
Q C L X M U K | C M Q L U K;X
A F D S V E Z | F D V A E Z;S
O V H X B I J | H O B I X V;J
E K P W U X H | P U K W X E;H
H P A U C S D | H S C A U P;D
F S W M G C L | S C F L G M;W
D Q P J E I V | J Q P V I D;E
O Y E T R N C | O E T R Y N;C
S Y W B U Z P | P B Z Y U S;W
D V Q H L S P | P V H D L S;Q
V M Z S Y W Q | W S Q V Z Y;M
Y C B N K U W | N U C W B Y;K
B P S J F R C | J B C R P S;F
R K M I L G D | M I D G L R;K
Y R X U B T I | B R U T I X;Y
J T X K Z F V | K Z V X T F;J
S Q F L O U H | U S H F Q O;L
C P Y H I W D | W P C Y D I;H
B C G N J T K | G K T C N J;B
T P L U J V S | L P J U V S;T
H Y T S P B Q | H P S Q B T;Y
E C Y R S N J | N S J C Y R;E
W G T D B I P | B I D W T G;P
R H D A M F O | D A H O M F;R
I B W V S P G | P I B G S V;W
P F X I O B N | B P I N O F;X
F U Y W Z O I | I U Y Z W F;O
U K R N M Q Y | R K N Q M U;Y
D Y X Q R B P | D X R Y Q P;B
L X I N M Z K | M N L Z K I;X
Y K B V P R H | B Y V K R H;P
F S D X C H G | H C D S G F;X
H X S N A T C | C H X A S N;T
J A W B N E D | A B W J N E;D
I E X W D Z M | D X M I E W;Z
E D I V L U H | V E I L H U;D
H R O V B J A | V O R H J A;B
M Y L T N H F | N F L Y M H;T
O T J Y Q X A | O Q T A J X;Y
F L Y X R S K | K X S F Y R;L
O X P R A G K | K O R G P X;A
U C M A G J X | J X A C G M;U
H R J K C A L | J L C H K R;A
H P I J V K B | V P I J K H;B
S O D A Z W P | W D O S P Z;A
K T J N X E U | T U N J K E;X
B U G K C S A | U C K B A S;G
D J G F T Y P | F G T J P D;Y
E K L W F N T | E W F T K L;N
S P V F E O Y | F V S O Y E;P
S I F P B J O | J B P S I O;F
R I J Y A L S | A S L J I Y;R
Z Y X M E V D | V E X D Y M;Z
P N A M V D K | V A M K P D;N
K M C G T O S | G T O K M C;S
L W E P T X Q | E W L P Q X;T
Q X R G F Y A | G R Y A X F;Q
F O J T Q H S | T S Q F H J;O
G E R H K B S | E R B H S K;G
Q Z Y B L W O | W B Q Y O L;Z
H M X K G A O | O M X G A K;H
S B P T Q E D | B T Q S D E;P
Z W M D S L I | Z I S W D M;L
B L J Z K P X | J X L B K Z;P
H D R X Y S B | S B Y X D H;R
N P A Z K J X | P J A X K Z;N
D P Y N L E M | Y L N M P D;E
Q W J F M U E | J M W E Q U;F
T S A E V I G | E V A G I S;T
G M H W R U N | N W R U G H;M
K V Z R P C J | P J K C R V;Z
N M D A C H L | D C M N L H;A
A N I V X J D | D X A I J N;V
E I D F C K X | X C E D F K;I
V B L K H E T | E K T B H L;V
O H I B U X K | K I O X U B;H
X N H D E Z J | E D Z X J N;H
F Y X A E M Z | M Y A Z X E;F
T X S G A K C | K S C G A X;T
A E R U O H Y | R A Y E U H;O
Z V D Y U L M | Z U L V M Y;D
S A N K R U V | R K A V U S;N
N Q I A L V X | I X Q V A N;L
I U A N O K W | O W U K A N;I
I P K U J L H | P L H U J I;K
C S L R Z U W | C L Z S W U;R
G Y M T Z H D | Z D T Y M H;G
T R K S L F A | A R S T K F;L
M A V Q W L F | Q L W V F A;M
W L Z E M Y R | Z W E Y L R;M
S B A P G Y T | A B T P Y S;G
I S N V E K D | I E N S V D;K
I K A E O G W | W G O E K I;A
H Z W R N J O | J H R O Z W;N
F A Q R Y D O | D A Q Y R F;O
K M F N Q T V | Q F M N K T;V
B X V C Q S P | X V C Q S B;P
D R C N U W K | C D W U N K;R
G M Z B N X K | Z G K N M X;B
Q X J M W H V | V X J H Q W;M
B M G X I A Y | I M B X Y A;G
K P M S I X Q | S I P Q K X;M
S B X J P C U | J B X U S P;C
N V E R J T M | N T V M R E;J
W H T U V D L | H U T V D L;W
I U F Z C E M | I C F E Z M;U
B U R D K Z O | R D Z B K O;U
K S B V M F T | K F S B V M;T
L Y N M D V F | L D V N F M;Y
M O T H B N A | H B O T A M;N
M J Y S C G R | S C M Y G J;R
J R V E Y C O | J Y V R O C;E
A P E F K S Y | P F K E Y A;S
O Y B S C T R | Y O B S C R;T
M W G U I K S | S U W G I M;K
X A Q U C L Z | L X C A Q U;Z
F S O X G Y C | S F Y G O C;X
N A S Y O W U | N O U Y W S;A
Y Z N C V J K | Y N C J V Z;K
B A V I X Q U | U A Q X B I;V
O D Q U Z I R | O Q U R I Z;D
D O N T H X C | C H N X T D;O
M X C F K Z J | M F Z K J X;C
S W G B V Z Y | G V S Y W Z;B
K L U W E G S | S K L U E W;G
U A G I R H T | G R A U H I;T
D U A N S L E | L A D N E U;S
S J V B R M A | R S B V A M;J
H M P N B L D | L N H M D B;P
C V L D G S P | D P S L G C;V
O N F R J K D | O K D N R F;J
P N U Q L I W | L N P W Q I;U
V E X Y W P H | Y W H E X P;V
D Q N Z T J U | J Z Q N T D;U
H T I X E G D | I X G E H T;D
V K M J F X B | J M B V X F;K
G A B J Y T V | B T A J Y G;V
C D O E W Y J | Y J D E O W;C
A Y U B S M P | M U Y A B S;P
M I P H T V R | M V H R I P;T
D U C G X T N | T D G U N X;C
X P R O Q H S | S H Q P R O;X
I R M X A P H | I H R X P M;A
T X O S Q H R | S H Q R O T;X
P V O S Z M E | O S V E M Z;P
J Q R E O U X | Q J R E X O;U
I J K O S X V | K V O I S X;J
W F M O L C V | C O L V M F;W
N H E Z Q C D | E N Q D H C;Z
P B K A S Y C | A P K B S C;Y
O Y J L N X F | X F L J Y O;N
Z M V J N H K | N H M J K V;Z
Z L U R H C B | Z U B R L H;C
P E N B O G K | O B G K E N;P
N X A E K W O | N E K O W A;X
U Z C K N X W | W K U Z N X;C
J E W I X B K | I B J X E W;K
D X R V E P S | S E R V D P;X
R K C M D W B | D B W M C R;K
T D F H L O E | L H D E T O;F
P Q Y Z E F C | Y C F Q E Z;P
Z C N F Q E R | R Q F C N E;Z
I Q P B Z N L | B Z I N P L;Q
L P O H K I X | H O L K I P;X
E L Z K X N D | X N L Z E K;D
M R P G Y K X | G R Y X P K;M
P L W Y H J E | L H P J W E;Y
Q N F Y C A S | C A Y F N Q;S
N U W I K J H | U I W N K J;H
X Q N T Y P D | T Y N Q P X;D
M J Z W Y H G | W Z J Y H M;G
Y R U Q X Z A | R U Q Z X A;Y
V M J L Q A O | L A J O Q V;M
V I Q R N O Z | O V Z I Q N;R
U G N E A T I | U E G A I N;T
U Q L F A R X | L U X F Q A;R
N K P G B J T | G P B N K T;J
D X Q C G U T | X C T Q U G;D
R L B V S Z I | V B R S I L;Z
J F P Q K N R | F K P Q R N;J
T F Y J L R I | R Y F L J I;T
Q O A T D V E | O E T A D Q;V
F M L K U E J | M J K L F U;E
W E O T Z P K | E Z T K O W;P
M U R Q O G P | P G O M R U;Q
U Z V E R L C | U L Z R C V;E
B U N E X L C | C E L N X B;U
R W N E T D J | E R N D T J;W
L V B N E S P | L V S E N P;B
L N X D K W B | N L X D K B;W
Q J V W L A N | Q A W J L N;V
J G F O H L U | O U L J H F;G
G X E B V K N | K G N V X E;B
J M E D G H Y | J E G D H M;Y
B J U Z I S P | Z B I U P J;S
K U D C A X M | X M D U A C;K
B P T H U J X | U P X H J B;T
W H Y G Q C K | W Q K G Y H;C
U K P W Q F A | P W A Q F K;U
S W H T C K A | T H S A C K;W
G B K U W D T | T U B G W K;D
L M J S T V U | S U T V L M;J
G R B L T Y A | R L T G B A;Y
L K X Z E R V | L X E K Z R;V
H Y F E V Z L | E Z L V F H;Y
E O I M A W R | I O E R A M;W
J Y E X N K V | V J K E Y X;N
C Z D H R U O | H U Z C D O;R
C X Z G K P B | G P X C B Z;K
J E C W M F G | M J W C F G;E
O A I R K M V | K A R V M O;I
R Q G A X B P | G X R A B P;Q
W U R Q L O C | C Q R O L W;U
Z D P R H W J | D J W R P Z;H
A P B K F L G | B K P F A L;G
W D A Q O U X | D W Q A U X;O
W Y K X E N B | X N E W K Y;B
D J A F O X Y | Y D J A F O;X
H C F P Q V U | P H Q C F U;V
M S Z D T O Y | D Z O S M Y;T
L Y S H T E J | Y T J H L S;E
O G T U D S F | G D T U S O;F
J F Y C S X M | X J Y M S C;F
V A U H F B X | H B V F X A;U
P L V M E F K | K L V P F E;M
U K L E P T B | T E B P L K;U
I P T N F Y Q | T I F N P Q;Y
Y L C T G M Z | T M L C Y Z;G
S N J G E H Z | J H N S G E;Z
R C M B J L Y | M B C L R Y;J
K G V X T P I | X K I V P T;G
E I L V S D K | K V S L E I;D
K U I G L X S | U L S I K X;G
V Z B W U A L | B V W Z U A;L
S U P Q V X A | P A S V U X;Q
W P A C N Y K | Y K A C P W;N
X I J U B D O | I O U J D B;X
A M Q O D T I | I D T M O Q;A
M F C N V D X | F V X D C N;M
J W V X B U S | S V W U J X;B
U A V M P H W | H M U V P W;A
Q U O V T R A | U A Q V R O;T
Q O D Y H E R | Q D H Y E O;R
S L R Y H N Q | H R Q Y L N;S
F A E O X L C | F X C E L A;O
L S K W Y U O | K L Y O U W;S
B C K U D P A | D P K C A B;U
A J W Q U T K | K J U A Q T;W
G J N B V Q Z | V G Z N Q J;B
C M J I E U R | E I U M R J;C
W U I Y R O S | W Y O U R S;I
N G Q C P X Z | Q G C N P X;Z
W C G J R K M | K J W M G R;C
M K N W Y Q J | J K W N Q Y;M
B V E U M K C | U V B C E M;K
P W K F U V L | L V W P F K;U
X B U Z M I N | U Z X N M B;I
V B O I D K A | A V K B O I;D
K C W E G V T | V E T W C K;G
E V I R D C T | D E C R I V;T
K L S N E X J | K X N L E J;S
D G X A T H J | X J D T A H;G
G Y W N Z U J | U J W Z N Y;G
N Y Q J H D I | Y N H J I D;Q
I C L D G B Y | B L Y G I D;C
A H F U T I Z | I F U T H Z;A
K A N U O M S | A U K N S O;M
Z F C T L Y Q | C Y F L T Z;Q
R Y O E Q N M | O N R E Y Q;M
P T R M K X E | K P M R T E;X
E R A T U X J | E T A X U J;R
F V D B P N O | D B P V F O;N
X T K Z A B U | B U A K T X;Z
P C R L O B Y | B C Y R O L;P
G I T Q Z P O | P O Z Q G I;T
G I R Y U T A | Y G A I T U;R
X A D I N J Z | A I D Z N J;X
F X S J I O N | X S I J F N;O
L I V T B A U | T I V B U L;A
I W S H P O N | P I S N W H;O
Z O K W J P D | P W K D J O;Z
N G B H I D Q | G H N Q I D;B
O Z I T N Y S | Y O N T S Z;I
G O B A E P V | A B V G P O;E
T X S B D R Q | R D S Q B T;X
N C K M Y L H | Y N K C M L;H
N M O L J I B | N M J L I B;O
N B L V Q I F | I Q F V L N;B
W X N I J M L | J M X L N W;I
Z H T U P L Y | P Z H L U T;Y
S L M D T P A | T L P A D M;S
B U C H G L K | H U B K G L;C
H C O G S D R | O S G H D R;C
T O E S Y G K | Y E K G O T;S
D C J Y E G S | J G E Y C D;S
L C B D V U W | D L C W U V;B
G H Y U R Q D | H D G R U Y;Q
P D X Q C A Y | X C Y Q D A;P
B F R S A D T | D R F S B A;T
E T R L C N J | T J L N R C;E
M L T S E Y Z | T E S L Z M;Y
K A D T J U F | D F K U A T;J
Z Q B O S X J | B J Q O X Z;S
Z S C E G W L | G W Z L S E;C
V A T O Y N F | T Y N O V A;F
S J Q R L B M | R L B J M Q;S
A Y G D M B H | D Y M B H G;A
O R Y G T P V | G T V R P Y;O
V A J W K S M | V J A M S K;W
M I Z U F O V | U I Z V F O;M
G E C Q A F Z | E Z G F Q A;C
O F S J D B T | B F D O J T;S
M U T Q B Z D | Q T D U B Z;M
C H J W A Q Y | W C J H Y Q;A
Y N J Z S F D | Y D Z N F S;J
D P F I V O R | V O I R F D;P
J N L Q Z S U | Z S U N J L;Q
R B T N V F X | T B R V F X;N
U A S L Z I H | I S A U Z H;L
J S Y A N D P | N D Y J A P;S
B K E J O X C | B K O X C E;J
S J C N V X Q | J X N C S V;Q
C D G H W B I | C D G W I H;B
Y N L G I R Z | N L R Y I G;Z
B F G K Y N D | N D G Y B F;K
R F X T Y L M | X M L R T F;Y
U B M V S J G | V S B M G U;J
Y Z K D W M C | C M Z Y D K;W
H L Q W X D E | Q X W L H D;E
I K D P N G W | N G K P I W;D
X M S L F E Q | Q X F S M L;E
D L G Z R W J | J W R L G D;Z
N S Y V P R I | S R P I Y V;N
K U Q X V L H | L V H X U Q;K
G Z X T N S F | X T F Z S G;N
J M F B C G N | G C F M N J;B
B F T Q V E H | E F H V B T;Q
O R T J Q L B | R L Q T O J;B
D A W N G C P | N P W A G D;C
U L J C O S Y | O C L U Y S;J
N Z K M D U I | I Z M U N K;D
M J B N Y X S | Y X J N S M;B
D F B L N O Z | B D Z F L O;N
V X N Y O A S | N V O A S X;Y
N I B Q S K W | S I Q W K N;B
U W R C Y H M | Y W U R C M;H
P S X E N W C | E S W N P X;C
C W Y H Z X U | Z U W H Y X;C
O X J Y L E V | X V O J E L;Y
E I V D P Y W | I E V Y P W;D
S C E X H Y B | B S H C Y X;E
F J N C W V L | W J C N F L;V
M F H P N B A | N P H B M F;A
G J S R H Q T | T H J G S Q;R
A Q M Y X R I | M R Q Y I X;A
N B E O I M R | R B E M I N;O
A G J H B M E | G A H B E M;J
K B Y W X J U | W U Y J X B;K
O B X K W M H | O W B X M H;K
G T Q V Z A L | V G Z A L T;Q
D T A M W C I | D T A W C M;I
E I T W R G Y | Y R E G I T;W
O T M W Z E N | E Z T M O N;W
W H T E U Y N | H N E W Y T;U
S T L A F R I | T F I L A S;R
V K S Q G B H | S B V G H K;Q
M U L J I R S | S I M L U J;R
H T F K Y W J | F K W H T J;Y
X P U I N M Y | M I N U X Y;P
H F S O M Q B | M F S O B Q;H
Z R U T E N S | R U E N Z T;S
Y V W U I B T | Y I U B T W;V
Y F S R O A J | S F O A J Y;R
V J P I S O R | V P S J O I;R
B H M L C E D | D E L M H B;C
D B J E I A C | I E C B J A;D
Q F C N H S M | S M C Q F N;H
P T R S D Z C | R T Z P C D;S
