C I X F B V E | E V B C I F;X
D S K X O C N | C X D K S N;O
W P S C Y D N | Y W S D N C;P
I X L R M C P | I M X P L C;R
G W L E S F V | V G W E F S;L
R K E F Q V Z | K E R Z F Q;V
W E Q M R G J | E W G J R M;Q
O D W U B N T | T N O D B U;W
M B G N S Q P | S G Q B M N;P
B N S E H V Z | V B E N Z S;H
M D Q Y W T P | M Y D Q W P;T
T G V P I C Y | I Y G P C T;V
Q Z X U A J H | Q J Z U A X;H
W O D E G V T | W V O D T E;G
Q K X N R O P | R Q K P X O;N
F R Y D G B V | D G F Y R B;V
A J P C Q B L | J B C L P Q;A
O T Z M U Y I | O Z U T I M;Y
A Q O K S L N | K Q O S A N;L
D L N E Z O G | O E Z N D G;L
E K Y X C M D | X K M E C D;Y
R Y N U P K S | Y K U S R N;P
Z A G L R J E | Z E J R A L;G
H M L T A I Z | L H M Z I T;A
Y L X F H M E | H M E Y X L;F
O W Q H U J V | W J O H V U;Q
Z X V K C L A | Z A X V K C;L
F U X Q S H N | U X H Q S F;N
I A R S K U B | B I K R U S;A
D C F Q R Y P | R C Y D P Q;F
H L Q A N Y U | Y A N U L H;Q
Z J T Y V L F | L Y F Z T J;V
X H Q L V J D | J L H D V X;Q
F Y T C G M S | F Y C S G M;T
M I P S J G U | U G M P I J;S
E D T G K X W | G E X K D T;W
F T V W K H I | I F H K T W;V
U L C D H B J | J C L B D H;U
S H Y O D Q V | O Q H Y S D;V
L U T W I F O | I F U W T L;O
K S A J N O P | J A P S K O;N
V Y G N U B R | V N G Y U B;R
R P E U Y Q D | E U Y D Q R;P
X P V E R U L | E L P U R V;X
R D O G S L Y | L Y S D O G;R
X Y G H J O E | H E J Y O G;X
U T E J G D S | E G T D S U;J
C U B E T L O | B L E U O C;T
Q B D P Y X L | L X Y D P Q;B
M U S P G O R | R M G S P U;O
T Y L K I M Q | Q M Y T L K;I
C Z S M U R J | J S C R U Z;M
C T W A G E D | C T D W E A;G
G Z K T A H I | K Z T A H G;I
O Q J C M V Z | J V Q O C Z;M
K Q R H B X D | D H R K X Q;B
Z X T Y N B P | Z B P X T N;Y
Z P G A H Q C | A G H Q P Z;C
F N L Z E X M | N X M F Z E;L
L P B F E G V | E P G F B L;V
J B P R D I S | I S R J P D;B
F D C O Q E T | E T D O C Q;F
X U Z E N T C | E X T C Z U;N
T Z F P Q L Y | Z T Y F Q L;P
O Z H L R J D | H J D Z O R;L
Z L K G W H X | W Z L H K X;G
W X C H A S Z | X H A C W Z;S
M P W V D A L | W A D V P M;L
Z P V W J D E | Z J E V W P;D
K V E W G C S | W C E S K V;G
C W E L P G R | R L E C G W;P
D N L P F B K | K L B P F D;N
T F N X U B D | F T N B X D;U
B O K H S W R | H K S W B R;O
D N H W Q K B | D W K B H N;Q
U Q M W S L Y | Q L S U W Y;M
B I A X W V D | X A D V W B;I
D A L I G Q P | L G P A D Q;I
U Z O G V B D | O G U Z B V;D
Q U E M Y K X | K U X E Y Q;M
I P V Y U L J | J P L Y V I;U
G V M U P C I | V I P C U G;M
D I H O F Y E | I Y D H F E;O
G J C Z E R H | Z C R H J G;E
F W N A T G Z | F N G Z A T;W
P D U S Z N O | S N D P O Z;U
I U Z R S W F | R Z U I F S;W
L H V D T U F | F U L H D V;T
B Y M Q S W O | B S Q O W M;Y
F S O K T D J | O T F D J K;S
R F T Y Z E V | Y R Z F E V;T
T S K U W Q G | T G S K U W;Q
U I H A F T D | I H A D T F;U
K X U C O P L | P U C O K L;X
J G F U Z W C | W G F Z J U;C
Q J I D P H O | I H D Q J O;P
I U F O W A L | A F U W I O;L
W U H O L A Y | H W O U A L;Y
Q D Z Y N X H | Z X H N D Y;Q
H J I S A V M | H I M S A V;J
V M P D I X O | D V P I X O;M
O H S C A X Z | Z X O H C S;A
E X U D C L A | E X C D A U;L
B O F R P L K | R L P F B O;K
X Q H C W V U | H V W U X C;Q
L K U C Z N S | Z N C S U K;L
Z T P F S K H | Z P K T F S;H
X H E V L P T | X T L P H E;V
H U T W A N P | H P N W A T;U
H V O X U T I | V I T O U H;X
U B W I E Q N | W N E U I Q;B
C K M D E W B | W C D B K E;M
T Q G K B Z E | Q T Z G B K;E
N V X Z R I Q | I Q Z X R N;V
F H A R E L N | L N A H R F;E
W G X Q D U O | G Q W U D O;X
B R S E O J N | R N O E J S;B
V I N Q E A Y | Y I A V Q E;N
L M G V E N B | E G N B V M;L
S L I X B C A | B C I L A S;X
X E N C T O P | N E T P O C;X
T L I K J H S | S L K J I H;T
D S F J G Q P | J F S P D Q;G
F X V U P C J | V C X F P U;J
A Q Y X F H M | A H M Y Q X;F
W H X D L V Y | W H V X Y D;L
R L Y P I S M | L P R Y S M;I
U Q I O G R Z | G U R Q Z O;I
K W B Q E T Y | E W T B Q K;Y
J Z D S K G Q | J Q Z D S G;K
P I L B R D W | W B R L I P;D
H V G R X W A | H G R W V X;A
G W B K S U X | B S U K W X;G
B D G R Y E F | D G Y F B R;E
B F I X Z W E | W X F I B E;Z
E T P Z I G W | T Z E G I P;W
G Y V B D E H | D Y H V G B;E
H E U B W I V | W I H E B V;U
F A W O L R H | H O R L F W;A
T Y O I H F Z | Z F T H I O;Y
Y F G N R J M | F N Y G M R;J
S A T D I O C | D O T C A S;I
F X S R I Y E | R I X F Y S;E
V P G Z K T M | V P K T Z G;M
Y B L I K W Q | Q W K Y B L;I
L H T Q R F K | K F H R T L;Q
T W U S H M X | S X W T U H;M
O C P K U T Q | C Q K U P O;T
I Q E B L U J | E B J U L I;Q
C D O S K L V | V K S D L O;C
U C S X Q A O | Q S C O A X;U
I N G J W M F | G I F N W J;M
Q I V T A J E | E A J I Q V;T
E P Z Y M G O | G O Y E P Z;M
R I C X G N H | I G X N C R;H
U Y A I C J X | Y X U C A J;I
P G A V O C X | P G X C O A;V
E G P B Y W O | G P Y O W E;B
H M L N B K D | M N H D B K;L
W K R P E F I | P I F E R K;W
V N Z K B I D | B N D I K Z;V
M E W P F Y T | W T M P E Y;F
K E I S D X N | X D S E N K;I
M L D N Q R W | D N Q W R M;L
N E A X L O J | J L X N A E;O
H J R L S I Z | Z R S L I J;H
E N M Q U Y P | P Y N E U M;Q
D X F J L U T | F L D X J U;T
Z I W T L M D | W D L Z M I;T
K T G Z P M B | Z P B T K G;M
J G Z W B X C | B J G X Z C;W
M B X A L W Q | W Q M B A L;X
S M U B J F Q | S U F J Q M;B
Q H F D K S X | S K F X H Q;D
R B L D Z T P | R B T D P Z;L
W J R O Q T Y | J Y Q O R W;T
P R C O G F E | O P R F C E;G
X I Z Y L Q O | Q O Z X I Y;L
F S I P E L Z | Z I F P S E;L
Z M S G A C E | Z S C E G A;M
C Q D S E I R | C D I Q S E;R
K L X F N A S | A X F S N K;L
R E U K B Z Y | K Y E R U Z;B
R S D A U I M | S D I R U A;M
B Q A C S P Y | B Q C P Y S;A
R Q U Z W H J | R W U H J Z;Q
N H F A T B G | B H N F A T;G
H O F V U A D | D O V F U A;H
F I O R T W U | I U O T W R;F
P Z A Y C O R | R Z C Y A O;P
N M T B O A F | A O N B F T;M
N O B J W T Z | N O J Z W B;T
L S C J G X M | C S M J X L;G
D P F R V C S | P D S V R F;C
N Z J O T Q V | T N J V Q O;Z
R K Q F G M V | R G K V F M;Q
L U N X G S E | N L U G S E;X
M S K N I B T | T N S I M B;K
K I R Q F X A | X F A Q K I;R
B K W R I H F | R H W I F B;K
I C F D Q B H | H C I B D Q;F
F M Y Z T E B | Z M F B T Y;E
E V G A D M U | E G U M V A;D
T E C B J V L | V L T E C J;B
E V X G N K J | X J V E N G;K
G E R L P D W | L G R P E D;W
H O C D P E I | H P D O C I;E
L S W T F P C | L W C P T S;F
S I Q Z B E M | Z I E S B M;Q
N L H K S U J | J U N S H L;K
Q B V N F R D | D R F V Q B;N
L J N U P I B | L B N I U J;P
H D W E Z L P | P D W Z H L;E
O F Q N W T B | B N Q W F T;O
P U A H W Q Y | A P Q Y U W;H
F B S Q Y P N | F N B S P Q;Y
Z C G W K P X | K P W G X Z;C
H Y L Z S N R | H R S N Y L;Z
L T R P U V F | P L V R U T;F
K Y O W H R E | O E R H W K;Y
J X Z B T S H | J X H B Z S;T
U A Y Z O M I | I U Z O Y A;M
W C X A V Q O | V X W Q O A;C
Y E G J K Z O | O G K J Y Z;E
K B E P W Y V | E P B K W V;Y
K M V E F O B | V O M K E B;F
M H Q T A J W | T H J M W A;Q
D Z I P T H B | Z T D P I H;B
Z K Y C T A H | Z K Y H C A;T
G J M W Q D H | H W J G D M;Q
Q Y U C W T O | U W T Y O C;Q
E P F L U Y Q | Q F E L Y P;U
E G A K O Z I | G Z I E A O;K
S G Z W Y D J | Y W G J D Z;S
L D Z E S Q H | Q H S Z D E;L
U E V T M P D | M P V T D U;E
P A C U W D Z | C Z W U A D;P
Q K L G U V O | U V K G L O;Q
P U S T A N D | P A S N D T;U
Q T B C K N Y | B Q K C N T;Y
Z O U D K S V | O D K Z V U;S
W L Z T Y E F | Y E T W Z F;L
D J M A Y F K | K A J F M D;Y
L Q M O S H U | L S O Q H U;M
U N I P H K Q | K U N I Q P;H
X P C U K F Q | C F K Q X U;P
R C F W S V I | C W S F I V;R
E O J M Q F K | Q M F J E O;K
T K N Q V D G | V D G K Q N;T
O S P G L Q B | B G P O L Q;S
V H M A J W S | A H W V S J;M
N M T Y C W V | Y V N M T W;C
K V S T H E G | G S K H T E;V
K Q J N A V I | I J Q V K N;A
Z C S X N G T | X S Z G N T;C
X G D W V H B | D G W B H X;V
B J T P Q X S | Q B T S X J;P
K W D T X O R | D T X W O R;K
C E V P Y H R | V R C H E P;Y
V P I S Q Y U | P V Y I Q U;S
C U Z Y R G V | G Y R C U V;Z
Y J Q A R K E | A R J Y Q E;K
I E P W Y V J | P E I W Y J;V
N Z O L K A I | I O N Z A L;K
Y B C X Q M T | Q X M B Y T;C
X G I W N C E | N W G E X I;C
L J A R M X N | R A N M L J;X
I V L K S B G | L S K G I V;B
D Q U L M X A | U Q A L D M;X
I M K W B J X | B W X M J K;I
D O X S A L M | L S M D X A;O
I Z P B M K W | P M Z B W K;I
H U A V N E S | S H U A N V;E
D W M O K A S | D K O S A W;M
M E D O N L Z | Z M O E N L;D
J H X Z N C D | X C N H J Z;D
M Y P B X A W | A B P Y M W;X
W U H Z M K T | T W M H K U;Z
C Q U S A H E | E C Q A U H;S
R K I U Z H C | U K C Z H I;R
R K S C G V D | G D V S K R;C
C D H Z I T N | Z H D N C I;T
F E K Z C X P | X P K C E Z;F
J U E A Q G F | A Q J E F G;U
N J O X T W M | O N W X M T;J
S V H A T I P | T H I V P A;S
P E V U D C B | D U E C V P;B
P Y H R L U T | R L U Y T P;H
W P J Y R A G | P W Y G R A;J
X Q U A O Y P | P Y Q O A X;U
N S R B A P E | A R E N B S;P
Z G E M A U H | M Z G A U E;H
H G D L A P K | H K G D A L;P
M D B O H A P | P A H D B O;M
P N B V H M W | N V H W B M;P
B W I G A K T | A K I G B W;T
N V M P L Z B | L M V P B Z;N
Q N G U I C Y | Q Y C I U N;G
J W L R G N U | W J L G R U;N
O H I E F B M | F I B O E H;M
U H Z F G W K | H U W F G K;Z
V O T D Y R J | Y R V T O J;D
T P A L N K R | A L R K T N;P
T P N H M W X | M T X N W P;H
L J T V S N R | V S T N R J;L
T B S Y H M X | Y T S H X B;M
W O E T D V Q | W V O Q D E;T
Y D P I H C A | P I Y C H D;A
L Z P I K E M | P Z K I E L;M
R J I G B C K | B I G K C R;J
B J R T I A M | M A B J R T;I
X F R H Y J D | H R X F Y J;D
V L J I U D S | U V L J S I;D
O Y A M Q L I | I A O M Y L;Q
I R G L H Z O | G R H Z O I;L
N K I O J E Y | K N E O I J;Y
G N H U Y B T | B U H T Y N;G
A D K J Z H O | K D J O A Z;H
T N G J H D Y | Y G N H D T;J
D L K T N Q J | K L N Q J D;T
I F Z G N P D | F P G D I N;Z
W T Q J F Z D | T Q F Z D W;J
T V M J S H D | M J V T H D;S
F M I Q W R A | F W M Q R A;I
F X H C G M K | X G F M K C;H
L B J W M R E | M R W E L J;B
R F C E V U T | C T V R F U;E
S D E U W R T | T R W S D U;E
M T Y R K P Q | Q K M Y P R;T
L G R I B X Z | X R L I G Z;B
M N K V T J G | J T V M G N;K
T N H Q Z F E | Z F H T E N;Q
V O G F P D C | P O D V G F;C
P V C Y W R T | C W T Y P R;V
O F M S G B Z | G Z S F B M;O
U B H S F Q K | K S B U F Q;H
W I Z K D Y H | Z Y W I H D;K
I T Q O C H P | C I O T Q P;H
B L R C U Z T | B U R L T C;Z
F O S R I W M | M R F W S O;I
Y O X R P W K | X Y R O W K;P
E G P Z J O D | J P Z E O D;G
C M X B E H O | E H M X C B;O
G F Y J B I V | J Y B G I V;F
C H R O L J K | R C K L H J;O
J X H S N R E | X H N J R S;E
P A Z C L H O | L C A Z H P;O
I A H O N J X | A I J H X O;N
Z L I Y V S B | B L V Z S Y;I
O R M A J D X | A O J X R D;M
B O W V S M J | M O B S V J;W
W V Y D K I R | D V I Y R K;W
O Y T M L F G | Y L F G M T;O
I S W X U A L | I X S A U L;W
B G O M L N Y | Y B O N M G;L
M H C L V G J | V M L G J H;C
T F R U V X S | X V U T R S;F
E N A G I B Z | G B I E A Z;N
N E V C L K R | E R C V N L;K
U J S C H A Q | A Q C J U S;H
W O J F X D Y | Y X D O F J;W
U K H I S C F | C U F S H I;K
Q D E W C T A | C D A T Q E;W
I F Y A E Q L | L A Y E F I;Q
U N D L W I V | I D W N V U;L
H N L A Z C G | H C G Z N A;L
Y K L E M J N | J Y N M L K;E
U M C V T J G | V U G J T M;C
I C V Q G M R | C G M V R Q;I
T I M C V A N | M V I C A N;T
U I Y H C L B | B Y U C I L;H
G D B W F M T | T B M W G F;D
P K O F G N B | O G F N B P;K
P J S Q T E W | E Q W S P J;T
L K Z F Q S W | K W F S Z Q;L
E K Y D I O M | M E O Y K D;I
O I D M N B A | D I M B A N;O
A Z P J H Q X | Z H A X Q P;J
K R E J O N I | N J E O R I;K
C M Q R Y W G | Q Y G R M W;C
M A K L I N C | A M I N K C;L
V X H C L A J | C H X V L J;A
A M R W J S L | R L A W S J;M
E G P B D I H | G H E I B P;D
Z I G Q L Y W | G Y I Z L Q;W
E H Q X K D I | E H I X D Q;K
P E F C S U Z | F C P S Z U;E
T L F A O S V | F T L S V O;A
Z N Y C J T R | R T J C Y N;Z
Z O Q R D B U | Z Q B U D R;O
T F Y J G O S | Y O T J F G;S
E I X R U W F | E R F W I U;X
S L U G N T B | T G B U N L;S
Z V Q A I N X | X I Q N A V;Z
E P W H C K N | N W K E H C;P
K H M R Y E X | Y R E K X H;M
C M A V X Y R | A M R V C Y;X
W Q L R T X N | N L W R T Q;X
I N C L M O E | O M C I N E;L
G K V B Y P H | Y B K V G P;H
Q S J I U F N | I S U F Q N;J
J W Y O U D L | L W D O U Y;J
Z T U S B P E | U P S B E T;Z
M G L Z W X E | L Z X W G E;M
W P M J K Y N | J K W M P N;Y
W Y L T Z P E | Y P W T L Z;E
H Q F L K A M | H L A K Q F;M
O R I U M X B | O R U I M B;X
Z G K S M C X | C G K X S M;Z
F O A H M N U | A H U M N O;F
F H V I T O Q | F T Q I H V;O
T M W L E O A | A L W M E T;O
D I Z J S F W | Z D I S W F;J
Q V B M J T E | M T Q V J E;B
G Q C W E H K | W G H Q C E;K
D R S G Q W X | W X Q R D S;G
P B K E G A V | K A V B G P;E
M U K E F R D | U E M F R K;D
Q D T J M S A | S A Q T D J;M
R G T Q N X H | Q R N G X H;T
Y O W A S M U | A M U S O Y;W
O C N V L T Z | T V N L Z O;C
P H Q S O D G | S P H Q O D;G
Z L K Q J U W | L J K Q U W;Z
N T G P F D E | G E N D F T;P
V B K Y A U O | U O Y K A V;B
M F B X A T H | B H A M F X;T
Y T F A J C I | Y J F T C A;I
A V Q W I Z G | G Z W Q V A;I
H N B V G Z C | C B H G V Z;N
Z O C F Y P T | Z O F T C Y;P
A Q U P T I L | Q I L A U T;P
N Q X G D R O | X Q O G N D;R
F R J T V C D | C D R F J T;V
J E V W T U R | J U T V E R;W
O Z Q R G X L | L G X Q O R;Z
X B P J R T W | P X W B J R;T
C I Y G A V K | V K Y G C A;I
Q J E Z I A D | A I E Z D J;Q
T F E I S X M | E I M F X T;S
L Q D A E R F | R E Q L D F;A
S P R F T C U | P T F S R C;U
L H P Z I Q M | L Q M I H P;Z
L C F U A O N | C A F L N U;O
R E Z I Q V D | E Q R D I V;Z
M A J K S I U | J M S U K A;I
C P U W F Y I | I P C Y W U;F
Y T E A X J S | J T X S A E;Y
O J M F B G X | X J G O B F;M
D Y O F W T X | D W Y T X F;O
F C E U K T V | V U E T K F;C
M G T I D C X | M X D G T I;C
R Z N D C J F | R N D Z F J;C
C U Z E K L I | U Z C L I K;E
O I G C T B Y | G O C Y T I;B
F U J I E S K | U K F E I J;S
G H E L V Q Y | H Y E Q G V;L
W F J Q D R N | F W Q N R J;D
D F X N O A T | O N F A X D;T
L P C Z Y I T | P Z T Y I C;L
G M O E B W R | M O E B G R;W
G K P A Q M H | K Q M G P A;H
A T R Z N X B | X T N Z R A;B
P O X B C D Z | P X B Z D O;C
O M I E L C U | I U O M E L;C
O B J N I G T | O G T N B J;I
Q D O P L Y H | H Y O Q L D;P
G D W X F C S | C F W X D S;G
C G S Z U R I | U G S R I Z;C
B F X L I O R | X O L R B F;I
D F L Z O T R | Z L F D O R;T
H B O L R G N | R N B G H O;L
R P D F K C M | F M D R K C;P
P U L Q X C N | P N L X C Q;U
O Q J S T R W | W Q J S T R;O
G R N P X F S | P R G F X S;N
R E Y W P V I | R V P W I E;Y
R E F J W D K | F K E R W J;D
N Y Q F U K L | U Y N L Q K;F
N Q R O V H C | N C H V R O;Q
V R L J T F Y | V Y R J F L;T
I M S F A J X | X I M S F J;A
M X O R L S K | L S M O R K;X
A N R U E B T | R U A N B E;T
I J G V N B U | G N U B I J;V
T W P E G L Y | G T L W Y E;P
Y E C D N F Q | D N E F C Q;Y
F N M W S Z C | F W Z C M S;N
Z Q G P L D B | Z G D P B L;Q
C D B U X A T | C T D A B U;X
K N B I C E D | E K I D B N;C
H T W B K Y Q | W B Y K H T;Q
U J L H M Y O | U M H Y J O;L
E H M W T F Y | W T Y E M F;H
K C M V B J Q | B C M V K J;Q
M T Y A H D I | M T Y H A D;I
U N S K A B Z | A S B U Z N;K
B L G K X T P | X T P K L B;G
G X D K C V R | G C K V D R;X
S I T J R V K | I V R J K T;S
G N J C R M L | M N J G L R;C
I C J Q V P E | J C P I E Q;V
W E P L B Y M | W M L Y P E;B
V C J T K G H | K G T V J C;H
V W K M A U N | W N K V A M;U
B Y A H E C O | O A E Y H C;B
H P W U E G Y | Y P H U E W;G
K C S H U Q W | H C S W K U;Q
U D R K Y H Q | D K R H U Q;Y
N B Z W O K E | O B K Z W N;E
F G C T H Z W | H T Z C G F;W
Q I N P A C E | A N I Q E C;P
U J T O A Q F | J Q F O U A;T
Z A T G O W X | Z X G O W A;T
B E C V S H T | V C H T B E;S
T O S V W G L | V T G O W L;S
X V A Y T R D | T R X A Y V;D
W O K D U X F | X F K W U D;O
B J S X D A M | J S D A M X;B
G V O I Q F Y | F G V I O Y;Q
J T G S X F Q | J T X S F Q;G
I E P M L U O | P L I E O U;M
N Y G I C L H | C I G N H Y;L
P F O V H I L | H P I F V L;O
I O C A S Y E | E S I A C O;Y
I T Y Z K S W | I Y S W K Z;T
N C E K I D P | D C E P I K;N
M K Y U O F J | F M Y K J U;O
D R O V L P Q | P R V L Q D;O
O W Q J I V G | O Q G I J V;W
V R Y L F B X | R V X Y F L;B
P O H E S C K | E O K H C S;P
L G X W J S F | X J G W F S;L
U M K W L C P | L K W M C P;U
M V Q L G H P | H P M L G V;Q
G B F U M O I | G B I M O U;F
A Z Y B C M Q | Q Z C Y A B;M
L C P D M Z T | T L Z M D P;C
O Q J F G D L | D O L Q J F;G
K V Z W F B M | W Z K V F B;M
H L T N X K R | L T K H X N;R
F V X A P O M | F V M X A O;P
Q U M N F Y D | M Y N F Q U;D
S A Y M L D T | T Y A S D M;L
P R Q C X J G | R J P X C G;Q
S K C E T P W | C E S T P W;K
Z Y C W J H P | H C W J Y P;Z
V M F O U Q Y | M O U Q Y F;V
D X W A B Y G | Y W G D X A;B
Z O J H W K Q | H K Q O Z W;J
A S I M T U X | X I T M S A;U
X T Y V U D J | V U J T Y D;X
D F T P X V U | D T X U V F;P
C W A X U M S | S A C W U X;M
L X N S F C W | F W X N C L;S
W U H T R K G | R K G T W H;U
P D B F T I R | F D R T I B;P
Q F L K P J Y | K F J Q Y L;P
I H J M C Y W | C M H I W Y;J
X T F Q S O R | X T F R Q O;S
X K Y D F H I | H F D Y X I;K
T Q X D V G M | V M D X T G;Q
H K Q J D Z A | H D Z A Q J;K
Y M W N G A P | N W Y M G P;A
B S H O Y L A | H O L Y S A;B
N X H P S Z O | N X P H S Z;O
C N V O S R P | R C V O P N;S
V A P T Z O I | P V T O Z A;I
W L I N S M D | M L D S W I;N
I G L E T P Y | T P I E Y G;L
C Z A I T P W | T C Z A W P;I
W C D J I K V | W K D C V J;I
X H N A V P F | F X A V P H;N
P X N F W H R | H F R N X W;P
O U P F R Q A | P Q A F O U;R
Q Y R X D F N | R X Q D N Y;F
C B X N V K F | V F B X K C;N
L I Z O R C J | I C Z L R J;O
C H Y T A I J | H J C T I Y;A
A L J N C P Y | N Y A C P J;L
B W G A N L J | N L A J W G;B
G Z C P V N R | C P Z N V G;R
N O W M S L U | N M U O W L;S
X E U K M C G | U C X E M K;G
Z J F W R C N | Z F R J W N;C
X S T W N E Z | T S N X W E;Z
B W U Z A J H | Z B U H J A;W
P D K J T L Z | D T L K P Z;J
U C G M J I O | C M O U I J;G
W F H B Z E T | H F B E T Z;W
X G I O N W S | I O G W N S;X
L N V I X W S | S L I X V W;N
V D Q E C J K | C K E D Q J;V
W R Y M X Z Q | Q M R X Z Y;W
R K O X A Y B | R X A Y O B;K
U O I D Y T G | T Y D I U O;G
V Y T L J N B | N L Y V T J;B
P D Q R H B K | B H R K P Q;D
L Z E U Q D O | D Z U L Q O;E
X Q T M G J E | J X G E T Q;M
A J E D B O R | D E A J O R;B
B T P I K R S | R K T P B S;I
A N Z X G R K | N X A R K G;Z
G H A W M E R | H R E A W G;M
Q Y L O K H T | Y Q L H K T;O
E W X U Y P Z | P U W X Z E;Y
V L G D U P O | L P O G D V;U
G B X I H W P | H P G I W X;B
U E N V M A H | N V H E A M;U
W G K E L C B | C E B G W L;K
Y A E U X D B | U B Y D X E;A
O B C V G J P | C B O G V P;J
Y A H W E S I | I A S H Y E;W
J U S L P I X | U L J X P S;I
S K O C X M P | S O K C P M;X
L U H X C V P | C V L H U P;X
C Y D B H G O | D H C O B G;Y
J D Z V E H K | H V Z E D J;K
U S O L F M A | O U M A L F;S
S L Q X F W V | Q V W F S X;L
U H D R G A M | A H U D R G;M
D N V U W M R | W N R V M U;D
I H L W Y N K | N L W I Y K;H
M J R N K Y A | K N Y R M A;J
L T J E A F G | A J F T L G;E
O N I P X T U | T N U I P X;O
A R M Y W J F | Y W F A R J;M
J Y A L H E M | A H J L M Y;E
I K T D U Q Z | U D I Q T Z;K
C B L N R T Z | Z T N B C R;L
A R N H Z Q E | H A Z R E Q;N
S H D J Z A R | D R H A J Z;S
S D C P H L Q | S P H L Q D;C
I F W D J U R | I W R F J U;D
W Y A V K S B | S W K V Y A;B
I J S H L D P | L H S J D P;I
E A K H J I T | J H E T I A;K
K L H P I C X | L K I H X C;P
G P R J W Q F | Q P G F W J;R
V C Q Y N D A | N D V C Y Q;A
K Y T X C Z O | Z K X C T Y;O
C F W B U K G | U F K G C W;B
S J O I C H X | J H S O X C;I
T H S W E R N | T S E W R N;H
O X I M V E J | X J V O I M;E
M R B V J C T | T V B M C R;J
V U Q H F T R | F U H V R T;Q
R U M J L Z S | Z U S M R J;L
R J K Y Z L U | L Y Z K U J;R
H Q M T I L O | O H L Q I T;M
R T J O L F U | O R U J L T;F
L W R K C P S | K W P L R S;C
F W H U R G Z | F W R H U Z;G
T B E Q Z N X | Q B X N E Z;T
L G A N J R U | J A R N L U;G
X H P M I N A | X H A M P N;I
U G X H P Q W | U X H W Q P;G
P Y F J Q C Z | P C Q Z J Y;F
Z M S Q E V L | S L E Z M V;Q
X Z G Q S V O | S Z G X Q O;V
O Q E W F M L | L E F Q O M;W
T X Y Z V W J | W J Z V X Y;T
Q T X Y E L H | L H Q X E T;Y
N I C V M W G | G C I W V M;N
S R X K F B L | L R S X F K;B
N H K J L V S | N V K J S L;H
R N Q E G Z O | N O Z E Q R;G
T A U G I V O | I O U T G V;A
D R I B O S U | I D S R B O;U
A E Q F Y H V | E Q F Y A V;H
R S Q M N Z B | B M S Z N R;Q
U F V Z G K W | F U V G W Z;K
E S J N T L D | L E T N D S;J
P A F Z C G W | G A P W F C;Z
O A P C W J L | J L A W O C;P
R F X T G O Q | Q T R F G X;O
G K I S C F M | I G S M C F;K
Q E U L M I N | M Q U N E L;I
K H U N Q O E | K Q O H N U;E
Q D E H A G Y | Y A G H E Q;D
X A E U Q C R | X C Q U A E;R
E U N W T J R | R J N U E T;W
T I O L F B V | V F L T O B;I
F H U M I O C | I H U O M F;C
A M U O V X H | U M H X V O;A
X M U G H L O | H X O L M G;U
K W O N D V Q | Q V K D O N;W
W H G V D O S | V W D G S H;O
R D K E T W O | K W O E D T;R
I N S T E B G | B G E T S N;I
D T E Y B Q V | B Y V E D T;Q
V J O H I D T | V D T J I H;O
R S K B C X P | C P K S R X;B
K A G C T E Y | E Y T A C K;G
E G D H C Z L | L E Z G D H;C
D B Z S E T P | Z T P E S D;B
U E M J C Q P | P U M E Q J;C
J N G D B K P | J K N D B P;G
T J I W Y O U | Y W T O J U;I
A S L Q T E X | A S T X E L;Q
Y F A K V S Z | K A Z V Y S;F
Z S E U I T X | I T Z X E U;S
R B F J O L Q | B F J R O Q;L
D Q M R X E Y | E X D Q R Y;M
F K L B G X T | B X F T K G;L
G T S B E L A | T A E L S B;G
R C B I G J S | S R B C G I;J
X R P N K F C | X N R P C K;F
Z I V W G K J | V G Z W K J;I
U G N B L X Y | Y B U L G N;X
C U M R I F W | I M F C U R;W
S D M R X C V | S C V R M D;X
Z C A T U J P | Z U J T P C;A
W C P R Z M Q | M W R P Z Q;C
K M U J Q H F | F H J K Q U;M
X I E J O Q Y | X Y O I E J;Q
E A D V S K H | A S D V E H;K
X A M N F L Y | N X L M Y F;A
L U H E N S A | U E L N A H;S
B J X E Y P W | J E X B Y W;P
L I U S V Z Y | U Y L S Z I;V
T U G C D S F | C S T D F U;G
V O P E T H A | E V T A P H;O
W O H R G B T | H G T B R W;O
C T R Y X B K | T Y B R C K;X
R E H Z O Q I | I H R O Q E;Z
P C Q R M W F | Q R P W M C;F
P F A Y I L R | I F A L P R;Y
C N U G Y V Q | C Y U Q N V;G
R Q K U W M A | Q R U M A W;K
W L N F B J T | F N W L B J;T
W A L F N U G | A N F W L G;U
S D W J K N A | A D W K J S;N
L K Z H T C B | B L H C Z K;T
X U Z J P F Q | F P X Z U J;Q
F U Y A P W I | F P W I U Y;A
Z V S O N E L | E O N L V S;Z
O P D W E Z R | P E O W R Z;D
Q A Y L H E K | E H K Q Y L;A
M P N G F W C | F M G C P N;W
A C P N Y U J | U Y N J C A;P
R G I M N L K | G L I K M N;R
D A M H X K P | H D X P M K;A
E C D K V P J | P C V J D K;E
V N Q D G W H | V D G N H Q;W
C B S W V T J | J T W B C S;V
A U E B L W M | E M L B A W;U
U D A Y M Q W | Y D M Q A U;W
L K T I R O Z | O L Z T K R;I
R T A U K X D | D K X A R U;T
T Q G L V R Z | R Z V T G L;Q
E A U S M G J | U M A E S J;G
M A H C W D I | A D I H C W;M
U S K A F O B | F B K A U S;O
B M X V Z E G | Z M G B V X;E
I K F M T S B | B T F K I S;M
K E X W Y N J | X J Y E N K;W
X W R T U F Y | T Y U X F W;R
H B Y P W J Q | Y W Q H P B;J
N Y U C A I S | U N S C Y I;A
I C K T X D J | C J T I X K;D
Y S R C H P K | H R P C Y K;S
K Q N S P T V | S T Q K P V;N
Z I Y X A P D | X P I Z A Y;D
W E I M S C O | O S W C E M;I
V N S T A P Z | S T N V Z P;A
O R D I H F L | R D F L O H;I
H D N W S B Q | S D N Q B W;H
C M A I B X P | C B P M X A;I
C D V P Y K R | R D Y K C P;V
U P R G W S M | M U G R S W;P
V C W M R I F | M C W I V F;R
J M D G U C V | D U V M J G;C
S N T K F W R | W F S R N K;T
B K O L D W E | L B E W O D;K
X B G F K A N | N X K B G A;F
S H R X A K Z | X Z R K A H;S
P O E U V W L | L O V W E U;P
A N S E K F Y | S N F E Y A;K
N T E H S A Y | T S E A Y N;H
K A M V O U L | A M U K L V;O
C M Q Z A W F | A F M Z C W;Q
P U S Y A G T | S P T A Y G;U
G E U J X A K | J K U E G A;X
R A F J V I D | D A R J I F;V
F T I C K R X | C K R X F I;T
D H Z U X W J | U H D J W X;Z
B I H K D V A | V H D B K A;I
F B S X N W D | D B N X W F;S
G B N L I T J | L I J N B G;T
C R H F G Z N | Z H N G R C;F
W R F Q Y O J | O F J Q W R;Y
A V E Z T C Y | Y C V E A Z;T
F R A G B T U | G F R U A B;T
G I E F B A X | E I G B F A;X
P E Q H T N V | T E N V P Q;H
M K W Q U D R | K R Q M U D;W
P A F J B H K | H P F K J B;A
N R B Q J X O | X R O N B Q;J
B R V P J M L | P V J R L B;M
P B I X K R S | K X S P B I;R
V Z M L N X Y | M L N Z V Y;X
J Z F Y E R T | E Y J F R Z;T
A Y J H E N G | Y G A N E H;J
D Z Y E U V H | Y E D H V Z;U
V D P G M C I | M C V P G I;D
S J B T X Z N | N B T J S X;Z
U V K N C X B | N B U C V X;K
Y V D J C P B | B C V P Y D;J
J B E A U D M | M D U J A B;E
Q K Z M A P B | K A B M Q Z;P
X D R F E B C | C R X E B D;F
F V U A B M L | V M U B L A;F
T L X K E J G | L G E K T J;X
X S G D H K Y | K S G D X Y;H
D A K I R X Y | D R I K X Y;A
C Z W X V A U | C A U V W X;Z
Z H K B V R N | N B V K R Z;H
Q U B A D G H | Q H G D A B;U
A Y L H R O G | G L H O R Y;A
Q A V W Z S Y | Q W V A Z S;Y
S T Q J X M R | M J X T Q S;R
T U R W P C H | T W R U P H;C
N R V W F M P | R F N W V P;M
S H F I V U K | U K S H I V;F
U Y D G N Q K | Q G U D N K;Y
X G L D S O F | L O F G S X;D
R Y Q V B U J | Y Q J U V B;R
O H C P V I F | O C V F H P;I
Y P M G J V H | Y P V J H M;G
Y O F P W Q K | K Q P Y W O;F
Z D Y V S H B | H D Y B Z S;V
R T Q G V S J | T S J V R Q;G
O M N F W C S | C M N S O F;W
O K G Q I T D | D I T K O Q;G
C S O J W L V | S J V O C L;W
E N C O L R S | O L C E R N;S
W Y K G B N R | R Y B K N W;G
Q W E I K F B | Q B W K E I;F
N D W E X K Z | K E Z D X W;N
I W Z S U V M | W U S I V M;Z
T O R K X V H | O K T H R V;X
S A P B C H Z | C A S Z H P;B
F Q U S O B R | B S F O R U;Q
Y A D S M T N | Y D S T A M;N
H G U N K I B | H I K B N U;G
U I M B V S O | V S B U I M;O
W R L Z I C N | Z N R C W L;I
G E N W P H U | E U W H G P;N
T E S U W V C | T V E U C S;W
N P F K U D H | H N U K D F;P
S Y V B M L C | S L C Y V B;M
N V B Y F A R | A V Y R N F;B
I H E S Y R F | F I E R H S;Y
T F D N V L Y | N D L V F T;Y
V Q F O K X U | U O K V Q X;F
Y X M G B I W | I Y G B X W;M
J K A D U B Q | A K U D B J;Q
A B O I Y K L | B I O Y A L;K
V W A P K U G | P K A W G V;U
O C X Y Z H T | C H O Y X Z;T
W J Z R S T I | W T Z J I R;S
I Z R V P W T | P V T W I R;Z
R Z S A J M B | J M Z S R B;A
T A Y I G L F | L G A I T Y;F
A T B L H I C | A B T C I H;L
E Z G D L B J | J B Z E D G;L
T V Q S A K D | V A K D Q S;T
S D W Z M Q C | C S Z W Q D;M
B W P Q F Z L | L F P B W Q;Z
W X Z Q D F T | Z X D F T Q;W
M G T J L Y C | C J T Y G M;L
B Q E I U J W | E W J U B I;Q
Y C L U K J D | D L J C Y U;K
D K T Z V N B | K D N T Z B;V
K T P D Z J I | Z J T D I K;P
G E J R U C A | A R E U G C;J
L N H J Q E G | G Q N H L E;J
E N G Q M U V | U M Q V E G;N
O F X U P I K | U X I F O K;P
U A Q T W V X | A Q W X U T;V
M X G U K J L | U M J L G K;X
E P A U Q I L | A L U P E I;Q
T C V Z D H M | Z V D H T M;C
H B L R Z Q C | Z C B H L R;Q
Z C L O P K I | L I Z C P K;O
O K I V R U N | O R N I K U;V
O P H G Q N Y | G Y N O P H;Q
J P A B E O N | N O B E J A;P
V H K T O B G | T G K V O H;B
P W A N O X H | P O N X H A;W
W A B J U D Z | W D B J U A;Z
J P U N S R H | N J R U H P;S
V S F Y T N B | N Y T S B F;V
H U R N X C P | C P N U H R;X
B F A U Y H C | Y A C H U B;F
F W T C V P A | W P F T V A;C
R C N X W S T | S R N X W T;C
U A S K X W V | U A V K S X;W
B S P T V A Q | B S T Q P A;V
I T L M Q C B | C M Q L T I;B
H M D X Z Y S | D H Z Y M S;X
O R Z G A S W | R Z W S A G;O
T E V R P S C | S P R V T C;E
C P T W K A M | A P W C T M;K
V S H T X M E | H S M E X T;V
K R L J H C N | J H L C K R;N
U Z J F K W H | K W J F Z H;U
A X W G B K E | A W G E K X;B
J F D Z K X C | X D C K Z F;J
P X Z O E J R | J Z O R P X;E
D Q R M C F V | V Q M F D C;R
A V D L J C T | L C V D J T;A
C K J L E Y B | B L Y E C K;J
J S C H K F R | J H C K F S;R
F I W P Q M G | Q F I P W M;G
V F H Z Q D N | V N H Z Q D;F
L A W X J R Y | X J L R Y W;A
S D X G J R F | G J D X S R;F
I C V L D W E | D E C L V W;I
M H T B V O Z | Z V M B H O;T
C V M I W R Y | I R Y W C V;M
D G I M Z L X | L M X I D G;Z
Y W D S F X L | D F W Y L S;X
O X Y A M Z U | Z X O Y U M;A
E J V X Z D P | X P D E Z J;V
X F H W T C P | F H W T X P;C
V Q S E A G I | E S G Q V A;I
O I H D Z R T | I H R T O D;Z
N K I D S Z A | S I Z D N K;A
H T Q W F X G | T G H X Q F;W
D T Z A R N O | A Z N R T D;O
I G Q M O U W | W Q U I M G;O
F M C U Y A Q | C A U Y F M;Q
E I G C A S F | E I C G A F;S
V K T M R J D | K V J R D T;M
G Z V I F L C | I L C V G F;Z
G W X D R C E | R G C X E W;D
G U X T M S D | X D T G U S;M
S E J K T Y W | K W Y J E S;T
D P N B H A F | B N D H F P;A
F W T V A I E | E W I A F T;V
T Q Z O U D M | D Z M T Q O;U
T Y K N L H G | T Y G N K H;L
F X B H P Q I | B F X I P Q;H
P X J T Q N A | J A P X Q T;N
Y L K V W I O | K L V O I Y;W
R B M Q X O C | M Q B R C O;X
J G W B F H V | V G F B W H;J
Z U L I K F V | F L U Z V I;K
U L F X Y K B | L Y X F B U;K
F E U C K M V | K C F U E V;M
K X J G I S Z | K Z J I X G;S
N B O P X E W | W N B O P E;X
X C I N O W J | W I O N X C;J
S D W J H B M | B M S H W D;J
D P Z W C Q T | D W C Q Z T;P
D L I N B P Z | Z L P I D B;N
O E D T L G R | R O T D L G;E
R D K G F V X | V R D X G K;F
F B A T O W X | T F B W O A;X
P O I C H Q D | P C I Q O D;H
V F L R B K A | F K B A R L;V
K B F C T Q A | C K B A Q T;F
I T E Q K X M | I T E Q K M;X
S Q R C W I Y | W R Q C Y S;I
V I D Q Z S F | Q I V Z S D;F
K A H M P Z U | M A H P Z U;K
L T G X V A I | G T X L A V;I
O E U T A W M | A U E O M W;T
T J I D Y N O | J I O Y T D;N
C T B E F H S | T H B E S C;F
N D I M R S A | A I D N R M;S
Y O D L W S N | D L W O Y S;N
U N Z G H R E | H R U N G Z;E
W Z P T X U A | Z U A X W P;T
V Y E P L H W | V H W L P E;Y
L N Z M X T S | M N S L T Z;X
N W K M H I D | W M H D I K;N
S G B F L E Z | E L G S F B;Z
W M I N V S L | M L S V I N;W
J B I R H N E | B E J N R H;I
Y Q U T A D C | A T Q D C Y;U
Z E F J T U R | E U J R T Z;F
N J Z H Y D W | N W Y Z D J;H
O Y N K U I G | Y I K O G U;N
A T N Y U V M | U V N T A Y;M
R D Z C X B J | B R X C Z J;D
H Z M P L Q Y | L Z P H M Y;Q
Y N M J O E X | X Y O M N J;E
O J X K B C F | K B J X O F;C
D M L U I V E | U E L I D M;V
F X Y W S D E | E S W X D Y;F
H P B U C T W | T B P U H W;C
T Z S H O R G | H T Z O G S;R
Q F I M R A X | M F A I R Q;X
F I N G W C P | I N G C F P;W
F N T H Z X S | T S X H Z N;F
K H T G M X A | M X H G A T;K
T V J P B F X | V F X J T B;P
P C Q K S X R | K S Q R X C;P
H S Y Z F C D | Z D F C Y H;S
E F T H W C P | H E F P T W;C
B H R A E N V | V R N H A E;B
P I V Y F L M | I M V P Y F;L
E X P V Y Z M | P V M Y Z E;X
X R M J D Y C | R C J D M X;Y
N S L C Y M I | S C L Y N M;I
R M O W Z V E | V M W E R O;Z
O D M B Z W J | W O J M Z D;B
G X D T L V H | X G L D T H;V
F M V Y U E K | U F Y V K E;M
Q K E G J S X | S X G K E J;Q
S R Q T M D I | T S R Q D M;I
K F N X Q H W | W H F X Q N;K
F E W D P B M | F P B D M W;E
T Z V X R J A | X A R J V T;Z
O L C E D X Q | Q X D O E C;L
H X N B U L T | L H N T X B;U
X N J R C Y V | C Y J N R V;X
N O Q U I A W | N I Q W A O;U
E L X P T M F | X L P E F M;T
J Z R N U K E | R E U N K Z;J
Y I W B L J K | Y B L K J I;W
F L O Z Y A T | T O A F L Z;Y
N V J F Z M P | M F N P V J;Z
P T X R J B V | T X V J R P;B
D E F W P V T | T V E D W F;P
B X W O T K V | O V X K T W;B
G P S B N W R | N G W B R P;S
F G O T V Y W | O Y W V T G;F
S V D U L H A | U V L S A H;D
U P I J X B M | X P M I J U;B
L N I B T C Q | T N I B Q C;L
O C G N L H X | L X O N C G;H
Q D K J U N S | K N J Q S D;U
D K N R V S W | S V W K R D;N
M R D K F L Z | F D L R Z M;K
T P G W K Q I | Q P W G K T;I
G K Q A N F H | K F A H G N;Q
E F I X W B Q | F W B Q I E;X
Z Y I G L O S | L Z I O Y S;G
D X Q B T E G | B E D X Q T;G
Y X N Z H I W | X H Z N W Y;I
E S A Z H Y D | Y A S Z D E;H
S P J K W E L | W P K E S J;L
W V C M S G Z | S M V W G C;Z
Z K H E C U X | C Z E H X K;U
N Z J X C W T | X N J C T Z;W
L U X F I V C | V X C U L I;F
G B D Z J M O | B J O Z G M;D
M O C Q H E R | C O Q R E H;M
I M A K G Z R | M G K R Z A;I
W T I G L S B | T G L W S B;I
C M N V I Y A | C N A Y V I;M
U T X V C N S | N C V T U X;S
M J A E O B K | E M B K O A;J
M A C B R O U | A O C M U R;B
L B N C Y D F | F L B Y N D;C
K V N A S F Z | A Z S F N V;K
M X I Z E L D | D L I X M E;Z
U S R I G O H | G I U O H S;R
W V K R G F C | K F C V W G;R
W R T Z Q N L | Z N T Q L R;W
U V I H F R L | H V F U I L;R
N U T W M J Z | M N U T W Z;J
V Q G O K B N | O V K Q G B;N
C E L X B A G | A E L B C G;X
F Z E X I N W | F Z E I W X;N
E V M P A L H | L E H M V A;P
Q E D N K C A | N K A D E Q;C
A V H P T O I | V O T I H A;P
N S G Z Q K C | K S G Z C N;Q
O N J K S T Y | T O Y N S K;J
A C S B E L U | U L C S A B;E
V F O H Q Y P | Q Y V H P O;F
U W B A M Q E | W U M A Q E;B
W T E X Z M H | E M W Z X H;T
R U N G V I B | R B U N V I;G
R X Y M I J G | G Y X I R M;J
M E O Y A W H | O W E Y M A;H
H S Y F R M L | F R M H L S;Y
B L U E T N H | N B H L U T;E
A X Q H C D T | Q A C D X H;T
G E V Q A L U | U E L G Q V;A
B A D U M G X | G B X A U D;M
C B L I Q G J | B Q C J G I;L
D R E I K S M | M D I R E K;S
L Y P N Q H W | Q L Y W N P;H
A P Y F W C V | P C A Y F V;W
Y I Z U S H N | N Y H I U Z;S
D U R M P E B | R M D E U B;P
I L H T G U D | G L U D I H;T
G R E H M J V | H V E G R J;M
B A H I Q K O | H Q B K A I;O
E D C Q K G T | G E K T D C;Q
D L F J P S W | D P J L S F;W
S V I A R J E | I E R A V S;J
R D E V J P L | D J E R L V;P
Y Q R H U Z G | G Z H U Y Q;R
G C O Z M F L | G L M O Z C;F
B L U Y O P J | O L Y J P B;U
W N H A V M G | N H W G M V;A
K T Z X R P A | P R X A K T;Z
A B J G O K V | O V B A G J;K
C B T U F Z N | Z U F T B N;C
C N D G A Q K | K C A G Q N;D
D T X H J V Z | T X H J D V;Z
Q W G L Y A V | V L Y W A G;Q
R I K Y E C J | K C J Y I E;R
X E O V A S Y | O X A S E V;Y
D P F L T U M | L U F D M T;P
F B L G A R Q | G A Q R F L;B
O M K L P F N | F P N K M O;L
B T H S K N V | N T V H B K;S
B M I F C T K | M I B C K F;T
X E B L R D A | B A R D L E;X
U B X H J W G | J X W H B G;U
J G U S D V H | D H J V S G;U
D W L K O M E | W L K O E M;D
L X E C R N U | L R E X N U;C
R O V X G I T | X G R O T I;V
G P T M U Y L | Y G T L P M;U
K C H P F Y Z | F P Y K C H;Z
L T N R Y H W | T R N L Y W;H
Z M R X P I F | P R M F Z I;X
U P I F E R O | E O F U P I;R
M P L A F B K | F M B P L A;K
L Z S F B K O | S F L K Z B;O
V X R O H Q Y | V O X Q Y H;R
N J O U Q E L | L N U J Q O;E
X U V G M R O | R O V G U M;X
M G R L Y O Z | O L G Y R M;Z
H B G F M K C | B H G C F M;K
M N J T W G L | N L W M G J;T
K W R S M X I | S K R W M X;I
U M L Z G V T | G Z M U L T;V
U L Z O P I A | P L A Z I U;O
H R I Q A N F | F Q H A N I;R
L P H M K Y A | P K A H Y M;L
V C S U N Y P | Y U S V N P;C
A K X B Q V O | Q K O A X B;V
D M Q B O U F | B D F Q U O;M
R S Q X H P Y | R S Q X P Y;H
H M O L Y Z F | L Y M F H O;Z
R I X Q C D K | D R C Q K I;X
N U D K Y L R | Y N R L K U;D
A R C N G P K | C P R A N G;K
M R G Z O Q E | G M O R Q E;Z
W M O G F Q R | F R G W Q M;O
H R O N T W Q | O R T N W H;Q
C I S W U E M | C W U S M E;I
I X M Y T U W | X U Y M I W;T
U G F Q T N K | U F G T K N;Q
G H Q A P C K | P G A Q H K;C
V C O Q X M K | M O C X K V;Q
F R N U V Z E | Z U R E V F;N
Y V M L A I J | I Y J L A M;V
A H S I T E L | A E T I H S;L
G B E R M L D | D M R L G E;B
X Q B A L O T | Q L A X T B;O
P E Q I A D O | A E O D P I;Q
Y W I B F X A | A F B W X Y;I
W A N S T R U | T N W U S A;R
J V W U L I F | U W I L J F;V
O S I E B V Z | E S B Z O V;I
Y P V E K C H | Y C V E P H;K
W S V Q D T X | V X T D S Q;W
X C Y L R Z J | Y J C R X Z;L
M U O T A Y Z | T Y U Z O M;A
T E D U P N V | V N P U E T;D
C F E H I M J | H C I F M J;E
G F O B V C D | O F C B G D;V
I H O W R U Z | W Z U R O I;H
W U G S J E Y | G E S J U W;Y
P U R K W X V | X V W U R P;K
P E V F G D O | D O F E P G;V
M K V R S A W | V K M A S R;W
B Y Z G F L I | I F Z L Y B;G
R B G J L I Z | G B Z J R L;I
I H P L Q R D | D I R Q L H;P
O N T R D C X | C T R N O D;X
D T G Y V J C | V D G C T Y;J
G D S O K M R | S O G R K M;D
B Y T G Q E D | B E Q G Y T;D
Y U O F P X J | X F P O J U;Y
P K G F W E L | P W F E K G;L
X U V O L M P | O X P M U V;L
C H T Z Q X N | X N T Z Q H;C
C N Q Y K L O | Y L N O K C;Q
B Y O F L D P | P F L O D Y;B
A G D V C P M | C M D G A P;V
Q I J N F K V | V I Q J N K;F
S T B C F J H | F S C B T J;H
X V H M K T Z | Z M H T K X;V
N Y F L E B W | F N L E Y W;B
Q E W J T X N | E X Q J N T;W
F A D U J L B | F U J D L A;B
N Y B F T O V | Y N B O F T;V
M I Y Q G P J | J I G P M Y;Q
E S W Z K Q M | S Q W M E Z;K
Z F H S R G K | Z H F K G R;S
S V H B Z X T | Z V S X B T;H
L H Y F B Q D | H Y F Q L B;D
H Z S A J B G | G H Z B S J;A
H M V X O K L | V M H X O K;L
L F M U B K P | L B M K P F;U
D V U H G C Q | H V D G C Q;U
U L M Z J N F | J U N Z F M;L
L T Q U X K W | W Q X K L T;U
X R Q T V Z W | Q V T Z X W;R
J K D C F Q A | K D C F Q J;A
B L V W C Q O | Q O W C V L;B
C K H I V G O | I C G O K H;V
I A Z J E O K | I Z K A E O;J
N A F M H X I | F N M A I X;H
O K N S W Z G | K G O N Z S;W
J C L O S W R | O L W S R C;J
S K L D H Z R | L R Z K H S;D
L W F V C M B | V F B L M C;W
V B I O L K Y | K O L V Y I;B
S R Y N E J C | S J E R C N;Y
M T I P S E W | P M I T S E;W
J M H U I Z O | I J Z O H U;M
O W I C T Y U | O C U I W Y;T
M A O L Q E C | L A C O M Q;E
G Y B A Q M E | Q G B Y E A;M
Z S H A M P R | M H Z R A S;P
W A O E P T C | E T C W A O;P
F E T N V Y Q | N Y T F V E;Q
G Y L Q M Z A | Q Y Z M G A;L
W Z G J Q R I | J Z W Q R I;G
T I W K F V X | I X F W V K;T
N Y Z M H J C | J Z N H M C;Y
G D Y T M B R | M R Y B G T;D
U Z K F V C X | V C K X Z U;F
M G H D J K B | G B K D H J;M
A I D T N L W | L N A W T D;I
W Q G J R N I | R G Q N J W;I
W V Z M K N S | Z S N W K V;M
X C A I H R E | H I C R E X;A
R X V M D G O | D R V X G M;O
Z J K M N X D | N Z D M X K;J
F C V Z H A O | H Z F A V O;C
J H I C W T S | H S C J W T;I
V R W H Z U N | N Z U V H W;R
C J V Z Q S T | V Q C J Z S;T
Q V A J R F K | K V R Q A F;J
A Q O P I R T | A I P Q O T;R
M H A Q Y J P | Q H A M J P;Y
V Y S I R Q U | U I S Q Y R;V
L H C N I D W | H C I W D L;N
B H I L Z R S | I H B R Z S;L
S X Y M F E N | X S E F N Y;M
H R X W C U K | W H C X U R;K
L W C O H N S | O C S L W H;N
G D H P K Y B | G B D Y K H;P
Y S J Z L O G | L S Z J O Y;G
A S Q G C T Z | G Z Q T S A;C
X C U T Y V S | X V Y U S C;T
C A V Z J E N | J Z E V A C;N
E V K F A J L | L F A J V K;E
Z P M V S X G | Z V M S G X;P
F R T P U Z L | U Z L R P T;F
Z T Q W K E D | K D Z W Q T;E
T P V L D Q J | J T L P Q V;D
L Y M S W D E | D E Y L W M;S
S K V O T U L | L V O U K S;T
D C S A L W Y | S C L W Y A;D
X G M Q L R C | M G R Q X C;L
Z J W D U V Q | J V U D Z Q;W
Y Z D W Q H B | Y Z H Q W B;D
P E H D Z J I | H D P J E I;Z
S W C D G A B | B G D S W A;C
A H V K R C B | R C K A V H;B
P T D R A Q Z | Z R A Q T D;P
Y C U B S E N | E U S C N Y;B
F P C H Y I X | C I P Y H X;F
I O R F P Q A | P Q A R I O;F
H P N U J X Q | J U P Q N X;H
B X K C Y E L | Y L K E C X;B
P U V J H I B | U I H P V J;B
E H T L U R G | L T G U H R;E
G P S A K L T | K P A G T S;L
H J U W B V M | W B V M U J;H
Y M C S X A P | M X Y A S C;P
M E H U T W J | W M T E U J;H
V A Y T R J D | A R Y J V D;T
H S K Q F B A | B S A H Q F;K
H J U D Q M C | D H Q M C U;J
R D Q U P K F | D P K F Q U;R
M U F W B O P | M F U P W O;B
K Q N S D F B | K D S N B Q;F
V W H D C J S | D W V J H S;C
K Y E U P V J | V E Y K J U;P
B J U C Z H N | H C Z U J N;B
F U J H O I R | R U J O F H;I
S J F X R V G | S J G V R X;F
E H Y R F O P | Y E O P H F;R
L D G E Q K P | G P E D Q L;K
M N I K V H B | K B N H I M;V
M Z X I T Y S | T Z Y I S M;X
S K T J O W F | K W O F T S;J
M H L X Z Y G | H G Z X Y M;L
X B N E K Y L | X E N Y B K;L
R W Y F M P G | P M R F Y G;W
U I Y Z W C A | U I C A W Y;Z
Q L P A I U T | Q L P I U T;A
J Q O S W A X | W J O S A Q;X
G W Y N Q T B | Q W T N Y B;G
W C U M S Y I | Y W C S M I;U
J S O E U G F | O G J E F U;S
N T B G O J E | N E G B T J;O
O Z U C B K L | O L K U C Z;B
Q I V O S A B | S A I O Q B;V
C H P M K F N | M H F N K C;P
Y T I A G H E | G E Y H A I;T
N G K H Y Q U | U Q G H N K;Y
U C L J S E R | U L E J S R;C
A D T Y I U W | A W T D I U;Y
S A R P J Z E | A S P E J Z;R
R L E P V G Z | P V Z G L E;R
U J W T X R V | J V U X T R;W
E B O C Q J D | C J Q O E B;D
A Q U G C O H | C Q O A U G;H
M N Z C W I P | N C P W I Z;M
F C M O H E A | M A H C F O;E
E X R Z J O N | J O R Z E X;N
S H G A E X B | A X H G B S;E
K N M T L C W | M W T N K L;C
Z L U H F Q C | H Z F Q U L;C
R S K U E V F | K S V U R E;F
Q T O F N Z J | F O T N Q Z;J
Q W B A J R L | R L J A B Q;W
F U J L X G W | U J L W G X;F
L D H N T E M | N M D H L T;E
O W J E K I D | W J K D E I;O
M G B Q V Y L | G L Y V M B;Q
N I A S G Z B | I G S A Z N;B
P O R H Z J N | J R N Z O P;H
C R O L J S B | O S R L J B;C
T S Z Y H R I | Z S Y I R T;H
I G X L S F W | S W G I F L;X
W C T U R A H | A C W U T R;H
G L A B X Y J | L J A Y B X;G
J T K O B R U | R K O U T B;J
H T N Q B Y Z | H N Y Z B Q;T
P R N M Y T C | T C N R Y M;P
Z N R U D G X | X R N G U D;Z
H V I E M C K | K M V E I H;C
W Z C R I L E | R Z L W E I;C
F S C O I K V | O K F C V I;S
N T M U I A X | U N A M X I;T
R S K F I O U | R F I K S U;O
F A Q G I T N | F A G I Q T;N
Z H C R F E V | V R Z H E C;F
A D U X O E N | N D O E U A;X
K O N H I C U | N C K H O U;I
D N M H C O P | P M D H O N;C
M A G N L Y C | C A G Y M L;N
M P B O Q A D | M A Q D P O;B
I Q J C S Y R | R C I Q Y J;S
J U I G A S V | V S G A J I;U
M G L I Y H E | L E Y M H I;G
A T C H U O G | A T H O G C;U
Y B I S X M J | S M X I J Y;B
C U S G H O B | U B S C G H;O
D L C B Q U W | U D W B L C;Q
B H I P J A T | I H P B T A;J
S V X Q I E L | L E X V I Q;S
X O T Q J K C | K X Q O T C;J
Q L V C Y E B | V B Q E L Y;C
M J R C X Z F | X M R Z C J;F
B Q K D C H P | D B C H K P;Q
J M C G Z T E | E C T M J Z;G
V J U G X Z H | G V H Z J U;X
D L E C P I S | E L I D P C;S
O G M Q B L R | G L O R M B;Q
O T I D U N Q | N D T U I Q;O
Y I N L G C F | G F L I C N;Y
N A G L I X V | N I V G A X;L
X O K W I J V | O V W I K J;X
T Q E X S Z A | Z X T E A Q;S
X N H U R A B | N A R U X B;H
D G E I B Q C | B I E D G C;Q
J M F C W K B | K W C B M F;J
U E V A P M X | E A P V U X;M
O B R M G C X | C G B O M R;X
S T K M E H G | K H T M S E;G
J B M H F V K | H M V B K F;J
J S M T G Q F | T S G M Q J;F
S E J K C I X | I C S X K E;J
S L B Q K V P | Q P L S K B;V
F E L J P H V | V E F P L H;J
Y D N W L C M | C N L M D Y;W
Z H G K N J F | J G H N Z F;K
Z I S X T P Y | S Z Y T I P;X
M Y X E F L P | M P E F L X;Y
R Y F B G L Z | R Y G B F Z;L
W H C K I L S | H W I C L K;S
F A K H L W B | L W A F K H;B
A Z K I J M W | M J Z K I A;W
U P V W N G S | S V U W G P;N
V J U C R A Z | R J U V A C;Z
Q G T Z O V A | Q T A G O Z;V
P T Q B S O E | O B P S Q E;T
I P F K H N Y | H I N K Y F;P
G V B K R H X | K X B R H V;G
W L G J O C Z | J G W L Z C;O
I Y T N E M G | Y G T E M I;N
X G W A E Y H | G W Y E X H;A
T Z I C N E Y | N Z E Y T C;I
W V K A R T G | T W V K A G;R
O S C H Q J D | J O S H C D;Q
W T G M P O U | T M O W U G;P
C R O H W P M | R O H M P C;W
I P R Q V Z Y | Z R P V Y I;Q
N M P W Q G F | F N P M G W;Q
X I O C G R S | G I O X C S;R
O H Q S Y F N | Q H N Y O S;F
S V O N G Y X | Y X V S N G;O
R S T K F B W | K F T S B R;W
X P L G W U Q | L U G X Q P;W
H M S E F G O | S E F H G M;O
G A C S E V P | P G E V A S;C
N W H X R E A | E A N W R H;X
T B M Z U P D | B P Z T U D;M
P J B Z V I M | V J M I Z P;B
O N I G H T L | T L I H N G;O
G O Z S T C J | G S O T J C;Z
W M E N L X G | M G L X N E;W
N K X Z T R B | T Z X R B N;K
M I N U D Y F | F D Y I U N;M
F T Y R G V H | Y R V G F H;T
U F M Y K O D | F O D Y M U;K
I Z J W M R K | K J R Z I W;M
V O N K S M W | M V O N W K;S
C N X Z K R E | X C R K N E;Z
M A E C K H Z | K A H C Z M;E
K G Q P W F O | K G O Q P F;W
G N W Y B C F | N B W F C G;Y
K U C A V S E | C K E A S V;U
J V E C N A Z | N C E A V Z;J
Y I M W N T B | I Y B W M N;T
D W S U Y G V | U D S W Y G;V
M S V D G C X | G D V X M C;S
U T Y R L F Z | F T U R Z Y;L
Z R J Q L C N | C Q N R L J;Z
F G M C Z V J | F G M C V J;Z
K T F N S D B | S D K T N F;B
F U V I L Z N | F U L Z I V;N
A C V F E G Y | G V Y E C A;F
V J R Y O W E | E R O W V J;Y
C Q J E R T L | R L J T C E;Q
V M O Y U D K | V K M D Y U;O
R T F Z Q N D | N D Z F Q T;R
Y V S X T H N | H X V N T Y;S
L C O Q M W A | Q C A W M O;L
A B W Y N X L | L Y W N A B;X
N D S F X R Z | S Z N X F D;R
P Y I A H L Q | I A H Q Y L;P
B P W Q K N Y | P B Q W N K;Y
H W X U O R P | P U O H X W;R
N V I X C G W | N X W I G C;V
F D X T M R Q | T M Q X R F;D
O P S H J G L | J G L O S P;H
R N U D S A I | A D N R U I;S
E U J G N A S | A G U N J E;S
K F A J W E G | A K E G J W;F
G F B Y Q W M | M W B Q Y F;G
Z O F V M H I | Z I F V O M;H
D M T P C Z A | P A C Z M D;T
M S R K G P Y | R K M S G Y;P
C D B S P Y R | Y C S R B P;D
R F G A J K H | J R K H F G;A
M R B V N P I | P N R V B I;M
J S Z X V K F | F J S K Z V;X
B M L J A V Y | B V J M A L;Y
M U C J X R Z | Z R U J X C;M
W S P U V L B | V B P U L S;W
H Z U P Q V D | P D Z Q U V;H
I E X J Q K D | D J K I E X;Q
F A W E M R L | M F W L R E;A
P U T Q H M J | Q P H M T J;U
M I W B D X P | W B P I D X;M
L O P M I T V | P I V L M O;T
K C V U X E O | E U O X V K;C
B K X F V W D | X D W V F B;K
Z I C L W X Y | C X W Y L Z;I
G M L P I N T | L N G M I P;T
U L K G S Y R | Y R L U K G;S
X E O S N W P | E O X S N W;P
S U I L M R H | H R I U M S;L
R G K Y D E F | Y G F D K R;E
A V J W O D L | V A L W J D;O
S K T D P N E | S N E K P D;T
S H V D R U B | B U S V D H;R
E X C T R U L | R C L E U X;T
C S I U E X Q | S U C E Q I;X
H A W E Z L F | Z A F W E H;L
N D F O W T Z | F N O W T D;Z
U H C M T V P | H U C P T V;M
S V X K R F C | R S C X F V;K
P B G Q I Y N | N B Y G P Q;I
S K G P H C L | H K C S P L;G
T F R X G S Z | S X Z T G F;R
S C A D K O E | O E K C A D;S
Y G I Z Q L X | X Y Q G L Z;I
W Q C A I X O | W O A Q I X;C
O Z Y S X R P | X Z O Y S P;R
L F H I R O A | F H A O R I;L
R G Z I A F M | M Z G A R I;F
M T Z S I P C | P I T M S Z;C
S W A J Y N T | N Y J A T W;S
U H Z T P S L | U Z S L T H;P
C N S E Z P V | V C P E S Z;N
Y Z T Q X B L | Y L Q Z T X;B
S B D A E P Q | A E S B D Q;P
K C L N J S I | L C J I K N;S
M Q V L T X I | X Q T L I M;V
T H F W I X U | W T X U I F;H
C A O Q P U N | O C A Q U P;N
Q P I Z G N V | P G I N Z Q;V
Y R C F K L U | R K F Y L C;U
O U I Z M G Q | O U G M I Q;Z
D M O S I J H | D S M H O I;J
K I P N C Z W | P N C I Z W;K
N J F K R I P | P N R J K I;F
A W R Z L T K | K A L Z R W;T
R Z O B P Y F | Y Z R B O F;P
S E L F U N D | U D N F E L;S
K Z X E M T V | T M X Z V E;K
M T X G F Q H | M G F H T Q;X
O J K C Y N I | J K O Y I N;C
D X S J T Z Q | X J S Z D Q;T
G M U P T N O | P G T O N U;M
Q A E Y B Z T | A T Y Q E Z;B
N F M K G A T | T M A G N K;F
F H A U V L O | V A U L F H;O
Z Q L W N U P | N P L Z U Q;W
K O X I F N D | N O K F X D;I
A N P C H K Q | Q K A P N H;C
N X L S C F D | D S N F X L;C
B K Y I M E R | B I E K Y M;R
T F R L N Z S | L S Z N R T;F
Z I B L T F S | Z L I S F B;T
P T M I R K O | K T R O M I;P
Y Q X B N R G | R X Q G N B;Y
A K D G L U R | L A D U K R;G
V T H O J U Q | T U V O Q J;H
F L N D A R J | A L R D J N;F
S H A Y J E B | B H S E J Y;A
B Z V G O K N | N K O V Z G;B
Y M L S J N X | N M J S L Y;X
K B T Q L I P | L P B I Q T;K
W E T F J G V | T G V E J F;W
E F B X J Q H | X B Q E F H;J
J O S Q I U D | Q D J S O I;U
Z Q J S T A K | K Q T S J A;Z
B N L X M Q Z | L Q X M Z N;B
B G Z H V Q F | G Q Z H F B;V
S C I F T Q X | Q F S C T I;X
Q J Z K W L P | K Z Q P L J;W
J Q B U Y D R | R B Y Q U J;D
D L R B S E M | E R L M D B;S
Z M W O B N G | G N W Z B O;M
M S V Y N X E | N S V M X E;Y
N R O C Y K S | S Y R C O K;N
Q V L E K G B | Q V L K G B;E
P R M O G X H | X P R M H G;O
S Q D R Y B G | R Y S D Q B;G
F I W S K Q X | I K Q W F S;X
G D N I Y F M | D I M F G Y;N
P Q D Z U E L | L D E U Q P;Z
J O X M P N D | O M X P J D;N
D X B Y U I E | D E I Y X U;B
J P X U B N A | P U N J X B;A
B N L M S F A | S B F L M N;A
Y J E N I B H | I B H N Y E;J
Y F A U R C W | R C U Y F W;A
O S T B N C W | B C N W O S;T
Q P A V H D T | V D A H P Q;T
M C J A X B Z | X M B C J Z;A
A R T L E X Y | A E T R X Y;L
G Y L N M T O | T Y M L O N;G
S T I W G X M | X S I M T G;W
J G F T B R S | G R T J S F;B
O I F P B Z U | O F Z U B I;P
I W R A L T Y | Y T I R A W;L
N W R P E T Y | T N Y P W E;R
K R S X A U Q | U S X K A Q;R
S Y A R K Z U | A K S R Y U;Z
N F H J G P Y | J Y N H G P;F
W Z B V X S Y | Y Z W X S B;V
A U F P Q N B | B N P Q U F;A
K A S E Q C I | E C A K Q S;I
P O A J Z T S | Z A T O S P;J
D H G Q V J F | D G J H F V;Q
Z X F N H P U | F U X N Z H;P
U K M T S Q H | Q K S M T H;U
X T P Z F R W | F T W P Z X;R
C A N B K S W | A C W B S K;N
U T B J F M O | T U B O J F;M
Z O Y J I G S | I S J Z G Y;O
T G H P I D L | I T D G L H;P
N F L C U K W | C N F K U L;W
I H N R G F M | M I H R F N;G
B P Y H I C O | Y P H B I O;C
G I C O P J Q | O J Q I C G;P
G K L H N U C | U G C L H K;N
G E W I C R Y | E C R I Y G;W
G E D S R O P | E R O G P D;S
R S F K I J N | R I S J N F;K
J D T K B Y O | Y J K B T O;D
Q C G X R U E | E G U Q R X;C
Z L O S W F K | F Z L K O W;S
A W B I H R J | A H I R J B;W
K L E C A O P | P E K C A L;O
J O Q I G C B | C O J Q B I;G
H A J V Z F I | I J F V A H;Z
D L S V M Y Z | V D S Y L Z;M
A I H U G S Z | H I U S Z G;A
H A J D T E V | E J T D V H;A
A S U H O X B | O A S X B U;H
K Q I O J V A | I J V K A Q;O
S Z D A G V B | B A G D Z V;S
C B P Q J O N | N P C O Q J;B
M Y W L D E F | F W E D M L;Y
N X M F O A G | F X O N A G;M
Z G H D M E B | E Z G H D M;B
Q H F P V I D | D P I F Q H;V
F G M X N S H | M G X S F H;N
C O R S G J N | C S R N G J;O
L Y A J E G C | E L Y A G J;C
O Y M E H D Q | Y D E Q H M;O
E X T J S V D | S V X D J T;E
V P M I C B O | B V M C P I;O
G A N R O C D | O N D G A C;R
N C K Q S J M | Q J M S N K;C
O R U M C K B | O B M C U K;R
R A W K F Q I | R A W I F Q;K
M L I X K W Y | M X W Y L I;K
A C S X U O W | U W A C O X;S
P M O U F X L | L F X M P U;O
O U M L P V Z | V O P Z L U;M
R G Y C B T M | T B G M C Y;R
I T U B E M D | I B E D T M;U
X R G Y Z T H | X G H R Z T;Y
O H V U L A G | A L U V G O;H
Q D E S O A L | L S E A Q O;D
D M O B L C Z | Z B C D O L;M
I N U Y L O T | U T I L O N;Y
A Z X M V O B | Z X M V A O;B
G S N X Q W Y | N W Y Q S G;X
Z E C V D U N | N Z V D C U;E
Z X U O Q D N | N Q Z D O U;X
Y G S X D W C | G W S D Y C;X
U D J A B R W | W A R D J B;U
M N W P F H Y | W M F N Y P;H
O L W R H K V | H O W R L V;K
K H R P B X Y | B K Y P H X;R
A O I N W K S | W I S O A N;K
L Z I T J Y K | J T L I Y K;Z
O F S Y E V M | F Y V S E M;O
N T V Z P B S | P V B T S N;Z
Q N T O R U W | O T N W Q R;U
J W P V Y H D | V W Y J P H;D
K O D W A N R | O R K A N D;W
K H W B D N I | N K W H I D;B
C D M H N I X | X C H N D I;M
T M D N J R I | N M D J T R;I
F U R Z D L M | R D L M U Z;F
N X I U M V Z | Z X N U M V;I
N M U F I X Q | X M N U F I;Q
Q B O C V J L | L J C O Q B;V
O Y R N L P H | L R P O N Y;H
T N J H U A Z | N Z H A T J;U
W G P A U T R | P W R G T U;A
K U P C M Z X | C P M Z X K;U
Q E T N G M U | Q N T G U E;M
Z R Y M L F S | F L Z Y S M;R
A D X U J I L | L X A D U I;J
J L N Y M V K | M K Y V J N;L
O J K A N C H | O K A C H J;N
W R U Y I J L | W I J L R U;Y
V I O K P M N | P O N I K V;M
X M K Q I T H | M K X Q H T;I
H Z T F G V B | B T H G V F;Z
R Q H V W I K | K H I R V W;Q
U B J S H G T | H S G J U B;T
K U P N S X Z | Z S X U N P;K
A R P I O L C | R L C I A P;O
Y N C J I S T | C N I S Y T;J
P D K Q W Z O | D Z K P Q W;O
I E W C N L D | L N D E W I;C
A O W R Z X S | S O A Z W R;X
T Z L N D R I | Z L T I D N;R
Z H R W D X B | Z B R H W D;X
O Q Z V N X K | X Q Z K O V;N
Z Q A C G J S | G J S C Q Z;A
I N Z O M W E | N O M I Z W;E
N P E Y B K Z | P E N B K Z;Y
W E V R F Q Y | V Y W F R Q;E
C V D S M R L | C V D R L M;S
L H C Q N M W | C N L Q W H;M
I G T U K V Z | G I Z V U K;T
V T J O R N U | V O J U N R;T
M L O W H Z Y | Z H W L Y O;M
X L Z H P U R | U P R Z H L;X
C E U B Y H R | C H U B R E;Y
Q K H Z W J B | K B H Q W J;Z
B U J K N W O | N O K W U J;B
T W C S Q M E | C W T S M E;Q
W Q E C X L F | E Q L F X C;W
I P R J Z W Q | Q I J W R P;Z
Q J S U M A D | U M A S D Q;J
Y T N Z X K O | X T K Y O N;Z
B F O G I W N | I B F N O G;W
J Y T E K C S | C K T Y J E;S
W Z R M U L Y | R W Z U Y M;L
I D C W K A F | I F K A C D;W
I M K G S V T | T M V K G S;I
E S L J R F Q | L F J E Q R;S
R Z T M B W H | T B W H M R;Z
N R Z J L I S | N I Z S J L;R
D O F E K U C | O C F E D K;U
W K Z S F B G | S F B Z W G;K
W O L T J C A | L O A T C J;W
H G L S W P M | M G H L W S;P
H M D A W E P | P E A M W D;H
W R Q U J X D | R U X W D Q;J
Z B J E M D I | D J B E I Z;M
X Y W T N U C | W N Y C X U;T
P T J U L A B | T L P A J U;B
Z H A Y B J R | J A R H Z B;Y
Y X R T P M O | O M X R P T;Y
S K O Q N P Y | S Q O N P Y;K
A X M E G I H | G A M H X I;E
S D I N P M Q | D S I M Q N;P
G A Z H K L J | H A J L Z G;K
Y J F Q C I H | F H I Q J C;Y
J I L K R H X | H I J L X K;R
A U C X S Q I | I U X S C Q;A
F L O G U Y J | L G U F J Y;O
L Q W X M A N | L W N Q X A;M
Q F D A W Z G | F Z W G D A;Q
Z X N T I L S | L T I Z X N;S
Q E G L R H I | L G R H I Q;E
W B Y A V X P | B A W P X V;Y
J U I O L M S | I U L J O M;S
V A K F N D B | D K V A B F;N
U P I C Z R W | Z P W C R I;U
C H I Q U T N | H C U T I N;Q
K S U V B D F | F S D V K B;U
P V H R A X M | R A M V X P;H
C P D V L G X | D V G C P X;L
T M N U L J P | M P U T N J;L
U T X Q R W H | R H W U Q X;T
S V R G U L B | S V G U B L;R
R T D C Z X B | X D B T Z C;R
P U V R J S D | R S J P U V;D
Z E B G Q N M | Q N G B Z E;M
U Q N R H E G | R E G U N Q;H
F I B J G C Y | Y F J C G I;B
V X O M B W R | X B O R W V;M
B V W K U J P | P B K V W J;U
L K M S B D Y | D L Y S M K;B
J I X H D R M | I R M D X J;H
C U Y J I L N | L N C J U Y;I
O K C R B S Q | R B S K C O;Q
Y S H C I L U | I H U Y L C;S
C U Z M I Y A | M Z A Y C U;I
M N O W L D Z | M N L W Z D;O
A Q T C Z F X | Z X A T C Q;F
T Z Q L F M G | M Z F Q T L;G
W D Z Q N T S | Z W S D Q T;N
M A U S P G N | S A M G N P;U
V Q O W L I B | Q O L I B V;W
Y I P A B U Z | B P U Y I Z;A
J H Z Q G K Y | H Z K J G Q;Y
P J D Z N K F | K Z D N F J;P
R F A L X Z U | R A U F L Z;X
N A G L M O Z | A Z G L N M;O
O Y R M B W P | M Y O P W B;R
K P S X T A N | S N A K P T;X
T X O V C W J | V C W O T J;X
Y J X D P Q U | Q Y X U P D;J
O C T M N D F | T N F M D C;O
X B Q C V Z E | C B V E Q X;Z
T Z H F R D G | G F R D T Z;H
L V C J B Z X | B V C J L X;Z
N U D P X L Y | Y P X L N U;D
C F X P Y I M | Y M P I X C;F
R D C V P U A | P R V A C D;U
C Q F G A B D | A B G F Q C;D
X U B C G S K | G U B S C X;K
P H A E V U F | U F V E A H;P
H E W N T F P | T W P H N F;E
T M B F Y H D | Y B D H T F;M
C R Y F G U L | U F R G L Y;C
L C R P I D Q | C P D I L Q;R
O P H G L T Z | P L Z O T G;H
N G S I Q L E | N L E G Q I;S
J R U H B T V | V U J B T H;R
F S C T L Q U | F T S C Q U;L
K R T O L U C | L K U R T C;O
U F W C S Z G | G W F Z C S;U
F N C D M O L | O C M N F D;L
J B W P U V R | U P B V R W;J
W F Z S T D N | W S T D Z F;N
Y D S U R H L | L S D R Y H;U
B A H X P U J | A B P X U H;J
S C V P R E A | A P V R S C;E
R P K M N V U | U V N P M R;K
I D Q H M Y B | B D M I Q H;Y
W D U Y N X T | N W Y D U X;T
O U H W Q R T | T U H R O W;Q
X P U C G L V | U G X C L V;P
Z U X D T W C | Z X U D C W;T
I W A Y H E U | U E H I Y A;W
T D W A H L X | T X L W D A;H
P L T B N W V | W B P V L T;N
O B W Q V X H | V O X B W H;Q
T P I G L V K | G P I T K V;L
K L J P Z V Y | Y Z L P J V;K
F V C I E S U | I E V F U C;S
W Q M E B X L | X B Q W L M;E
C J T Z I E O | C E I Z T J;O
Y M C N L I J | N C Y M J I;L
Z E B O D S M | B D Z E S O;M
Y U S Q T W G | G S U Q T Y;W
V N S D Z X E | X Z N D E V;S
P B W D C M G | M C W G P B;D
L C X O R V Z | C X V R O L;Z
C U P O I S T | P C S I T O;U
E G M X C L I | L I M X E C;G
K O I Z E H C | O H Z C K I;E
G W R F Y A I | Y I F W G A;R
S B K T N F L | T S L N B F;K
S D N B G K T | B K T G D S;N
I H O T M Z D | T I Z H M O;D
X M L B C A W | A L C W B X;M
L K F Y O M Z | M F L O Y Z;K
Z B V P M G D | V M G Z P B;D
H F J Q X S K | K X J Q S F;H
D I A O J N M | A D J M I O;N
I L T K Q E J | L K Q J T E;I
H A C V X N I | H X A C I N;V
S W A C L F U | A L S C U W;F
S I O N M Q G | Q I N M G S;O
T W V L R G Q | R T Q V L G;W
T Y Z W E L U | Z L T E Y U;W
C F B K X J I | I K C B J X;F
Y S U Q B R G | U G R Q Y B;S
Y L A T C V S | Y L V T C A;S
W T K R D B M | B M K R W D;T
Z J E K V N U | V K N E U J;Z
P D E R B Y Q | Y E P Q D B;R
U J S X K V Z | V S X J K U;Z
F S U J A L O | S L U F A O;J
N W L G X B R | X L G R N B;W
G W P L A C H | W H P C G L;A
P X I N Z J Q | Q N P I X Z;J
Z T D I C P G | G Z P T D I;C
V S Z G O L I | G V S O L I;Z
B D G K Z H N | D B K G Z H;N
L M V X D S B | M X L V D S;B
O B D X Y R M | X B M R O D;Y
O P C I W T R | O C P I W R;T
Q U D B R T L | Q L D R U T;B
T R L I M S W | S R W I L T;M
Q N O G W Z F | Q W G N F Z;O
A T L E U H N | L E U A T H;N
D H O A U B F | A O D H U F;B
B E C H Y J D | J E B H Y D;C
O E Q T X I F | I F E O T X;Q
V A S G X Z F | V F Z G S A;X
Y A G J H S L | G A Y J L H;S
L A U I F S E | A E U F S L;I
I J U E N F W | I W J N F E;U
X Q W D K A Y | A X K Q D Y;W
R V J Z L U I | J I L R U Z;V
G Q N X I B E | E G X N Q B;I
C G I M R N S | N C I R S G;M
R G A M Q O V | R A V Q O M;G
V E J P U K Y | U Y K J P V;E
D Q E U O Y C | O Q U D Y E;C
Z K I G J M C | M K Z C G I;J
U M X Q P Y H | P U Y H X Q;M
R M V B X T N | N R M X B V;T
M V T A W K U | M A V T U K;W
S U W N B E D | N U D W B S;E
Y O M A E S G | Y M O A E S;G
L Q S M Y B O | L B O S Q M;Y
C J G P M N H | J N C M H G;P
L E A X R N B | E N B R A L;X
X V Y L Q T C | V Y C Q T X;L
Q B W M C L E | Q C M W E L;B
N W R K J C M | C N R K M J;W
X I D S K P W | D S K I X P;W
N V L P E Q G | G V N E L P;Q
Z T W X K H F | F W H X T K;Z
R K V J G N U | N J K R U G;V
N S W U D Z A | W S Z N D U;A
Z L E W F Q Y | L Q F W E Z;Y
T R F Y K Z W | T F Z Y W K;R
C M Y E H R F | H F M Y R C;E
X M L H V N D | H L M D X V;N
V P H W G O I | G H V W P O;I
O V Z B M N X | X Z B M V O;N
T E L G K A H | K G A H L T;E
B L H D N W U | L H W D N B;U
X P K G I W F | W K P I X F;G
J Z N W S U P | Z N U W S J;P
E P Q I L X G | I P E X G L;Q
Z J Y F K D E | Z E D J Y F;K
E O J Z N Q G | Q O N J G Z;E
H D C Y E K Z | D H K C E Z;Y
J I W C T U O | I W U T C O;J
S U B G K D T | S G U T B K;D
R P D J C K E | C K D R P E;J
H R A O U F N | R F N H O A;U
F M Z O K N S | S M N Z O F;K
K Y I W N Q M | W N Q M Y K;I
R P E H M O F | F H E P M R;O
F R X N Y U E | X R U N F Y;E
B D Y Q S N W | W S Q B N D;Y
E H U C L R Z | H U C R E L;Z
Z A B D H R V | D Z V R A H;B
N Z V L A B S | B S A V Z L;N
K A O G N D W | N D K W O G;A
T E M S X O Z | X E M T O S;Z
I X S E G L B | X L B I E S;G
L H Y U Q S P | U Y S P L H;Q
E G U X N V Q | X G V Q U N;E
V F W A G Y O | F A V Y G O;W
C V J G L D A | L A J D V C;G
T E U Y V D N | Y U V E D T;N
L V F B S W P | F W P B V L;S
M N R Z I S G | I G R S M Z;N
L O F E X P W | W E O X L P;F
P F I D K C Q | D C Q F I K;P
F B L R A Y W | L B F R Y W;A
C N U S Z K A | A Z K N S U;C
V T X F Q L D | F V T D X Q;L
L W B E P V F | P L W B F V;E
D R F G T Y S | Y D R G F T;S
M E S N R Z K | S E N M R K;Z
P D Z Y W F B | B W Y D Z P;F
K R X P M Z S | P K S M Z X;R
M I D J F W P | M F P D J W;I
G D A J Y W T | T W Y A G J;D
M C W A O Z S | S A Z W O M;C
R J C Q T H B | B Q C T J H;R
K D S V W I P | K P V S I D;W
V W T J S Z O | J T O Z S W;V
S N W I T P U | T N S I P W;U
R M Z C U J G | G R C J Z U;M
G Z P A B J K | P B G A J Z;K
K N A Z O U Q | N Z A U Q K;O
N R H M J I X | I J N H M X;R
Z O R W P M K | R O W P M Z;K
C J V L U E B | V J U E B L;C
W T V C Q M I | C W I Q M V;T
I M N V T O E | I O V M N T;E
L D B X I Y J | B Y I D J L;X
W P L F M R J | P W R J M L;F
G R O J P H A | P J H O A G;R
G L R M Y H W | Y M G W H R;L
C L X T Y O A | Y L X A C O;T
S F B L N H G | G S B L N H;F
N I T R X F M | X R F I M N;T
R E T P J S Q | S Q J T E R;P
K G D M V W T | V D W T K G;M
B U C M Z L K | Z L C B M K;U
N B I F X H T | I B N T X F;H
J D Y W V M H | W H D M V Y;J
A W J K P E D | P K E D A W;J
Z S I D Q A G | I A D G Q Z;S
B E Q H U D K | H U B K Q D;E
W D A N Y S X | A S N W Y X;D
D E F Q C V K | C K F Q V D;E
E C G H Q B F | E B G F C Q;H
J O F D Y I T | I T J O F D;Y
E K I V M N A | I M V A K E;N
D T B F E V J | E V F D T J;B
G F K H R Q V | F K R Q G V;H
N G E C K D A | A N G C E K;D
I S B J O R A | O B J I S A;R
Q I S B V P M | S V P Q B M;I
F M L Z S H N | L Z F N M S;H
M K J N F G Q | N Q M K G F;J
K C U N A E O | E U N C K A;O
K U L X W V A | A U L W V K;X
P E S C K L G | K G P C S L;E
V Q K O X M P | K M Q P V X;O
U R Z D Q G V | Z G Q V U D;R
U N X D J P G | U X G P J N;D
R O Z J D Y L | L J R O Z Y;D
P U X Y S Q N | Y S P Q N X;U
Z S R D Q L J | L Q R J Z S;D
L V G O N M F | V G F M N O;L
W Z H T K M D | K T Z H D W;M
N B U G A Y I | B U G N A Y;I
A D E N S T H | D T A E H S;N
N H U F B G X | H N B U G F;X
P A V K L N T | A L T V K N;P
B K G V Q I J | V J Q B I K;G
Y J I F S A L | I J A S F Y;L
D I R A Y W F | I Y R W F D;A
Q D N M U P T | D P M U Q N;T
R T V C L A W | R L W V T A;C
R Q H S T J V | Q V T S H R;J
E L M S I W Z | M I E W L S;Z
E D K P M F Z | Z D K M F P;E
G T R C K A X | G K R C A X;T
R G C V L T F | F T G V R C;L
F Q J L W X A | J X W L A F;Q
X Y R S B G K | Y S R G B K;X
G M D U J W V | W V D G U J;M
L J U C X W F | C X J L F U;W
A L X Z T F W | T L F Z X A;W
I A H C P E X | E I C A H P;X
L B I C O W M | O L M B I W;C
P X Y A K D N | X D A N K P;Y
U T Z J K F M | Z T M F K J;U
J B D Z K S M | J D K Z S B;M
Q N V L K Z G | Q K L Z V G;N
C R P K T D U | C T R U P K;D
D S H A E L U | U D S H L A;E
I H C T X Z G | I C H G T Z;X
H B E X W Z S | X S E W B Z;H
M J R O Q D E | D R O M E Q;J
I S V L N B M | N L I S V M;B
T D O I F Z Y | T Y F D Z I;O
T L M N O J C | L C M N J T;O
O M N V Z Q H | N H Q Z V O;M
V P R U X O B | X B P U R O;V
T E H J W G V | E J W H G T;V
G N P B W Y M | G B P N Y W;M
A N U Z V X H | U X A V H Z;N
N Z A V E T S | N A Z S V E;T
Q X Z E H G O | Z Q E H X O;G
S Y P I R H G | Y P G H I S;R
Q U K N H F M | H K F Q M N;U
P S R C B V E | P E C S R V;B
L A S X M V T | S X V A M L;T
Q M A U B Y C | Y Q M U A C;B
Z F T Q M X S | F Q S M Z T;X
T P H D Q U Y | Q Y H U T P;D
W O Q T M A C | M Q W T O C;A
K B I F N H C | N H I K B C;F
B J H V A Z T | V B Z H J A;T
U M B Y W Q V | B V U W Y M;Q
I R H P M A Z | Z P R I A M;H
H Z C S A V P | P A Z C H S;V
L V O A S H P | O H P V S L;A
Y Q R V J O C | Y J V C O Q;R
T S Y U Z V G | Z U G Y V S;T
Q U K V P Z J | V P Z U Q K;J
I S P Y F Z T | S Z P F I Y;T
S I W F A N D | I W N F A D;S
A T E Y F B O | Y A T B E O;F
U K J A M P Y | P U A M K Y;J
B S P I X T W | W B I S P T;X
C G J Y U W N | N W C Y J G;U
V S M K R J O | V M J R S K;O
I S Q L V P R | R S P Q I L;V
G B X W Q P F | Q G B P F X;W
N P I Z M V W | Z N V I P W;M
Q X I H B Z P | X P Q B Z I;H
M H F N K O W | K N H W M F;O
E T O M Z D N | Z N E M O D;T
C A W X N M H | W H X M A N;C
Z G A F P O R | A G F R O P;Z
Y A J O Z E B | A B J O Y Z;E
D I F E W Z K | D E Z I K F;W
N K X J V Q H | N X H K J V;Q
U J S E N Q H | H E U S N J;Q
L Z D C E V M | D C V E M Z;L
N E I J M F O | F M J O N I;E
X J B K H U A | K H B J A X;U
T D S E H J Z | H J S T Z D;E
Q V M O C H Z | Z O M Q C H;V
D K T P U S V | P S D T U K;V
C F K Z P H M | P Z K C M F;H
O G S F B E J | F G O J E S;B
O A U B G S W | O G S A W B;U
C O X Q E Z M | O Z Q X C E;M
V S R J N T Z | S V Z T N R;J
Z G P A E S D | G Z D P A E;S
T R O Q S K N | Q R N K S O;T
H G F P N D T | D H T F G N;P
X Q O W G S N | S W O Q G N;X
F N G P S W I | N S P W I F;G
A H L G T B X | X L H A G B;T
M D U E N L Q | M U D Q N E;L
H Q F C S K M | M F Q K C H;S
W S X V A I F | I S F X V A;W
T B S P V F J | F J S P B V;T
S E A J W Q I | I W A S E J;Q
G D K L U S X | D G S U K X;L
T H Q F Y U C | C Y Q H T U;F
J S R X I W K | J K R X S W;I
S I H B T E Z | Z E B T I H;S
W M C X K G D | G M D C X K;W
R O I J B V L | O J V B L I;R
O B G H X Q F | B G X H F Q;O
F Q A X T S L | T X F L S A;Q
S X J V K Z W | J K V S Z W;X
P G R N U K I | I U K G R P;N
W Q T P J G S | W S Q P J G;T
G I O E S P K | O E K S I P;G
O Q A Z J L C | C L Z A Q J;O
D F Y Z U N G | Z Y G D N F;U
L A C U W S F | S C F W U A;L
C D Y X F V P | Y X F D P C;V
Q P J Y E R W | R Q J E Y W;P
E T C M F Y W | M Y W T C F;E
O B A N E T U | E A B U T N;O
J N K Y G O D | J K Y G N O;D
P Z J O I V K | O V P I J Z;K
S K F G L I T | I T L S F G;K
P B I L R M D | M L B I P D;R
M B Y S V D G | D Y S G M V;B
R Q K D T V U | U R V K D Q;T
R U H S F D E | S D H F U E;R
C K I J S A L | J C L S K I;A
J T I C R L P | L P R I J T;C
G Z K N O U H | H K U Z G O;N
T N P V Y M G | T M Y N G P;V
N Y E S R C F | Y R F N E S;C
R P Q N Y K D | D P N Q Y R;K
U S K P H N Q | P S N U H K;Q
L C J N U H P | C L U N H P;J
X J T I Z U O | T X J I O U;Z
Q S R N V Y W | R S Y V Q N;W
I O X M J Z V | J V X I Z O;M
C F X D I L Y | Y C L X F D;I
E G L O Z V S | G S L O V Z;E
R H I J U S X | X U I H S R;J
E W R Z A L F | A F E W Z L;R
Z H G D P V F | P G D F Z V;H
F K E L Q G D | F K G D E Q;L
W X N E S R U | E X R N U S;W
F Y N J A K S | A J K Y F S;N
Z J M N X W E | X M E N W Z;J
Z W V P S K G | P V G Z K S;W
C Y M U H E W | C M E Y W H;U
Z N B V G X U | X U V N B Z;G
M S H E D Z J | H J M D Z E;S
D F P A I Q B | Q I A B F P;D
Y T S W B Q K | B K Y W Q S;T
F S B X Q A R | Q S X A B F;R
M E K J Y Z O | J O Y M K E;Z
I O Q C Z L U | Z I Q C L U;O
S W N G Y X E | E G Y X W N;S
Y Z E Q D C J | Z E D Q Y J;C
I U N D W O H | H U I O N W;D
E W H J X A Q | W E H A Q J;X
Q X B M K T H | K H B T Q X;M
E Q T F L K Y | F T K Q E Y;L
K A L C G Z F | C K L A F G;Z
N C P W Z J U | N J C Z W P;U
M P U J I Y F | J P M F U Y;I
Y Z T V L P W | W P Z Y T L;V
J D I X M A Z | I D J X A Z;M
F G B C T O L | F O C L T G;B
I S V O F C Q | Q S V C O I;F
B P F R D S J | P D S B F J;R
H Z A F Q G E | Q F H Z E G;A
Z N C Y T V O | O N Y C V Z;T
N O G F I R L | L R G N I O;F
J G M C W V I | I G V C J M;W
I N Q R T C J | Q I N T J C;R
N Z G J H Q V | Z V H N G J;Q
Y O K S H Q R | H Y R S K Q;O
U P Z Q L R I | Z Q U P L R;I
D O X G Y U N | Y D N O U G;X
E P K Y O V W | Y V O P W E;K
Y T M X H R P | H X T Y P M;R
B E Q I Z F S | Z E S F B I;Q
Y S V N E P C | V C E Y S N;P
N E A Q B P D | D Q P E N A;B
S N G I W U P | S P W U N G;I
N Z X I E Y O | O E X I N Z;Y
P B T J F D H | D J H P B F;T
Y I K F G H C | H F G C Y K;I
G N U T O P K | P K N T U O;G
D Q Z Y F C V | C Z F D Y Q;V
E M G R I H Z | Z R H E M I;G
W T H D Z F A | H D A Z F T;W
D L T M X G R | G L R D T X;M
B S G N K V D | S K B G D V;N
M E Z A P Q X | X P Q A M Z;E
T K N D A R W | K D W R N A;T
N O E G I Y T | N Y E T I O;G
H A F M O V X | X A V O F M;H
P T E R H M I | H R T E M I;P
F S G Q W R M | M R F Q G W;S
M Q S C O T J | M Q C J S O;T
N S Q Z M O W | M N O W Z S;Q
J Z H G M R X | Z J R M H X;G
A W U Q K R P | P Q R U A W;K
Y O M K B H E | Y M E H O K;B
E V T Q W O S | Q S W V E T;O
K P D X A N O | K O N X P D;A
Y V M T S L F | S M Y L T F;V
Y D I M E S O | D E S Y M O;I
I Y G F C S Q | S I C F Q Y;G
F B V D L K I | K V D L B F;I
E H I D S P C | P S C I H E;D
O F C R L A Y | C O Y A F L;R
D C R Z H A Q | A Z D Q C R;H
L F J W M Q P | P F J W M L;Q
K U B L T E C | E C T U K L;B
A Q Y F S H I | F A H S Y I;Q
V E K A U N H | E A U K V H;N
J C B F U Y M | M C U F J B;Y
V D K B L C F | C B V L F D;K
S L O E A Q T | T L A S Q O;E
V S C Y O T J | O Y V J S T;C
E Y M Z J V B | J B Y Z M V;E
V M D J F E B | D E V M F J;B
T Y M Z R C W | C W Z T M Y;R
K J F N A E D | N F J K A D;E
L G M W H E N | G E M H N W;L
Z E X K T Y J | E T J X Z K;Y
S X M T J U B | J T M U S B;X
K E B C X Q N | C X B N K Q;E
L O T C U E I | T O E L I U;C
Y U K M O D G | D K M U G O;Y
V L K R H E F | F E V K H R;L
N A Z I H W D | I D Z A N W;H
V Y H B E I O | H O E B I Y;V
L V A G I N B | A V B G L N;I
H D L Z O R T | T R L O Z H;D
K X Y N H L I | X H K Y I N;L
N G P R E K B | R P G E N B;K
E T U A R C G | E T A G U R;C
H E D Q Y K O | H D Y O K Q;E
Z E O B H U I | O H E Z U I;B
I S K F D Y O | D S O I K Y;F
D L X W Y K N | K Y X L D N;W
R W F O P K Y | K W Y O P R;F
T L Y D K J W | W D Y K J L;T
U T S G X C O | X U T O C S;G
N K E R W D L | E L D N R K;W
U G C N R T D | T R D G U N;C
K G L X M J V | V K X L G M;J
A I H U K M P | M A I U K H;P
N Y E K X V U | X E V N U Y;K
V S H D Z P A | S H V A D Z;P
W R Y A L M U | M Y W L A R;U
A O V K B Y C | Y B O K C V;A
C B L D A U T | B A U L D C;T
Y D U P O R E | O U E P Y D;R
S I C N E J D | S J E D C I;N
H K P G X A D | A P X H G K;D
K O D Y S Q L | Q K L D S O;Y
Q H P F I S Y | P S F I H Y;Q
X Y G M S A J | X J G S A Y;M
H G E Z X I L | Z X L E G H;I
N P U W C L O | W L U N P O;C
J V D P H N G | P H N D V G;J
P J X S O D B | O B S D X P;J
P U C N Z Q D | U Z N C Q D;P
M C R F J D A | A J M C F R;D
N S Q F A E C | F Q N A C S;E
V H B M U Z E | U E M Z B H;V
Z S T L I E J | I S J L T E;Z
J N F Y I T Z | J F I Y N T;Z
O D C L U S A | L O S U D C;A
R S Q E B A X | Q B R S E X;A
K Y M H A T S | K T H Y A M;S
N R E K J F L | E N L F R J;K
S Q K G X V A | G V A Q K X;S
L P Q N M K Z | Q L N Z K P;M
U C A P O H F | U A O H F P;C
D N Z L V Q M | V Q M D N L;Z
Q I R F C S W | S R W F Q I;C
J G U W L M E | L J E G W M;U
I C T R B L F | B T R C L F;I
M K Z Y I N F | N I K F Z M;Y
A V Z N T M G | T G V A Z N;M
L R V A O B C | O B A R C V;L
Y F S M R U X | X R M S U F;Y
U N Q B R L S | S B Q N U L;R
N P Z G O E B | G P B O E Z;N
D I E A S Z M | M I Z A D S;E
H A K U X R G | H G X U K A;R
E D Z L J A H | L H Z D A E;J
B L K T A M D | M K T L B D;A
P Q D H I R N | H Q R I N D;P
O B D E G W N | B E W G N O;D
G Z J T M I D | D M Z T I J;G
G J N M X T E | N M E G T X;J
R U F X S M Y | X Y F R S M;U
N R D K B G X | G N X R B K;D
M I H O C Z T | T O I M C H;Z
D F I J V B M | V M I J F B;D
V D H B U T G | H D G B U T;V
K O G X E W Q | W O X K E Q;G
T H I S Y J F | F I S H Y T;J
I A F Y V S M | A V F I S Y;M
I W V X S A L | X S W A L V;I
L G Y S D T F | S T F G L D;Y
P K U D T W F | K F U P T W;D
B K F M N Z U | U B N F M Z;K
A Q R G C O E | C A G E Q O;R
T E L C Q B P | E Q L T B C;P
W Z X E U H P | U H W P Z E;X
U X Q R Z L K | U R L Q X Z;K
B S T W X G Z | X T Z G S W;B
M Y C W X U Z | X Z C U Y W;M
Z K F Y I L M | Z Y L F K M;I
N O U W I V Y | N O W V Y I;U
L R Q I Y C H | L C R I Q Y;H
P L K R Z J Q | L Z P R Q J;K
K U B F G N P | B N K G U P;F
U D S V K W P | K W D P S V;U
U T E Y R O A | U T O R A E;Y
L A P I X Q W | W P A L X I;Q
L V D Q X O N | L N Q D O V;X
N Z K L E Q W | L K E Z W N;Q
F C G Q I K E | Q I C K G F;E
U Z E V N H M | E N H U M V;Z
W Y T X J H N | X Y H J T N;W
L D J M O V E | V L J M E O;D
V P E F X H U | F P H U X E;V
E G L I O H U | H I U G O E;L
V N X Q H A G | V N A Q G X;H
V K Q P R O J | V J P Q O K;R
T Y V X H U Q | T Y H X U Q;V
T J V M C W E | T C E M V W;J
R L C A U N W | W L N C R A;U
B M N Z S F H | S N M B H Z;F
V A J I P N C | J I P V A C;N
X G N O L H A | X O L N G A;H
Q J A Z X K P | J P X Q K Z;A
D B Y H M T F | F Y T D H M;B
E J G R K L N | J L N K R E;G
W H M Z Q U E | Z W E Q M U;H
X E Z G B W Q | Q W E B Z G;X
U J H E X C B | C H X J E U;B
N H D Q Y T R | H N Y R Q T;D
G Z X Y S C I | S Z C G I X;Y
Q D X E P B F | B D P E F Q;X
B J N R I D V | J R I N B V;D
Q M O K U C S | C Q S M K O;U
T F Y G X C Q | C G Q Y T X;F
G E H R J A F | E J H A F R;G
D J M E T N Q | E T N M D Q;J
M S I B N E W | B S I E W M;N
E U Z H X I B | H X Z I U E;B
V E A D Y S U | D A E U Y S;V
V U M X B D N | V M U N B D;X
U E V O B H R | V E R U H B;O
A B H Z W Y T | T Z Y W A B;H
D U M H B R N | H M D U N B;R
Y O A W T Z F | O A W T F Z;Y
C J Z Q Y R T | Q C T J R Y;Z
K F X W O E Y | F O W X E Y;K
C F W L S M D | D W L S M C;F
L F D G W I T | F T I L W G;D
Q V N W S D O | W N D Q S V;O
P Z S R C E U | C S P Z R U;E
O B W C G Z S | Z G C S B W;O
B E G Q C T S | E G B C Q T;S
M L E O U V K | K M V U E L;O
M O Q I U A Y | I O Q U A M;Y
P U V K C A L | C A P V L K;U
F H G R Q V C | G H V Q F R;C
W D V R Y F B | D Y B F V R;W
X V Q Z R M J | R Q Z M X V;J
D X G R L S Z | R S D X Z L;G
B C D L A X V | D A V L B C;X
I V Y T N P Z | I Y P N V Z;T
E T O V Y A F | A O Y V E T;F
Y T P A J Q B | P A J Q Y B;T
D Z O V L T S | L T D V O Z;S
T N A K E R M | E A R K N T;M
C K Q B Y G O | G B Y Q O K;C
N P Y H J I Q | N P I J Y Q;H
D V R Q Y B P | D R Y Q B P;V
T D C I P L E | C L I D P T;E
X L P Q R I D | P Q D I R X;L
J X L Q Z P N | L J Q Z P X;N
V W O U R A D | R W D U A V;O
Q R H Y P D U | P Y D U Q H;R
S X A V M O Z | V M S A O Z;X
Y V T H I B G | H B G I T V;Y
R C U M O V T | U V R C T O;M
F Q A N O E Z | Q N F A O E;Z
Q V F C U M J | V U C F M J;Q
G A O H T Y D | G O T H Y A;D
I D U Z E F G | U D I E G Z;F
B S J Q T G Y | Q B Y T J G;S
W U J R V Q H | Q R H J U W;V
Z M G O K B F | Z O K B G M;F
R D F U E J X | J U X R E F;D
S Q B T D Z F | Z D T B S F;Q
I K T L S J A | L T I A S K;J
J E D F R G K | K R D G F E;J
X G F P V L O | L V P G O F;X
Y L G N U B W | W N B L U Y;G
U T J E X M K | J T K U X M;E
P Y L B X A T | L P A X Y B;T
U M S Z H W L | U Z L H W S;M
B Y M P S U E | U B E S M Y;P
B J T C R W S | C S R J T W;B
M R C O V F B | B O C F V M;R
Z D N L Q W R | D N Z L W Q;R
E P L Y X Q T | P L X Q Y E;T
M C A S N V R | S R M C N A;V
Q Z P F O B A | B A F Q Z P;O
X Z G M T E D | D G E Z M X;T
M F T V N L S | N F T V M S;L
E Y C K W G Q | C W Q K E Y;G
V P I H Q O D | I D Q V H O;P
S X O L K U P | S P U O K X;L
S L B X U P V | L V B S X U;P
N X A C S M D | M D A X N S;C
B D U Q F O C | O D B F C U;Q
X B W E Q J U | J B U E Q W;X
P W L Q X I N | L Q N W P X;I
T U X A P F H | U F A P X H;T
A K Z O S Q M | Z M K S A O;Q
N H K V X D O | X D H N K V;O
E F I Z W P U | F Z U P W I;E
U C B T H Q V | C U Q H V B;T
M L X H Q K C | C Q K L X H;M
D T Q U J W C | U J Q T C W;D
N Z D K G C H | Z G D H K C;N
O K U Q S X I | I X Q S K O;U
W Q J C R Y A | R Y W J C A;Q
L H O Y P X W | O H P X Y W;L
B O M Q S Z V | Q O Z S V B;M
G J P F V D R | V R D G F J;P
P W F H A I Z | H W F P Z A;I
P C K H I Z D | D K C I Z H;P
F G X P T Q E | G P X E F T;Q
E O R W C V M | M W E R O C;V
C V T I D R B | C I B T R D;V
O A M B N K P | P B N O M A;K
I P D G S C R | R I D C S G;P
K R O U G H I | I K R H O U;G
L Z I M E B Y | Y Z L E I M;B
I Z B D C O V | C O B V D I;Z
M T B Z K A S | A K B Z S M;T
B E I U T D A | B T E A I D;U
R D B Z U E Y | D Y U E Z B;R
D Z H Q M O P | P M D O Q H;Z
G O Z Q U C I | U I Z Q C G;O
D Q S M I V T | V D S M Q T;I
X U F Z R P I | R Z F X P U;I
C U I O L X A | A O I C X U;L
T D K M U O L | M K L O T U;D
X J N D W P Q | X J Q W N P;D
H Q V F M R I | V F M H I R;Q
J Y L T A P H | A L P T Y J;H
T G V D I Y W | I V D T G Y;W
U R J L G M D | J D U G R M;L
F L I P B N O | B L F P O N;I
F Q E H D G Y | H G D E F Y;Q
G J S C H T Q | T J C S H Q;G
T M D I U N P | M P N D T I;U
Q M K X O W I | M W X Q K I;O
F X S D J U R | D S U X J R;F
S H T P M U N | P U S H N T;M
Q W E S C R T | R W S E Q T;C
S D C Q E J M | E Q J D M S;C
T H C G V X D | G D C H V X;T
Y P W S C J O | P J W S O Y;C
B G X L N K R | X K N L G R;B
S B I A G N J | A I J S G N;B
Y E T H L A Z | Z Y H L T E;A
A O Z M Q R B | O Q M Z B R;A
V N F M R O B | N R V M O B;F
C P S R V K M | M C R K V S;P
E X R V F O W | R E V W F O;X
L V E W D G J | D G E W J V;L
J D W C O Z A | C Z W D J O;A
P S L D R U Z | U D L Z R S;P
R D G H Y J M | R M D G H J;Y
I H C F N A P | H N A F I P;C
X U O E Z P I | P E Z O X U;I
X Y A M H G O | X O A G Y M;H
X Q J D A E S | E S Q D J X;A
L K U G W S D | K L D G W S;U
X B M Q S C P | X B C S Q M;P
H X F R E C O | O X F H E C;R
H Y F Z R J T | J F R T Z H;Y
M X Z S K C O | O M C S X Z;K
B Z U K H T A | T B A H U Z;K
E B N Z C F U | U F Z E N C;B
H Q O B I N C | O H N I Q B;C
R W L S C T A | T R L C A S;W
P Y D W Z F X | X W Y Z P F;D
A Z V D N C L | N D A C L V;Z
N Z I W B D L | N W D L Z B;I
U B I G P J V | P B V G J U;I
D Q J E P O G | Q D P E O J;G
X Q G E C W B | Q G B W C E;X
D J H G K O M | J G M D K O;H
Q N V H Y B R | R V Q N H B;Y
K I J W N T F | F I N K T J;W
A D T G M R Z | Z T D M R G;A
J L V K P X Q | V K P X Q L;J
A S I U J G T | S A I U G T;J
O C M Z J Y E | J Y O M Z C;E
G A P L V O C | P L C G A V;O
F S W G Q J M | M F S Q G J;W
K Z P A U Y T | U Y A K Z P;T
H W T D J N M | D N H M W J;T
O Q R B N P F | Q F O N B R;P
X Y O Q H U B | Y X B O U Q;H
T D J R F N W | F T R J D W;N
K Q D Y J X I | I J Q D K X;Y
X J S Q I H M | I J H S X M;Q
O U G F T X V | G O T U F X;V
P R V K E H W | K H E P W V;R
G V D B O I N | B V N D O G;I
W N C F Q P H | P Q W H N C;F
Z S X V I G C | V I X C G S;Z
J A Y Z O X K | A X Y J O K;Z
B K I F W A Q | I W A B F Q;K
O L F Y G B E | G Y F O L E;B
U S C W H V K | S C H V U W;K
L P K H M E X | X H E M L P;K
B V E C D U Z | Z B E V C U;D
E Z B H L W Q | Z Q B E W H;L
E S W C R K F | F W R K E C;S
Y V H T I O W | V I W H Y O;T
J Q K O F A U | A Q F U K J;O
U A K J M D P | D A K P J M;U
Y P V T K B D | K P B D Y V;T
F A Z N P K U | A U Z F N P;K
X Q S R V K L | K Q R V L X;S
C M A Z U Y O | O Z A C U Y;M
W E X A M U T | E U M T W X;A
Q D Z H W F N | H W D Q N Z;F
J N O C Y H E | Y H E C N J;O
C E N B F I R | C F E R B I;N
A L R X H F U | R L A H F U;X
E A S G V Y P | Y A V E G S;P
Y J L R C O V | O L R C J Y;V
O B T F J M I | M T O F B I;J
R Z C X H G J | X R Z H C J;G
L X Z P Q R V | Q P L R X Z;V
O H K N C E M | C O K E H N;M
L J S M G R F | G M R S F J;L
I R Q X Y U W | R W I Q X Y;U
V W P J F C Y | C F V P Y J;W
H J F Y V M E | F V Y H E M;J
F E B R K W U | K B R U W E;F
J S C M K A X | J M C S A X;K
W M N H J T I | J I T M H W;N
Y X M H R L V | L V R M X Y;H
C G H L N Y W | H Y C N G W;L
W B N V Q Z G | Z B V Q N G;W
K J C Y F D H | C J F D K H;Y
M E N G I C X | N M C E I X;G
E L A X Z K U | L A X Z U E;K
A Z M N G X O | M O A G X Z;N
R N G S L M U | U N L R M S;G
Z G C A F D J | J F Z G D A;C
K O J P L W N | J P N L O K;W
H C I R K E Y | K C Y H E I;R
B M A L J W C | M J W B A C;L
Z J V C Y D K | Z D C Y V J;K
L I F B M Z S | Z L B M F S;I
S F C D R T E | F T C E R S;D
Y D E M X O U | D E M X O Y;U
M S F K X L J | K J S F M L;X
S L G D M T J | L D M J G S;T
B C R D T J U | C B J U D R;T
B S W M V F D | W F M V B D;S
F X V W R S T | W F V X T R;S
J C N T B S P | N T B S J P;C
B A F L N K J | K F J N L B;A
T Y B V S W O | T B W S V O;Y
M R T O Q F K | K Q R F T O;M
W M I S O R L | S I M R O L;W
E L R Y N F V | R N L V E Y;F
W O S F E P A | A S W P F O;E
R E A S M J L | A S J M R E;L
O K X C T Z W | O C X K Z W;T
G L H B V O Z | Z B H V L G;O
L W Z X I J E | I W J Z L X;E
W P B F L M R | F R M P W L;B
Y H E M J U R | R Y M J E U;H
J O Q U M B V | J V B Q M O;U
H P Y K A U W | P W U Y A H;K
F S J X G V A | S G F J A X;V
Z B A E X S G | E B Z G X S;A
O T C G Z Y E | T G C E Y Z;O
G R L E X O U | R E U X L G;O
P U E X Q Y F | F Y Q U P E;X
J T G F W P H | P T J G W H;F
N M S F Z G U | S U F M G N;Z
G X Z P M R O | P O X G Z M;R
G A H X F C T | X G F A T C;H
T H W L G J V | J V G H L W;T
A G Y X M N S | G S A X Y M;N
U Y Q Z I N D | N Q Z D U Y;I
U F D E R N S | E S U N F R;D
T Z R L W M P | W Z P M T R;L
S N D P K G T | N S T K P D;G
J D K Y T R M | K R M Y J D;T
I G Z W F O C | O G W I Z C;F
W I S G Z T N | T W G I N Z;S
R Y W N O M D | Y O D W M R;N
B X G W U E Z | U Z W G B E;X
O W X I R C A | C R I W O A;X
N Z V S O M C | N C O Z S V;M
L U V B W O J | U L B J V O;W
Z I J G O F B | G I O J F Z;B
V R U O D S N | S O U N R V;D
R V A M J C Q | M C J Q V R;A
H A I C T R Z | I R H Z A T;C
F M Q A B S D | Q A M S B D;F
K J G P H Q M | M H P K G J;Q
J U S F P G H | P U H F G S;J
S I M A N K U | M U N S A K;I
G S Z I D Y M | S D M Z Y I;G
C M K D H W E | K M E W H D;C
C K B F U G T | K U C T B G;F
U M S Z I G A | I G M Z U A;S
F M S U V L D | V U S D M L;F
M R K P Y Z Q | Y Z M K P R;Q
M R S U Z B D | U Z D R S M;B
G S I D M F L | L D M I G F;S
N S T Y C H J | C N T S J Y;H
T Z L B K E M | K Z B L T M;E
E Q A T D N O | D E A T O N;Q
G Z Q D F S U | G Q S D F Z;U
C Z E W X B P | C Z E X P W;B
T D Y F C B G | B T F C Y D;G
Q I D E Y K B | B E K Q D I;Y
F Q X K L A M | A X L Q K M;F
K M S U X G J | J X M S G K;U
M V S O I B G | S V G O M B;I
C H E Z M D R | C M D E Z H;R
O Q V G C Y K | V Y G O K C;Q
V E O M R D G | E D R V G O;M
Q F J P E L O | Q F L P O E;J
A J R T U N E | N J A R U E;T
A P J E Z B M | J E B M A Z;P
K L F T Q E R | E R K L F T;Q
H J C O E T K | T K E J H O;C
Q B V X G A L | L B Q G A V;X
S R G D L W K | W G D K R L;S
N R F M T X L | F R N L X M;T
E D G L Q Z X | D Q Z G L X;E
E B M H T Q G | H G M Q E T;B
H O S A F J N | A O N H S J;F
X L C G Z W O | X O W C Z L;G
F J H C O G L | C O H F G J;L
Y N M S W H R | W H Y M R N;S
O M B D U W T | D U M O W B;T
S H A X K O F | X A H S K F;O
Z K R C T I G | G R C Z K I;T
J T G S R A L | T L G S R J;A
E S H D L P Y | D L H Y S E;P
O E F M G P W | P E F G W O;M
W G M J Y P F | M W F J G Y;P
B Z Q O V K F | K B F Z Q O;V
W X T A F O S | W T F A O X;S
K C I Z W R B | C B K R I Z;W
A V X H I K T | X T A I V H;K
O B N K D V T | D K V B O N;T
H K Z C T L S | K C Z T H S;L
M D X E N V K | X K D M N V;E
B U O D L S Y | D U O B S Y;L
B U Q Y X T G | G Y U X B T;Q
I Y U B F D J | J Y D B I U;F
Y F P W G M H | H Y P F G M;W
Q I K E D Y M | Q E K Y I M;D
Y U B O L R Q | R B L Q U O;Y
F J A S I E B | J B F I S E;A
C F L I K N G | L K F I C G;N
R P J B Q L U | U Q B L R P;J
V N M D I F A | I F A D V N;M
X K S F M C V | S K V M X C;F
W F Q U I B R | I R U Q W B;F
T B Y C J Z A | B C J A Z Y;T
V H Y C E W F | V F W Y E H;C
T O X M R I L | O X L T I R;M
G Z U Q R V A | R V Q Z A G;U
J L H B V I S | I L S V H B;J
M O L P G E Y | G L Y M E P;O
I J V Z X P H | Z P H V J X;I
D F J Q A L C | C D J F A L;Q
C G H P A E J | E J P C A G;H
D N R H Y X W | H Y X W R N;D
L N Q G H D P | G L H Q P D;N
O M P N H S X | S N P M X O;H
P O G F J N R | O F J P N G;R
Z D R N V K X | N X K V R D;Z
L X K Q E B O | L E K X B Q;O
O N S T G Q R | O S N G T Q;R
C T I J U K N | C U I T J N;K
R E S G L B O | L O B S R E;G
D H F P X E Q | F P E X Q D;H
T E C U O A X | T U C O A X;E
T W D H B J Y | B T D J Y W;H
Y G L P F U W | G U L W Y P;F
N H D O A L X | X O A H D N;L
U Y L R B N E | R N U Y B L;E
T N U B H O L | B O T N H L;U
Z E J M X Q D | J Q D E X Z;M
I Z A H U O P | A P Z I H O;U
Y R Z B K H N | N Y R K H Z;B
P Q F C I L B | P C Q F I B;L
N C V L S H U | L U C H V N;S
S G V F L N X | V F X G N L;S
G C Y T J R Z | T J Y R G Z;C
G B K H Q L O | H L O Q K G;B
M Z D C I R H | H D I C M R;Z
Q R G B F C M | B R F M C G;Q
G C W J S A T | S J T C G W;A
B E W A Y X L | A E B W Y X;L
P C S J K O M | S K C J P M;O
H E I J R S B | S B E J I R;H
N S R Y W G I | R G N Y I S;W
J H F G Z B V | V H F J B G;Z
X F H T C E A | F H A X C E;T
X M G Z C A P | A G Z P X C;M
B H Z R F X A | B H X Z F R;A
V G M W E I X | E G V M I W;X
L D U S B C X | L D S C U B;X
K T O P R B X | R K T O X P;B
F T E Q S H O | E S O T F Q;H
X L S U M F J | L U F M J X;S
S R M D A I C | A S D R C M;I
X J B O M Y Q | Q B M X J O;Y
K R Z C N A Q | A Q R C N K;Z
L J W N R B Y | B W N J L Y;R
B C I T U W P | U P W I T B;C
I U G H F N C | N G H I C F;U
U L C P Q D S | D C L U S P;Q
S R Q T P C F | Q P F T C R;S
Z F A O I G T | I T F Z O G;A
Y O K X W S D | W O Y D K S;X
V O H Z F G J | H O Z F J V;G
J Z L X O H F | H J F L Z X;O
X M Q N I R T | I R N Q M X;T
I W M O T S F | S I T M O F;W
A M T J F L U | A M L U F T;J
Y C O R E N H | Y O H C E N;R
F U E O G T V | E F U G O T;V
W M I T U G K | K U W G T I;M
K W M U R I E | K E R I M W;U
Q U N L Y B X | Y U Q N B X;L
C P A B L F M | P L B F C A;M
E S W L J U G | G J W E L U;S
M Z V Y S U J | V J M Y S Z;U
U C Z V L Q S | C U V Z L Q;S
B C W J S K M | S C B J K M;W
W G C K U M L | U W C K M G;L
W F D X E O H | E H D F X O;W
L B E Q D R Z | Q B R E L D;Z
Q A C M N I S | A Q S C M N;I
C D N M P Z J | M Z N D C J;P
N D R M L S K | S M K L D R;N
F C H W O L R | L R F C W O;H
N Y H F S Q O | Q O S Y H F;N
Q X C A N T S | Q T S A C N;X
W D J K L N X | N L X J K W;D
T V Y C A F J | F J Y V T A;C
T L M R U I S | U T L R I S;M
R Z E V X B W | X E B R Z W;V
G U N S B J R | R J B S G N;U
R M W O I L X | L R O M W X;I
Y P I T K E B | K B I P E T;Y
K A J C E U B | J K C B E A;U
M Z I W N C A | A C I N M Z;W
X D C T F B A | T A D C B X;F
S P H T B C E | E H T B S P;C
R M F J H O B | H M B O J F;R
A O B N D M X | B D O A X M;N
J Q S I V D W | I J W V D Q;S
D L S Q F X A | D Q S A L F;X
C F P B G O Q | F Q C B O P;G
X J G O M V R | V X O R G M;J
W E A C X G F | X C F W A E;G
Z M N H X S Y | S Y X N M Z;H
R X Q I C N S | R X Q I C N;S
R K C H O A I | R K C O I A;H
Y G W I J N Z | G Z N Y J W;I
S U H Q I K N | H S N I Q K;U
Z W U V E R C | W Z C R E U;V
X G I J H Y Q | G Q X H Y I;J
C J B E W R Q | J B E Q C W;R
O T S P N E Q | E T S O N Q;P
R J U K D S A | S J U R A K;D
F K N X J Y Q | J X K F N Y;Q
A E N W X Y R | E X W Y A N;R
Z P M E Y J N | M Y Z P J N;E
H K M R Q D P | D P M H Q R;K
K U F R C P M | F K U C R M;P
Z Q T B S R N | Q S B T R Z;N
A V O W L Y G | O A G Y V L;W
D R B X W A U | R D A X B W;U
N Z C E S I K | C S E Z N K;I
P S W E Q O M | E Q W M S P;O
F J V N D P U | N U D V P F;J
H E F I C G D | D I G F E H;C
X A J Z T K H | X Z J H T A;K
L A M T E Y O | O M A E L Y;T
B M Z E J W O | B M O E W Z;J
C D L J Z P V | Z C J D V P;L
D I O F N K Z | Z K O D F I;N
Y P K E F V U | K U P Y E V;F
N H V W R X E | N X W V R E;H
R K S C H X I | I K H S R X;C
E N R C V F B | R F C B E N;V
H R P T O E N | O R T N E H;P
J E H R D X I | E R J H D X;I
E W F G D U L | D L W E G F;U
Z Y U B O X J | B X O Y Z U;J
U Q L W X F Z | Q L F W U Z;X
S F P H O I J | F P I S O H;J
X N L F K D Q | F L D K Q X;N
R O C A V T D | C T V O A D;R
H C A S R X K | R K A X C S;H
Y V N A R E P | E V P R A N;Y
N T D P S V L | T L P V N S;D
N K C E Y Q V | E K N Y Q C;V
A V M P Y O N | N P M V A Y;O
W P A K C D R | W K R A C D;P
B S D U K N X | X S N B D K;U
T Q B L P U G | G B P T L U;Q
H V L R I T F | R H I F L V;T
L Q K X O S V | S V O L Q K;X
M W K P Q I S | Q K S P W I;M
P J A K V U X | U X J A P K;V
A J T K S Y Z | K J Y T S Z;A
Z V H L M C Y | C Z V H M L;Y
R V K Q C X G | X C V Q G R;K
Q B O H D X M | O Q H M X D;B
H Q Z S Y M C | Q Z S Y C M;H
F W H L O D N | O W H L F D;N
Y L G E K V I | L V K G I Y;E
N G W E M Q I | G E W N I M;Q
A U Q X L R G | A R G Q X U;L
O C N F R W V | W N C O F R;V
D T K R A N E | T R E K A N;D
J T K L E Y S | S J K Y E L;T
B Z P Y N M T | M N T Y Z P;B
M G F K P N Y | F K M P Y N;G
N Y C R B X L | B R N X Y C;L
I O W F T X Z | Z T F O I W;X
C J K A M R I | J I R C M A;K
T Z L H W Q V | Q V W H T L;Z
Z N O U W B D | O Z N W D U;B
C D M S K T A | A T S K C M;D
C T K E X J S | K T X J E S;C
G X E K J O L | O G X E K L;J
K C E J W M N | J N M E C K;W
C N G H D Z Y | G Z Y H D C;N
O I X G P Q C | C X G I P Q;O
H Q V J I B C | Q B H C V I;J
J L V W O I M | J V O I W M;L
F S Z L N V Y | N Z Y S F L;V
M E O K U W V | M W V O U K;E
X C A I J S W | J C A W S X;I
Y K H J Q B Z | Y B H K Q J;Z
S H M D A C X | M A H S X C;D
N L X K A P H | X A P H K N;L
S N H G Q V X | G S H Q N X;V
P T Z L E K F | Z T L E F K;P
G W T Y M P A | A W T Y P G;M
X D Y K R J C | Y C X K J R;D
R T G O L C B | B T R O C G;L
R J T A Y V W | V T R A J W;Y
G V O K Z F L | V O F Z K G;L
O C K W A U V | W K U O A V;C
K N M F P X O | M K N O P F;X
F J S X B Y E | X S E J B Y;F
Z L C J Q P O | Q C J L P O;Z
B Z S F K I P | P B F K Z S;I
L O T V M N H | M H O V T L;N
Q G J O C I W | O Q C J W G;I
J E U Y Q P T | Q J T P Y E;U
C T Y F H G B | H C G Y T F;B
W N I T V Z Y | W T Z N I Y;V
K E L C Z G U | C E Z K U G;L
S E W B T C U | E W U S B C;T
P F S X J T A | A X S F J P;T
N Q L U B C Y | Q B Y L U N;C
O K H B R J N | K H N B O J;R
U F Z P N Y R | R U F P N Z;Y
U X L N H V A | A V L X N U;H
B H G R Z C E | G C B H R E;Z
M L J K I X U | M K L I X U;J
X E J N L I H | I L H N E X;J
H O C W G M Z | C W H Z G M;O
H F A D U K Y | A K D H F Y;U
J I V X W T K | I K X W V T;J
I W D T M G O | D O T I W G;M
O H B F T D K | T D K F O H;B
B R L I X Y J | B I Y L X J;R
L V E Z F R M | R Z V M E F;L
U T R Y K E A | Y E K U R A;T
X P O F Z Y B | F O P Z B Y;X
P G E B K N V | P E V B G K;N
U K V E O Q B | E Q O V B K;U
K O R N H M C | K H O M R N;C
A V S R O P L | P A V O R S;L
P A D I Y O S | D S P I A Y;O
F O I M A R G | G A O R I M;F
K F D Z U G H | Z D K U H G;F
T S X F B P E | S P F E T B;X
R I Q U W A V | Q I R V U A;W
N Z R S C W V | R Z S W V C;N
E Y K P R I Q | E P I R Y K;Q
W E D N V X Q | D N Q W E X;V
L E X Q Y C U | Y C X U Q L;E
D V O F C J L | D C F J V O;L
O X G L M Q I | I G Q M O X;L
E U P M I H R | E P R M U I;H
Z D Y G E H N | N D Z G Y E;H
A C N P Z Q U | N C A P U Z;Q
I D T O N S L | S L D T I N;O
J H N D M E T | J T E M N D;H
P M V U N L R | P R M V N L;U
P T U Z R L W | L T U R W Z;P
H T J Z E S F | T Z H E S J;F
J X F A W S V | X F S J A W;V
G Q P E H V Y | V Y H G E Q;P
P L J Z Y U R | J P Z R Y L;U
M G W Q X F N | M W Q X N F;G
H S A Z V Y D | D Z H V A S;Y
L M Y P Q S B | Q P B M Y S;L
E K A T Y Q Z | E Y Q Z A T;K
Y U A F C G T | U C F Y G T;A
R O F I V P U | O R V P I F;U
L K G R E J H | J E G H R L;K
O W H Z R F U | R H O F W Z;U
P C J Y L E T | P C E L T J;Y
Q N B X D U S | N Q B S X D;U
H J R C L G T | H J C R T L;G
S Z W L E M R | R W S L Z M;E
W U X J B Z N | W Z U B J X;N
C N P E R V Z | C E R V Z N;P
R I N G V Y Z | R I G N Z Y;V
A V S U K P H | V A S U H K;P
X J F L I U R | L R X F U J;I
Z W V S R Y A | Y S W V R A;Z
Q W R H N A P | W Q A P R N;H
Z G L V S I X | L G Z X S V;I
H B R J U Y S | S B U H R J;Y
U D P G T A O | D T G U P A;O
F A C T N J L | A J C L F N;T
N H D I B P W | I D P W B H;N
M X Z R N C P | R N Z C P M;X
Z Q H G T S P | Z T P Q G S;H
P J S D G F X | D P S F G J;X
P F B X E S O | E O X F S P;B
O R C M H X E | R X H E M C;O
X I R Z S O Y | Y S I X R Z;O
Z S P H B R O | H P R S O B;Z
M F R K B D V | K M V D B R;F
Z H I G F M R | R F H Z G I;M
U Z L X W K C | Z L K X U W;C
V D U J T X Y | V D U J X Y;T
W C G N Q K P | K Q W C G N;P
H F M Z R K Q | R Q Z F H K;M
F W L M D G B | G L M D F W;B
N J K V C D L | D L C K N J;V
I S K Y F W U | U F W I S Y;K
U N S H E D C | U H N C D S;E
J V O F S K B | O B F J K V;S
L W E B Z U A | W B Z L U A;E
E J Z B C W X | Z W B E J X;C
T Y J E I O R | I Y E R T J;O
S C L K W A R | S W R K L A;C
X D V R K G Y | R G X Y V K;D
H E U T I P N | T I N H U E;P
Y Q T S C M Z | Y T S Z M C;Q
T S X H P Q K | X H K P S T;Q
Q X L W U O Y | Q X L U W O;Y
O C W R L D P | C L D W O P;R
K L P A T I S | A I S P K T;L
Y Q K W M U F | Y M W K U Q;F
R L T E F X N | N R L X T F;E
G Y I J C U X | Y U I C X G;J
E X N Z R Q I | X Q I Z E N;R
D H T F P K A | T H A D P K;F
I G R K X Q J | Q X G K I R;J
D O A J R K Z | J R D Z O A;K
R S H Q L A I | A I R L Q H;S
O Z W P V T F | F T Z W O P;V
Q D E C B O P | B D E Q P O;C
Y W C J D N U | N C Y D J W;U
Z D P C E W J | E P C W Z D;J
R X W N K S D | X S W N R D;K
H N M G A U D | U M A H D G;N
V U I C R J S | V I R U C S;J
X S F O B P E | S B O P F E;X
V P A N L Y Z | P A Z Y N L;V
I F V Y Q O W | Y Q V O I F;W
T N O A Q D K | Q D O T K A;N
W T C Z S L X | S W X Z L T;C
I Y W H L S A | S L W Y H A;I
W Q Z F E P V | V Z Q F W P;E
T S L V O F U | F V U S O L;T
A C H I O S W | S W O A H I;C
D Z V H M U N | N Z M V D U;H
G Q P O S T D | S T O D P G;Q
O I V E Z Q D | O V D Z I Q;E
B V H Z P W N | B Z H V W N;P
J W N U I H P | U W H I P J;N
G V L H W J Q | L V Q G J H;W
G N U A T K Y | N T U A G Y;K
Q U M D P E V | U Q D P M V;E
N X R D A L F | N R F A X D;L
K U F W B P O | O W F U K B;P
R F I D V Y L | Y V I L R D;F
A O J G C V P | P A V O C G;J
W Q E U O J D | J W D Q O E;U
X K Q Z G E M | E K G M Q Z;X
P X O I V W L | W X I P L V;O
M D T O Y E H | H D E M T Y;O
D Z L V C T K | C T K V Z D;L
S U D B X P T | B D S X U T;P
A Y N W G D P | P D Y N W A;G
A U P T O S I | S O P I U T;A
M G K R J E V | V G K M E J;R
M B V N Z L R | B L N Z V R;M
O M Z A U G T | U O A Z G M;T
J Z M P O T C | J Z O T M P;C
H E L G F X I | I F H L X G;E
Y T I P U S L | L Y I T S P;U
S M K A H G P | P A M S G H;K
Y I N H C Z A | C Y I A H N;Z
T K A Y J U N | Y T A K N J;U
T L D Y B I V | B V T Y I L;D
K U C X N G I | K U I X N C;G
Q Z J V B H F | H J Q B V F;Z
G B J N H Q L | Q H B N J G;L
G E Q D Z N K | N Q G Z D K;E
C Q D K S R Z | R C S Z K D;Q
E F V Y O I H | I O E Y V F;H
G F L O X Y S | Y O F G X L;S
C N R B K P H | N C K B R H;P
V G B I H Q J | Q J H G B I;V
T O Y G S Z I | Y S Z T I G;O
G T S W F J B | W F B S T J;G
F M L R U C Y | Y M R U C L;F
Z X M K E S B | E M K B S X;Z
B C U N W I H | C U W N H I;B
L T F P N S A | T S P N A L;F
X G Z R J Q F | Q X F Z R J;G
A F H B T V P | T P B V A F;H
Z V N Q A W L | A L N Z Q V;W
C F K V P A D | A D K C F P;V
W M U K A H X | A X H W K M;U
M K U S F Q T | S F T K U M;Q
S B O Y W Q G | G W S B Y Q;O
C F I P L D Z | C L D F Z I;P
Z G P S I B T | S P B I T G;Z
Z L T Y M X P | T P L Z M X;Y
J M X O N Z H | H O M J X N;Z
K J V U B P Z | B V K J P U;Z
T A G Y J O U | G T A J O Y;U
C F D U Y V P | U D C P Y V;F
A O C X Z P V | V O C P X Z;A
C N E T R I D | I C D T R N;E
Q U R L B K Z | B L U R K Z;Q
W H Z L O M V | Z M H W L V;O
R G H W Q F I | I W G F H Q;R
G M H D A R J | R J D M G A;H
H Y R U I C K | H C R Y I K;U
K I M H O Y Z | O K Y H M I;Z
O E J F T M G | O M E G F T;J
B J C S N W Q | S C Q J B W;N
B H L E I F O | F H L O B E;I
N U Y B O S M | O U N B M Y;S
C E J D R Y M | R J M Y E C;D
A I C N Y L E | I C N L E Y;A
A Q E O W T V | W O E T V A;Q
G Z W V T X O | W Z X G V T;O
H J E I D P M | D E I M H P;J
S Y E K H W B | Y H W E K S;B
S V K I C A U | A C V K S I;U
P M Y U D F W | D W Y U M F;P
Z H V I L K G | Z L G H I K;V
O S U N K B R | R K N S B U;O
C A P E B K I | B P K C E I;A
T S W X I Z Q | X Q T Z W S;I
W S B T I Y G | I G W B Y T;S
B T O Y Z N F | O Z F N Y B;T
R B D C N V O | C R O V D B;N
Y Q B C D M S | M B D Q Y S;C
Q F E T P H R | H Q E R T F;P
H C B O P L X | O L X B H C;P
K O J D Z F R | F Z R K J D;O
K R U B I C J | U C K R I J;B
F I J H P S R | R J S F H I;P
W D O S Q E N | Q D E S N O;W
D I K F P N A | D I K A F N;P
M Q D C J F N | Q F M D N J;C
D A V G L T R | D L G A R T;V
B Z W P R V N | B V R W P Z;N
H O D W L G M | D M L G W H;O
H R W A T O J | W R A O T J;H
G Q B W V L E | E W L V G B;Q
R L F P M E K | K L E P F R;M
B I H F K Q U | F K I H U Q;B
P L N I A R U | U A I R L N;P
P F V N G Q M | F P G V M Q;N
D P Z I X O W | W X O I D P;Z
W G U C A F P | W F C A P G;U
Z B U V P G M | G U Z M B V;P
E U B P O N R | U N E O R P;B
Z P M V U G O | Z P O V G U;M
W K F C E Z R | K Z R C E F;W
Y O L M F J K | M Y K L F O;J
E K R I N J X | K R X E N I;J
X H Y E G F S | E F S G H Y;X
L A F W O Z D | F W D A O L;Z
Y H W Z V Q R | R Z W V H Y;Q
V K P W F I G | F V P I G K;W
I E X L T O V | V I T E O L;X
C A T P B Q G | T A G P Q B;C
F Z Q R P K L | K R Z P L Q;F
N J L X F O T | J N F T X O;L
X V P R D U B | P V U B D R;X
R L J G M Z U | G R L U Z J;M
P A T L E N Q | E Q L A T P;N
L T D I H Q S | T S I Q H L;D
W N X Y H C R | H Y W C N R;X
A B W U H T Y | W A Y H T B;U
F W U O E K Y | K Y U E F W;O
P Q N M J W I | W I N J Q M;P
Y Z F V B P H | Z V F B Y P;H
X Y Q C H A L | C Y X Q L H;A
B G J Z O C K | O B J C G K;Z
H W X U Q C B | C W X B H Q;U
D Y P K V Q T | V Y T K D Q;P
S L Y H R G X | R G X Y H S;L
M O Y K B J D | J D Y M K B;O
J W K O H R G | R O H W K J;G
K R G H B X W | G X B W H K;R
D G O J X K V | G O V J D K;X
U R V E I T F | E U T V R I;F
C P D F I O B | C B I D P O;F
M H K D V U R | D U R M H V;K
X U E Y G D M | X E Y D G M;U
R C M L P I Q | C M L P Q R;I
I P S B O L F | O L P F S I;B
Y X Z N F H S | H F S Y N X;Z
V N U Y Z D C | C Z Y N U D;V
A B W U H X F | B U H W X A;F
Y B E Q T J C | Y T E C J B;Q
S Y E D G R H | Y R D G E S;H
J D L A O W M | J A M O L D;W
S Q P L W V C | Q C L V P S;W
D J G K P W C | P J C W D G;K
B Q G J D N R | R B Q N G D;J
A V Z U T I L | A T L U V I;Z
P A U H Y Q E | Q Y E H A P;U
Z P L I O E T | E I O L T Z;P
N C Z W D S G | Z W D G N C;S
Z C S O E R B | S C B O E R;Z
Q K I E V U T | T Q E U K V;I
A S Y D T X H | H A T X Y D;S
Y T W R L O E | R T O W Y E;L
X U T S Y E J | Y X T S J U;E
E G Q W Y X K | K Q W G X E;Y
D N M E X C I | C M N D I X;E
I Z J H A P D | J H I Z D P;A
B G F J K E R | G J B E F K;R
Q U S A X R J | A S R U Q X;J
B J A S N Z E | J Z S N E B;A
M Q I N E P V | E N V P M I;Q
N V I Y Q E H | Y I E V Q N;H
Z S W G M D J | S Z G M D W;J
G Q A S D B R | R G S A Q D;B
T I G S N Y V | G S N I Y T;V
A L P T H B J | A P T B J L;H
O Q Y R I M L | L R O I Q M;Y
D U O E I X J | X E U D I O;J
Y G A R P H U | P R H U A Y;G
N R K A V H C | R A N K C V;H
U K Y T L M B | K M T L Y U;B
R X T Z U B P | B R T U P X;Z
D M S E G A T | D A S M T E;G
L S I B V Z R | B I Z V S L;R
S M P Y K G O | O S P G M Y;K
W I D J P O A | J P I A D O;W
H Y C O Z R I | O Y Z C I R;H
I A E J W M N | I N E J M W;A
H M T V J X P | V J H T M P;X
C Q B Y S X H | H Q S C B X;Y
Y K O Q G H N | G O Q H Y N;K
G I Z K E X U | K G I Z U E;X
J R C F W I M | J F R C I M;W
G D K X L Q Z | D X G Q L K;Z
Z V T X S H B | X V Z H B S;T
D I B A Q S O | Q A B O S I;D
R G X N Y D O | G N R O X D;Y
Z D T P O J S | P S Z J O D;T
X U P E R G Q | Q U P G E R;X
V S O F W L H | W L H F S O;V
Q I G B K T S | B Q I K G S;T
G Z L R Q P Y | R L Q Z P G;Y
U B S K W Z E | B W K S U Z;E
T K F N X S E | N K S E F T;X
O Z C M R Y L | L R O Y Z M;C
S A B H C Y I | Y I S B C H;A
B S Z E I D Y | B D Y Z S I;E
C Q Z L T P Y | Z C T P Q Y;L
A K E M O Y Z | Y K Z E A M;O
P L B G Z V T | T V Z L B P;G
B U J C T O I | U J O C T B;I
G K X Q P M V | K X Q M V P;G
D C S A W Y N | D S A Y C W;N
I R W M U B H | R U M W H I;B
Z O B P V C H | Z O C B V H;P
A Y E F Z X Q | A Z F Q X Y;E
J H Z U F N S | U H N F J S;Z
C W D R O V F | O W F C R D;V
N Q M O E A K | E M A N Q O;K
M J D O Y U S | J S O D M U;Y
O W G K F L X | W K G X L O;F
U J Y F X L S | Y X S F U J;L
K Q F H I Z G | F Z I H G Q;K
H C F M P B R | M F B H P R;C
W K M E Z X S | K E Z S M X;W
F U Q X H B Z | B U Z X Q F;H
T O S U Y A E | O Y U S T E;A
I Z W R G S N | I N W Z S G;R
B U O D G K M | U K B D M O;G
F A O C B H N | N O B H C A;F
V O H U Y K R | V O R U K Y;H
B U L K G V O | K B U G V O;L
G K V S E Q C | V E G C Q K;S
R K G X Q F I | I G F Q X R;K
L F Q N H G P | F P H Q G N;L
Z N H V R D O | V Z R N O H;D
Z T C A O H K | H T K Z A C;O
B V W E K T D | K T D V E W;B
N I Z S Q J B | N Z I S Q B;J
P R Y H O D K | K R O H D P;Y
G O X J M Z N | X J O M N Z;G
N U E C A W F | U W E N C A;F
B J I W Q L T | W B T L Q I;J
T K O B M P H | B T P O M H;K
P H S C U I O | I O P H U S;C
J W O Y R V E | Y J R V O E;W
G B N X D W E | N X W G B D;E
E H A B W G V | G A E W V H;B
B A X Q E H O | Q O B H E A;X
U V M Z W O G | O M U W Z V;G
V Y I U O B Z | B Y O I V U;Z
U W O A S E Y | S U Y W A O;E
E X D Y P C U | C U P Y D X;E
Q Y X F S N V | V Q Y N X S;F
P K N J Y G I | G Y J I P N;K
M C J U A R Q | M U A J C Q;R
Z G S W Y E B | W B S G E Y;Z
D V Q C Y J P | Q J P D Y C;V
E L T S P Z O | L E S Z P T;O
Q A H B W E G | B W A Q G E;H
F H A Y B Z R | B Z F R A Y;H
Z M H P B T F | H T F B Z P;M
S V T P C U G | G U S C T V;P
R F N S C Y D | C F D Y S N;R
K M Z X Y U A | U M X Y A Z;K
S Q A N M X T | Q A N T M S;X
F H X S N W Z | W H X Z S F;N
B M S L N T A | L M T N A S;B
Y O D Z I T V | D V T O Z I;Y
R W I P N Q H | R P N W I H;Q
S F L K E T V | L E K T V S;F
C H K U D G I | G U D K I C;H
U W E T D O B | U B E O T W;D
O S R C F E L | R S E O L C;F
P Y G V Q O L | V P G Q O L;Y
T S Y H X A U | S H A Y U X;T
K I G F T X O | K I O F G X;T
F M S V I W Z | Z F S W I M;V
D N X V R M I | I X V M N R;D
F G V Y B E L | G Y E F B V;L
Z J I B U S D | B Z J S I U;D
F H N Z C I U | F U C H I Z;N
S R V E L G O | L O V R E G;S
P J B I K Y F | P B F I K J;Y
N T C Y E H U | Y U E H C T;N
Y L Q M V F T | F Q L Y M V;T
P N S Y L D B | P Y S D B L;N
D M R Z Q G C | C D Z M G R;Q
X L G U C J N | N G J L U X;C
I G X H F V L | G I F X H V;L
S I R C A Q F | A I R S C Q;F
Y B V Q M L O | Q B M O V L;Y
T I Z R V O M | V O R I M Z;T
D B P F C Y E | F P C D E Y;B
S W L N V H A | W A L V S N;H
Q V W J C Y F | W V C J F Q;Y
H T U X V R M | R U T X H M;V
E Y W H X L F | W L Y H F E;X
I D U K M P Y | I K M Y U P;D
C W N S H O M | N M H C O S;W
U I D E R A Y | I U E D A R;Y
A I B W J H D | A B W D J I;H
E V A H O J B | E V O A H J;B
B O G F C Y H | G F B O C H;Y
E C L Y U I A | C U L Y A I;E
M E B Y W N F | B M E Y W F;N
N Q I V G U X | I Q G V U X;N
P M J Q W X C | P C X W M J;Q
T V F B M S H | M S H T V F;B
I S H N Q T O | I Q T O S H;N
D O U H C G B | C O H U D G;B
B O Q X F W M | F Q B O M X;W
D V J N R K Y | R D J K N Y;V
J L H A T F O | T A J L F O;H
S U H Z J V F | F V H J U Z;S
G J S N I K L | K J L I S G;N
A F T E H C S | T E C F S A;H
E A K P Z H U | A H E U Z K;P
S I W K L H V | H S K V L I;W
R I E C A G F | F E G R C A;I
D M A L P S Y | Y A S L M D;P
N J E L I Q U | J N I L Q U;E
V E O T N L P | N L E T P O;V
Y N G M D T L | D M L Y N T;G
T P Y N G S Z | N S G P Y T;Z
O D Q F M Z S | O S Q D F Z;M
B Q O H M I L | M L H B O Q;I
H Q G X D C L | D Q H G X L;C
J W S M B O D | J M B W S O;D
M P U S W I L | P I S M L W;U
R C U O E M G | C E M G U O;R
I E G Y D Q V | G Q I V E D;Y
C N J Y V W B | B W J N C V;Y
O N C M Q V L | V Q N M C O;L
X W U R O B V | O V B W X U;R
J D E G U N I | G E I J N U;D
A Y T P G Z X | T Z A G P Y;X
P S Y T Z G K | S Z G P K Y;T
E H J R O N W | H W E J O N;R
D R E W Q L X | L X Q E D W;R
C I F H U K Z | I H F U Z C;K
Y T X H R O J | R X O T J H;Y
X Z I W H A Y | I X Y H Z W;A
V U D X M C W | X U W D C V;M
X F A K I W G | F K I X W A;G
B Q J M F R U | Q U R B M F;J
I B E N C O R | B O N C I R;E
V A K W J B C | K V A W J C;B
N K C Q F B Z | Z Q N K F C;B
N L G M T O I | M N L T O G;I
R B N P I E J | R E N P B J;I
C E G M V W J | C E V M G J;W
B G Q E K V U | U V E K B G;Q
P R C H Z U N | P R U N H C;Z
H W O E Y Q X | Q O X E Y H;W
F D H J T A G | F D A J H G;T
F Q B C D E S | Q F B S C E;D
Q R E K B O T | B T K E R O;Q
M J S T W H Z | M Z S H T W;J
Q S K Y Z M X | Z S K X Y Q;M
F M Q A Z J T | Q F Z M J A;T
C I D U M L A | L D M A U I;C
S I A M B X N | X N A S M I;B
M I X Q A D E | D A X Q M I;E
G R L B I Y X | B I L R Y G;X
J Q E I B U D | Q D I E B U;J
V K S O B Q X | Q V S B K X;O
C H X M K Z G | M X Z H C K;G
Z Y O F M Q G | F Q M Y Z G;O
U V Q O E G B | B U V G O Q;E
R A S G L Y K | A S G R K L;Y
V J G S H R W | R V W J G H;S
R I G Q H B U | H B Q I U R;G
T W L X P N I | P I N X T L;W
H N F U R D S | H U N F S R;D
E Q L W A X R | E L X Q W A;R
Y L B P K T W | P B T K W L;Y
E Z Q I N A P | N A Z I Q E;P
I J X V C B D | J D B V X C;I
W N L B G K C | K B L G C W;N
W O M Z U G C | G O M Z C U;W
L C T A X O Y | O T C X A L;Y
L E Z W H X D | H W E X Z D;L
Q X M A E D H | D A H Q M X;E
C K V R J N U | N K U J C R;V
W V L R B K Z | V W K R Z L;B
A Z J C W I N | J I Z W C A;N
J S V W N F A | N J S V F A;W
S G K A R C E | G C R K A E;S
F W G E T A R | E W T F A R;G
V J O D F E Q | Q D F O E J;V
C Z N M U I O | I Z U O M N;C
O G B W P C U | C U O B P W;G
J W C Q Y I M | I J Y M Q C;W
J E Y S B H T | J H B Y S E;T
A P L W H S R | A W R P H L;S
S F Q J G A B | A Q B F G S;J
D L Q U F G W | Q F W G L D;U
I U T Q D X K | I K Q D U T;X
S Y P H T W X | Y H T P X W;S
C H F B U G Z | F Z U G C H;B
D U B L Q W T | T L U B Q D;W
N K A Q I S F | F Q K S A I;N
U X T O C H K | X K O U H T;C
M K L U X J D | U D K L X M;J
H Y B P Q U G | P Y G B U H;Q
L C K W A M F | F M C K A W;L
N Q O S M H D | O H N S Q M;D
F X O U V G I | I U F X O G;V
E W C T R Y D | E C T W Y R;D
W G B P Q V M | P V G M Q B;W
B V Z P N X Q | Z X N B P V;Q
V E B D A S U | E D S B A U;V
D R P Z G X J | J R P Z X G;D
H O T Q S D C | C S H O Q D;T
E B J X W S H | H E W X B S;J
G Q N F U C Y | N Q G C Y U;F
O F R B Z H W | W H F Z O R;B
Q O U R A P K | Q O P K A U;R
S K A H T R C | S A K R C H;T
H K Y V R W S | K R H V W S;Y
A H V G Q C E | V A G Q E C;H
Y W K U I N V | N V W Y K U;I
I H M L R A U | A L I U M R;H
D K U W H C B | B K H C U D;W
P X K N F V A | K P F N A V;X
W D P M K B F | F K P M D W;B
F R E N S G T | S R F N G T;E
G F M S I P H | H P I G F S;M
W P H Z U C I | P I W C Z H;U
J E H R O V W | J E H W O V;R
G Z U K W J M | M J Z K G U;W
W U R T I S H | R H S I W U;T
Z X H J W U D | U X D Z H W;J
S D C N R J B | R J C S D B;N
U D H I M W P | I D H M P U;W
D R N K W J G | R K W N G D;J
D K E O Z M Y | Z M D O Y K;E
V E T G D P H | V E T G P H;D
B Z L V R Q X | Z L B V X R;Q
P S U Q J N C | U Q J S P C;N
Z L R E U S O | S R E L O U;Z
Z O A R K C I | K A Z I C R;O
S Q R O G F Z | Q Z S G F O;R
B H A T K O Q | Q K B H O T;A
F K D M H U I | U I H F M K;D
N A T K Q B H | B H K A Q T;N
U I Q B A D R | B D I R Q U;A
Z R L Y W E D | Z E L D R W;Y
B U P N Q K G | P N G B Q K;U
H A T Z L I N | A N Z T H I;L
L R P I X D Y | I Y X R P D;L
W D P B Z Q J | P J W D Q Z;B
X J L Q O G D | D G J X L O;Q
F C S I H V B | V C H I F B;S
E G T Z X A Y | X Y A Z G T;E
Q V D W G S H | H G W S Q V;D
Q M A U F N V | U F V M Q N;A
W O B J A N T | J W T N A B;O
O H C E K G Z | K G Z C O H;E
P V Y N K R J | N V J Y R P;K
D X B O V M N | D N B M X V;O
I U N F B Y C | I N U B Y F;C
V K S A X Q O | K X A O V Q;S
K G W S Z M C | M Z S W G C;K
A O C S J P F | S C A O J F;P
Y W V M Q T C | V M Q C Y W;T
Q I M C H W F | H C W M F I;Q
T A Z L I D O | Z I A D O T;L
G L Y J K Z Q | Z K Y G Q J;L
N W K J M B F | N B K F W M;J
C P Y Q U N O | Y U N P Q C;O
S I Y K G Z F | F G K Y I Z;S
O M P C Y U L | O L U Y M P;C
L D K Y B R U | R L Y K D B;U
X B V A L N F | F X B L V A;N
K G P T O E S | E S P K T O;G
F B A Z S M W | M Z S A B W;F
C H N L I J Q | Q H N L I C;J
S V N P R U H | H U N S V P;R
P S Y G M R X | P R M Y S X;G
R P G E Q C U | G P U R Q E;C
A K X B H O I | X H I K B O;A
T O M E J G X | G X E O J M;T
R V I F G O D | F O I D V G;R
Q U Z F B I E | U E Q I Z B;F
F H X B W R G | H F R W X B;G
I B M R V T L | I V M L B T;R
S J A R B U Y | U B Y S A R;J
L K C O D Z H | H K O L D Z;C
N Y I O F S K | O S I Y N F;K
L D I O Y B H | B O H L Y D;I
D R L I M G H | D M G R L H;I
D M J F S B Q | B F S Q D M;J
O M R H Q N F | H M N Q R O;F
D Q H F O Z I | I H Z F O Q;D
Q L G U M R O | L R G O M U;Q
E R G W Q A U | U A W Q G E;R
Q O I E C B W | W E C B I O;Q
V L W Q C I H | I Q W V L H;C
I C U T L B Z | C U I B L Z;T
I T H G M U B | I U T G B H;M
P Y Z E M F G | E P F G Z Y;M
I V Y L Z S C | Z C L V Y S;I
K Q C Z U I J | J C K I U Q;Z
B P N R F Z L | F N B R Z L;P
D I W A Y S V | D V W A S Y;I
S I X H V Q F | S I Q F V X;H
G O R P V J T | O G T R P J;V
U B Y J C S K | K B J C S Y;U
R K Z H O S G | Z S K R O G;H
H F E V Y Z X | V F Y H Z X;E
X L Y R D Z V | Z X V Y D L;R
I D Q M E H Y | Q M D Y H E;I
T W F U D X M | M W D X F U;T
E S H X L V T | L T H S V E;X
A U M B N V J | A V U J B N;M
U S P W M Z Y | S W Y M Z U;P
C D U Q O A E | Q O A D U E;C
V F G S P R K | K P S F V G;R
E G X I R C Y | G Y E R X C;I
C I N R B G Z | C Z N B G R;I
E G D Q J S K | S J D Q E K;G
P T U Z V D I | Z I D U P V;T
D V A M L P T | A T M V L P;D
B I G R F P T | R B P I G T;F
F W X K S Y I | F Y I W S X;K
L C D T G F O | T G C F L D;O
H K C Q U X L | U Q L K H X;C
L R D G B U H | U R D B L H;G
D L F V S Y E | F L Y D E S;V
F A P X Z D U | U Z A D F X;P
V P X L Y G D | Y V X G P L;D
O P V T U R S | P S V R O T;U
U M J T X G B | G B J T X U;M
H U Z W V I B | H I W U B V;Z
L T A E X G F | E G A L X F;T
T J H L B Y K | J H T L K Y;B
N D T F B U O | B F T O U D;N
Z B Q G N C J | C N J Z G Q;B
P F J W U S V | W F J S U P;V
F J B C D W E | C D W E B F;J
M J B T W Q K | M W Q J T K;B
X S B H K D M | S B K X D H;M
G R L N S V D | S V G N R L;D
K E F H C X T | T F X K C H;E
K X E P H Y U | P K H X U Y;E
S O J Q N M P | N P J Q S O;M
E O I K V X P | O V X P K I;E
L K C N Z A R | A N Z L R C;K
Y F L Q A G X | G F A Y X L;Q
Q E P N H C Z | C Q Z E P N;H
S E G Z Q K W | W E Z K Q G;S
K W M C O Z H | O Z M C W H;K
B G U D R H E | E D B U H G;R
X K B G C A Z | G K A C Z X;B
I Z H V T P N | I V H N Z T;P
S O P I B J M | I J O M P B;S
K V W H G S M | H W M G V K;S
T C A R F W H | A H T C F W;R
Y E J Z D W N | Y J Z D N W;E
P V D X M Z L | X D V L Z P;M
J T L I Q X E | I Q J L T X;E
J I N B A Q U | I U Q B J N;A
U P N V S A X | P X S A N U;V
E V Q R G J Z | Q R G J E V;Z
F P U D O T C | P T O F C D;U
L G A T C Y I | G C I T L Y;A
N V J F O D W | O D J V F W;N
Z Q K S M T W | M Z S K W Q;T
B C J I G E L | I L G J E C;B
Q U T M L I D | U I D L T Q;M
Z O U Y Q I W | O I W Y U Z;Q
G R I Q A H X | I Q H A G X;R
J A R Z C K O | C A J K R Z;O
Q F J D O G S | G Q D J O S;F
V K I N P D S | V N S D P K;I
U F D J T P N | N J T D F P;U
V O I Y G W M | Y W M G O I;V
S Q R W D V H | Q S V R D W;H
H G E W J S M | E J H W G M;S
N W K C P V H | N V C P H W;K
F W H Z O M Q | Q M W O Z H;F
L U Q R E O C | E Q C U L O;R
J Z X O T N F | T X J O Z F;N
H L Q K T I E | T H Q I L K;E
B D U Q Y V W | Y D Q V U B;W
T L F C Y H R | T L C R F Y;H
K R V S F I G | V S F K G R;I
B R Z W S T A | Z R A B W S;T
J U R D G N I | N I R D J U;G
Q X K R A C D | Q R A X C K;D
R Y I V C M K | M I V C K Y;R
M R J E C G H | E R M G J H;C
A S H P F T W | T P W S H A;F
N D C X G W J | D W C J X N;G
C U A H O F Y | A H C Y U O;F
O U W S M F E | O W F S E M;U
N G P S U W F | U S G F N P;W
R H V O W M U | O R H V U M;W
W M N A Z I F | A M Z N I W;F
A M F Z B V P | M F V A Z B;P
D M L F V G B | F M V B G D;L
J U L G K E M | E G J U M L;K
L R O Y H E A | E O A L R Y;H
F N I J Z U S | Z J F S U N;I
R U X H Z B F | U F X H R B;Z
R G W N K M J | J K N R G M;W
W A G L N M E | E A N G M L;W
E N I S Z G L | I Z N S E L;G
Y R K Q L D F | Q D L Y K R;F
Y D S C P Z E | S Y E Z C D;P
A L O X S P I | I O A S P L;X
B C V I Q K S | I S V B K Q;C
G C A Y L X K | L Y C X G A;K
K J C R V G T | T C G K V R;J
J L K B W R Z | R Z B K J L;W
J H B D Q L Y | Q J Y B L D;H
V H A J B I Y | A V B Y J I;H
Y K E L D S M | L M E K Y S;D
A W Z F C E I | C E F I W Z;A
J S V D N R G | J D N S R V;G
C K N M U P H | C M K P N H;U
U L B K J I X | J L U K X I;B
A U L P R H T | A T L H U R;P
V H T Y E D Q | Y D E H T V;Q
E Y F V K Z G | G F Z V E K;Y
K E R B P N U | U E K P B N;R
I H E M O C J | E H J M O I;C
W H X C A J Y | J C W H A X;Y
G X C H M Q R | G R C Q H M;X
M O F X C V N | N O C V X F;M
I O Z C D L R | D Z R C I O;L
K S H M P X Q | M S H K X Q;P
R F Y N L K D | F R D N Y K;L
R D Y B N M Q | D N M Q B Y;R
B X N Y V C S | N C V X S B;Y
X W V G H Q D | X D W G Q V;H
W T H G Q N X | X W N Q G H;T
K O A M W V P | W K P A V O;M
R M B X W G I | G B W M I X;R
K G E T Q H Y | H E Q K T Y;G
A I C T R G Q | A R C T G Q;I
M X L P W K G | K L M G W P;X
K A X Q W G R | K Q A G W X;R
V C A S M D Y | M S Y A V D;C
H Y I T W D B | Y T W I B H;D
V P Y I G E X | G V I X E Y;P
O Q N Z G B E | O N G Z B E;Q
O B N W J T K | W O T N K B;J
Z M S A K D U | K S U D A Z;M
N E I W B M H | N M W I H E;B
A B D V Z R E | D E Z A R B;V
C F M I U E G | G F M E I C;U
D H Y V W G J | J W H G Y V;D
J O U F A Q E | E F Q U J O;A
O K S A J V W | V W K J O S;A
S O N Z K T X | S O K T Z N;X
C I L W E J O | W E C L O I;J
M A C P G X I | I M C X A P;G
L H G C V J K | G K C H J V;L
B M S N E V U | V E S M B N;U
R L O M G X U | M O X U G L;R
T P V Z B U C | P V U Z C B;T
L J Y E X R V | X R J L V Y;E
X R V P O S H | O S P R V X;H
D K V J E W Q | W V E K D Q;J
F S D Y P W I | I W P S D Y;F
K P T Q A O Y | A Y P Q O T;K
Y R V F Q O E | Y R O E V F;Q
E G A N Q Z D | Q E A D Z N;G
J D U V F E G | J G F V D U;E
Q O A R P C X | P A O Q R X;C
X Z Y B G M D | D Y X M G B;Z
I R W X B P U | I B R U W X;P
Z X S Y M H A | X S Y H M Z;A
P T I Q R C L | C I Q R T L;P
F S P I Y A N | N I Y S P A;F
K Z S Q P H X | S Q Z H K X;P
A O B D E F H | H O D F B E;A
B F L T Z E Q | T F E L Z B;Q
G N Q R C J Z | Q J N R C Z;G
I R D E T W G | E G I R T D;W
X L U S A T Y | X L Y S T U;A
B F M E G N V | F N M B G V;E
H R Y J X S G | J H S Y R G;X
H W J G Y I B | I J G Y B H;W
X M N Y J Q P | Y J Q N M X;P
K H Z J D P A | P Z D K A J;H
P X A W F I K | K A X P W I;F
S Z I N D X C | N Z D X S I;C
I F V Y G Z Q | I Y G F Z V;Q
I W M Z O P U | Z W P U O M;I
N T D F G I B | D N B I F G;T
O S U X W G N | O U S G N X;W
I B A V J H E | A B H I E V;J
C I T Q N X R | X N Q C R T;I
V E M F N Y S | N E M V F S;Y
J U H B R F E | F J U R E H;B
A I Z W S D O | W O Z D I A;S
O I T N B W X | I X T B O N;W
G L D C I S H | C I L D H G;S
M U P R Q I J | I U M P Q R;J
Y E I O J A B | I B Y O A E;J
Y B K O Q R S | Q S O B K R;Y
L C F X V Q T | L C V F Q T;X
X W L I Q D Y | D L X W I Y;Q
D T X K Q G C | T Q X K C G;D
E P R Z V S T | S R V Z E T;P
F T D B C R U | D F C R U B;T
S K Q E A J F | J Q E A K F;S
P R Z B X H Y | H Y Z P B X;R
K R U F D T N | U N D F K T;R
V E O S N C Q | S V N C E Q;O
A M S H N D Q | D H Q A M N;S
D H U Z P X A | A X Z H D P;U
G Y M A X O I | G Y M A O I;X
I M X B J W S | S I M X W B;J
E R M Y C A P | C P Y A R E;M
N R T Z M X E | Z M R N E T;X
C D M Z Q F R | D R F C Z Q;M
E B T J K H W | E K T H J W;B
U M L W T P R | T W R P U M;L
P Q X I O M R | P M O R I Q;X
F G W V P J E | W P G E V F;J
R Z J M N H X | R N Z X M J;H
M I Q V S E C | E Q C M V I;S
X Q P B G Y C | G B P Y Q X;C
V F C E T W B | E B C T V F;W
W O P Z D R Q | W Q R D Z O;P
H K R O Z S J | Z S J R O H;K
J P G L N M B | M B J L G N;P
V U T K C H N | V K N U H T;C
S T I G D K Z | G Z T K S I;D
N Q H G D S C | N D G C H S;Q
N A M X J W K | J X M N W K;A
Y I F Z K N H | H N F I Z K;Y
D H T E F Z P | Z P D E T H;F
K A C D N V W | V C A N D W;K
G W R O Z A T | T Z A W O R;G
P E Y L C R B | L Y E R P B;C
Q J A D V S B | S Q V J D A;B
K W R O P M S | S M O R W P;K
S P J A Z L H | H A J P S Z;L
V I T L G R F | V G F I L T;R
T K B Y H V W | H K V T Y W;B
R D S A F V P | P R V S A F;D
J O E U S W K | J S K O E U;W
O R T N W U B | B U N R T O;W
I M T Z Q N L | I Z L M N T;Q
V S J O I A P | J V P S O A;I
U J A X Y H D | H U A Y X J;D
U X G L Y T Q | G U Y T X Q;L
N G D K H U L | L K U G N D;H
Z F W C G J P | C J Z P G W;F
W C B I K Y T | Y I T B K W;C
U B C A V I S | S B V U I A;C
E N B S F R Y | N B Y S E F;R
I E T F O L K | L K T E F I;O
O T U N R Z X | O T X N U R;Z
S X V M Y W U | M S X W Y U;V
N U O F P A X | A U F N X O;P
U J P A Y D F | F D J A Y P;U
Q P V Y M E K | V Y M Q K P;E
F G Z Y I Q U | Z G U F Q I;Y
D U W Q X M P | W X Q P D M;U
N P W F X S B | B S F P W X;N
K I G C Y O B | K B I O G C;Y
N D C S X Y P | S D P X N C;Y
E D U J I S M | S M I U D J;E
K F Z D U P E | E K F U D Z;P
H L A S G U M | H L G M S U;A
Z I K D X H W | X W H D I K;Z
H K I L U W X | X L W H U K;I
K X D T S V U | U T S D V X;K
E G B Z L O P | P G B E Z O;L
D R E Y U C F | R E Y F C D;U
U F N P B O L | N P U O B F;L
U Z Y G Q M B | B Z M U Y G;Q
A K S R M T B | S M A R B T;K
Q O Y M C H A | M O C A H Y;Q
V K Y P A Z J | A Y J K P V;Z
E S G B K C F | G K B S F E;C
H V M Y J B E | V J M B H E;Y
V Z S I A X N | N V Z S I A;X
W T O L P M B | P O W L B T;M
T F G P D I H | H D I F G T;P
Q X J E B K W | X J Q K W B;E
O Y C D N V R | R D O C Y V;N
T I O N W R P | N I P R W T;O
H O L F B N D | H N B D L F;O
L U Y S K I X | S U I L X K;Y
P A Y L Q D Z | Z A Q L P Y;D
O L S J F B D | B O S J D L;F
H T Y L P S F | P T F L S H;Y
C M V G I P U | C G M U I P;V
S H E D N U A | A N D U H S;E
W O I N E L Q | O L N E Q W;I
Z M C I P R Q | C M P R Z I;Q
R Y T W H P V | T V Y P H R;W
I H R C E Z Q | Q Z H C I R;E
Y T S L X H F | S H Y L F X;T
P Z X O H C Q | C P O H Q X;Z
W J F G Z T E | T Z G W E J;F
T V A Y D M S | M D V S A T;Y
E K P N O W I | N O P E I K;W
P Q O E T I Y | T I Y P Q O;E
L W A O M I V | W M O I V L;A
N Z D K B W F | N D W Z K B;F
K L S V J O N | K O N V J S;L
R L K I C D B | D R K B I L;C
B K D V A G I | V D G A K I;B
Y G L Z E P H | Y Z P L E H;G
A G U K X E I | I E X A U K;G
N X R P M C W | R M N X C P;W
Y O K F Q R A | Q O A R Y F;K
K C J O F E T | K F C O J E;T
Q W Y C Z E X | E Y W Z X C;Q
A U Z Q G N M | Z A M Q U N;G
Q D W C T X U | X Q D T W C;U
H P N T V C O | O V C H N P;T
T A X D L Y N | L X N Y A T;D
H M R G T X O | T X G H M O;R
L Z C Q W J K | J C L Z Q K;W
O A J U S B C | U O B A S C;J
X H Z L O S J | Z L S X O H;J
W O R I B G Q | Q G B O I R;W
K W D C A E G | D E G W A K;C
D F Y L G A N | F N D A G L;Y
O H E J C K B | H J C K O B;E
Q N W U F C D | C Q N F U W;D
U F J Y Z H B | U Y Z F B H;J
L S P E R V M | E R V L M P;S
V Q Y P X U A | U P V A Q X;Y
K W Y Z P I M | W I Z M Y P;K
O N I T J H Z | J T N Z O I;H
N R K S M T W | S M R N T W;K
M L C R Y Z V | V Z M L R Y;C
X Z S I C B P | C Z B P S I;X
F X Z T M A O | A T F M O X;Z
J V I R X Y L | I Y V J X R;L
L C A K V G H | H L G C A K;V
J K Y A O B I | O B J A Y I;K
X V Z K R M T | R Z T X K M;V
J T U N S X Y | J U Y S X T;N
Z P U A S B J | J B U Z S A;P
U X T K B Z I | Z U K X T I;B
E N I S A F D | D A N I F E;S
T B G S Y Z H | Y S T Z B G;H
K X O V S D L | V L X O D K;S
F C S O N Q I | C O Q N F I;S
J D L T R V Z | L V J Z T R;D
E C H K Y W Z | C H Z Y E K;W
V X B D A T R | X T R D V B;A
N G C X P T K | X G K N T P;C
N K P A J V L | K J N A V P;L
I B D E T L U | B I E L T U;D
X Q E W D G J | J G D E W Q;X
T C X K H E M | C K E X H T;M
V Q B S C W Z | W Z Q B V C;S
V E S N H U R | H S R N U V;E
X G I N Q W D | X Q G I W N;D
X N I K T P M | N X K T P I;M
O P R W Y Q L | O R P Y Q W;L
L M V I F X P | X L M F V P;I
P J L V Z U G | J V P G Z U;L
S U R G Z W Y | Z R W S G Y;U
F P J Q L W O | W F J P O Q;L
L P U M Z K Q | P Q U Z L K;M
Z P X N S R T | S Z X R T P;N
P E Y U I W G | G Y P E I U;W
C T A X E Y P | T C A P X Y;E
X K Q G V M Z | Z G V X K Q;M
T M W L K Y N | M N L K Y T;W
I V B E H S C | S I H C V E;B
W S U K G A Z | U G W K Z A;S
C F K M T O X | X K M T O F;C
J W O S L U M | J M U S W L;O
E N F Z L M P | M P N E F L;Z
T W E D Y S G | S W T D Y E;G
K V P G A X T | V G P A K X;T
V I T X G K C | T G I V C X;K
P B E X J F H | J E B P X H;F
I X G O P B R | O G P X R I;B
J O X I T Z P | J X O Z I P;T
I K N L C H M | I C H N K M;L
O J M P A Z E | P J E M A O;Z
B W J Z U C T | T C J U Z W;B
L N T V D H U | T U H V N L;D
D B M W S T K | M S W K D T;B
J W B K H E C | J B W C K E;H
U X E D T A V | X A T V D U;E
O Q J D S W G | S O D Q J G;W
V J K F L N B | L F N B K J;V
R L Q D V O S | O V D R L S;Q
D U N Z B W K | N Z D W U B;K
A X Q G D I J | G Q X J D A;I
G Q R Y H Z J | Q G H R J Y;Z
D B X Y T F W | D W T Y B X;F
K L W P C D Z | L P K C W D;Z
F D C J Z X A | X D F J C Z;A
M O P H T C D | M C P O T H;D
N D C I L U E | N E I L C D;U
G M P S R A K | S G A P K R;M
S O H G R J K | H R J O S K;G
E M S Q A H J | J Q M A H E;S
M E Z T O L S | O L M T Z S;E
U Z K I Q C P | K P Z I Q U;C
J S G Q T C P | J S P T Q G;C
H U A Q D K W | U Q D K A W;H
Q J I B K G R | Q J G I K B;R
G O L V Y F Z | O V G Z F L;Y
F Q K M W B H | W B F H Q K;M
M F O N X P H | X O M N H F;P
V H K X J I U | I K U J V H;X
G D X U W Q M | D X U G Q M;W
S G L O B W A | L S O A W B;G
D C N B V H U | D B U H V C;N
C D S M O X U | C X M U D O;S
C N V P H S Q | Q P S C V H;N
F K Q C S I U | K I U C S F;Q
L Q J U X Y R | X R J L Q Y;U
P F J L E I R | I E L F P R;J
J V A I S O W | V W A O I J;S
E S Q F O B R | Q B R F S O;E
A L E P R O I | I P L O E A;R
K U D X N G P | U X G N K P;D
I X C J T M S | J S T X M C;I
Q N S E G D K | Q S N D G K;E
I Y N H E A Z | H Y E I Z N;A
U Y O S L X H | O L X S Y H;U
H U B X J A D | B A H X J U;D
Q W V A F P I | Q V A I F P;W
K M E Z S L J | Z E S M K L;J
D N V X Z I U | X I U Z N D;V
N I P C E Y A | A Y N P E C;I
P L I O Z X J | I X P O Z L;J
O L B Z D V A | V O L A D B;Z
X D L U E A V | V E U L X A;D
R Z J Q G F Y | J F Q Z G Y;R
X Q J H A R I | I Q A R X J;H
F Z T O D E P | Z T F P E D;O
V A D Y G P O | D Y A G V P;O
C R F P A V X | C R F X P A;V
P D R V J F K | D J F V K R;P
O R X I M E P | M X P R O E;I
J D L E A V U | E J L V D A;U
X B Y Z J L O | J X B O Y L;Z
R V T J N F G | T F J R G V;N
C A Y X Z G L | X Z L Y G A;C
I E Q S T N F | S E I N F T;Q
T G H E L D Z | Z L E G H D;T
I E R N O U W | R O W I E U;N
L I R H M Y K | Y H L R M K;I
N I W Z Y S L | Z N S Y I W;L
Y I V J G O W | W Y V J O I;G
N B Z R Y D K | D B Y R Z K;N
K F T V S B J | V S K T J B;F
Y B S D N J E | D S J N E Y;B
O E T M S U K | M O E U T K;S
L V M N Y B I | I B L M V N;Y
Y Q E X G C R | E Y G X Q C;R
K G E P A N H | E G H N P K;A
Z Y A E O K F | Y Z K A O E;F
Q V Z U R D F | F U Z D Q R;V
O A Y N S M Q | S Q N O Y M;A
D I H P B Z U | U Z H I B P;D
N G Q T K S O | G N S O K Q;T
I V E P X A R | I R V P E A;X
N E A I W T J | I E A T W J;N
P Y T F K U L | K U P F Y L;T
Z V C H Y X E | C X H E Z V;Y
P T Z X N S L | P T N L S Z;X
O F A J L T E | E F O L A T;J
B P G S C N X | S N X C B G;P
B D A J K M G | M J A B D G;K
B Y K N I G V | V N B G I Y;K
F C O J X U W | J U O X W C;F
G M L B F W Q | M L F G B W;Q
H L C D K F U | U F L H D C;K
Z R B E X S A | X A B Z R E;S
T J D W L B U | W U B J D T;L
C N F U B V L | B C F V L N;U
W G Y P U X B | B W U P X Y;G
U L W Y P O S | L P U O W S;Y
Z F Q W O G A | W A Z F Q O;G
Q A P S R G Y | G Q R A S Y;P
P H I G O X E | E X H G P O;I
W Q P D I Y B | Y P D I B W;Q
T I C S M J L | L M J S T C;I
T L D R Y G J | T L G R Y J;D
I J Z K N R M | N K R I J Z;M
H W S J R O A | A H J W S R;O
O F W R N V J | R N O J V W;F
T L U F H W N | F W H L U N;T
H E U W O T R | U E T H O W;R
R Z S C U H N | R U N S Z C;H
G Z J O X V Q | Z Q J V X O;G
W V X D Y Q P | P W X D Q Y;V
J G F U W Z E | U W J E G Z;F
X W Y U V O Z | V Z W X O Y;U
J Q G A D H S | Q A G H D S;J
S N K Y M D B | N B M S Y K;D
B L W I A D F | W D B A L F;I
E X W Q H A R | W A X R H Q;E
C Q I S B X P | P Q S X C B;I
V N Z J C B H | J N B C Z V;H
D S N F Q E Y | N Y D E Q S;F
A B T I Y G Z | I T B Y A G;Z
V C I O L D N | O C V I D N;L
R W I A B J S | J I R W B A;S
F D J H N Q O | H J O N F D;Q
K L I C E P Q | Q K C P E I;L
U P V O Y X T | U O P T Y X;V
G P O R K E U | E K U O G R;P
X Q I W T A N | X I A T Q W;N
M G H U N X Y | Y H G M N X;U
H Z N M P E X | E M Z X N P;H
R V I D L U E | L E V D I R;U
X R M O J H Y | X H O R M Y;J
E S A D M X P | E P S X M D;A
U X Q E H K R | E U K Q R X;H
S L K M G O N | S O G L K M;N
I Z U H M W E | H U I Z E M;W
Z B L J C Q Y | Y L B C Q J;Z
A H G C O F S | H F C G O A;S
K Q Y V C S N | K V N S C Y;Q
N C W Y A K P | N C A P W Y;K
R T V C K D O | R T D O K V;C
V E A H Y B W | Y W V E H A;B
W S V L F M J | J V S F M W;L
P N Q G Y V A | G Y N Q A P;V
C G I W X B R | I B W X R G;C
A O T F M H L | O L T A F H;M
W N G B I Q D | N I D G Q B;W
J B V R I C E | C V E R J I;B
V O L B Y A G | V O A Y L G;B
N E D T Z V I | D I T N V Z;E
J H G V Y Q R | V H R G Y Q;J
N Q U L A R W | N W L U R Q;A
J U Q P F H G | U P G Q H F;J
W J L Q T I R | I Q J R T L;W
P U V H S Q T | H V U S Q T;P
A P B Z V Y R | V Y B A R P;Z
U R G Z C X O | Z R C U G X;O
D K G J L I A | D A I L J K;G
P G X C D S A | C G S D P X;A
L C A W J N D | W J L C N D;A
S D B P L U K | S U K P D B;L
F V E D S I J | J D V S F I;E
S R H M A J E | H J S M A E;R
P K E N M Z Y | Y Z P N M E;K
I N Y R A H Z | I N R H A Y;Z
G Z O X K M J | Z X O J M G;K
D R T Q J O U | T O U J R D;Q
S X A J I E K | E S K J I X;A
M S L Y Z H U | S Y H Z U L;M
I K H J F Z A | Z H K A F J;I
C A S R F L Z | F C L Z R S;A
D S U L G H E | S D L H E U;G
J S A T U P B | S J B U T A;P
S P U J D M Z | S D M J Z U;P
Y A R K T F E | Y F A K T E;R
N H I T D R A | I H R A T N;D
F W O R I N M | R W N O F M;I
Y X R I O B V | B R O Y V I;X
I D K X C R A | A I K R C D;X
H S E N M B O | S O H M B E;N
A E N D C S U | A E D N S U;C
Z J Q D R T H | J D Z H T R;Q
A J K R B S D | R D J A B K;S
M G K O S J D | S K J D M G;O
D W I J Z F O | I O F D Z W;J
P C H R O F J | F P H J O R;C
P U J W A S B | B S A W J U;P
T D H L N I P | D T H P L I;N
I C P T U B D | I B U P T C;D
M F O K A D W | M D O W K F;A
A L P Y V X J | L Y P J V X;A
C F I S L Q O | Q L O C F S;I
H G F A S B R | H G B R F S;A
D Q X T M H G | Q X D T G M;H
I L F A Q E Z | A L Q Z I E;F
Z O D W L F K | D L O W Z K;F
P O F H T Z U | P Z F U H O;T
S Q D A U E Z | S D A U E Q;Z
E H R N Y Z F | N R E Y F Z;H
H C P O B K M | K M B C O P;H
P W D Y R B U | Y D W R B P;U
Y C Z E N S V | S Y N E C V;Z
I C W X F Y N | F Y I X C W;N
X W U N S D T | T S X W N U;D
E P W J V Z R | V Z R E W J;P
H G T E L W X | H X G E T L;W
S L B O M A Q | A M S L B Q;O
L U M I T W Y | W U T I L Y;M
W Q B P C R A | P R W C A Q;B
J F P B E R Q | Q R J E B P;F
L H B I W X Y | L Y I W B X;H
Z Q C F N S A | C N S Q A Z;F
G P F B J K Q | P G B Q K J;F
L X T V J P S | S P J T V L;X
G X F Y L Q I | X I Q Y F G;L
L I P Y M H E | H M L Y P I;E
N B M A F C Z | N M B F A C;Z
E L A N G I D | E N L D I G;A
X Q M C E W G | M W X E G C;Q
R M U O S Z P | O R U P M Z;S
M N F T C L Q | L T Q F M N;C
K R L G W X N | G L N W K R;X
N J K I C U D | C U D I K J;N
J F N U Q K I | N K Q I F U;J
L S X C J N V | L X J S V C;N
Y G V W X D U | D X Y V W U;G
C Q E T M V Z | C M E V Q T;Z
Q V Z L M X T | M X V T Q L;Z
X P K U M N Z | X U Z P M N;K
C G V Q J F X | X G Q C V J;F
W Q V T B L F | B Q V W F T;L
U N I L W C R | W C U L I N;R
M G A F U L R | M A L U R F;G
D F O C J V B | J B O F D C;V
I T G X B W J | W I B X T J;G
J K Y P Z X L | K Y L X J P;Z
K T J E N U R | K N T R E J;U
D J V A Z L N | N Z A L J V;D
Q W C M B L F | W M C L F Q;B
V B Y N X J K | B Y J K X N;V
P U S X L G M | M X L U G S;P
B V N O E A J | N E V A O J;B
L V G D I F E | I D L F E V;G
T S N A Z E M | A Z M E T N;S
P I G C W U Q | U Q W P G C;I
X M N K U I F | F K M N I X;U
E D T V O J P | P J V E T O;D
U S D X N C G | X S D U G N;C
N H R Y I E X | X N Y I H R;E
X A C V Y K D | D V A X C K;Y
T S G M E N A | N S A M T G;E
T C S P Q G E | S T Q P E G;C
D Z H T O A G | T G Z H A D;O
W D L A H X V | V L W H A D;X
Y H W U L M Z | H M L U W Z;Y
L J I P C A M | I M L A P J;C
E V N D J A L | E V A D J N;L
W J H P B L X | W B J H L X;P
G S T L U B H | L G U T H B;S
E F I O L T K | O I F L K T;E
W B T D H Q U | T Q H D B W;U
W X K Y L F H | K H L X F W;Y
X O D M T E Y | M Y X O T E;D
N W P U M F C | W P F C N U;M
B U E V Z T O | E Z V O T B;U
O W J M S D C | J M W D O S;C
F T N X M Y V | N F M Y X V;T
G W O F Y C V | O G V F Y C;W
U D I A S V R | I A V U S R;D
F R O Y P M E | E F M R Y O;P
B O V J A E H | H J V E A B;O
I D O K X B L | D L X K O I;B
B Y D W A G L | L Y B G W A;D
I N Z B F X D | I Z F B D N;X
C A K Z B F J | B Z F A K J;C
D R L G C W N | G D L W R N;C
K E S D G N R | S K D R N E;G
Q I O D T W C | T I O W Q D;C
G J I C L N E | I C E N G J;L
F X C B V D K | V F X D B C;K
J A I H E S C | J H S A I C;E
U P Y H F W B | B W Y U H P;F
O G L B J H F | G J H L O F;B
T P A X B I D | A D B P T X;I
E A D Z O L F | L A E Z F D;O
M O E V H I D | O E I D M H;V
Z D G Y T P S | Z Y P S T G;D
L P T Z M Y C | C L P T Z Y;M
H R T P K M N | T K H N M P;R
A E J Q P K Z | Z P E K A Q;J
W X P S F C R | R W X S C F;P
Y D A Z V U L | D A U L V Y;Z
E Q R S W K A | S W Q R A K;E
V U T L N E W | W L T U N E;V
G S Q K P F M | G P M Q K S;F
Q P Y A N C W | W N P A Y C;Q
W V Q L N S P | W P S N L Q;V
D H K T B W I | K W T B D H;I
G I A D X P W | P X A D W I;G
K W I Z P R D | D K R Z P W;I
H I W Y B Q Z | Y Z W B I Q;H
P A Q M U T C | P U M C A Q;T
A N Q Y O F I | Q O Y A N I;F
I K R Z U W C | W C U K I R;Z
O S C V Z T W | C V S W Z O;T
Z W R O X M J | M O J R X Z;W
R W Y T S H C | H W R Y T S;C
I W Z K G R S | K W I Z R G;S
N F I K T A M | M K T F A N;I
U N C R Y O S | Y U R N S C;O
H R G Q W A I | R A G H W I;Q
R K L T I J E | L T R E J I;K
Q A R X M J V | X R J A V Q;M
L Z B N W J M | W L N M B Z;J
H Q M P S Z V | Z P H M Q V;S
C Y D W F A R | R F D Y A W;C
V K M F Z N C | C V N F M K;Z
R Y A S J K P | J A R S Y P;K
D U W P Q V S | Q V P D U S;W
K Y I C Z X M | M Z Y X I C;K
U S I L D C X | C L S I U X;D
G K N R D M W | M D W K G R;N
G S F D O L X | F S X G O D;L
H K T S R C Z | R K S Z T H;C
P F D S K Y B | Y K S P B F;D
Y M P F I S D | I P F M Y S;D
Z W K Y T M N | T Y K N W M;Z
Y G M S X E Q | X E G Q Y M;S
V X L E M D Y | D M L X Y V;E
C Z M S A G V | M S A V Z C;G
X U O A P D W | U A D X W O;P
V H C P M U L | V H M P C U;L
V Z U T G F H | Z F V T G U;H
D Y X U K A G | G A U X D K;Y
T A X G O H W | G H T W X A;O
J D U M A Z I | D I M J A U;Z
Q K W T F C D | D Q T F W K;C
S L Q O R D F | Q O D R F L;S
N R X S I F C | F N S C I R;X
P R V S W Y X | Y S P W V X;R
L Z E P M T V | V T E P Z L;M
L E K O V Y U | Y V L O K E;U
A Y H U Q G M | A U Y Q G H;M
E F D I G X Y | D Y F E G X;I
P A L E C W J | L J A W P E;C
J L H Z C O T | T Z O L H J;C
F H N R E Y O | O F N E R Y;H
J V D L H W Y | L Y V J W H;D
N V Y K F B R | F N R B K Y;V
T L X W E Z D | D E W X L T;Z
T J E C X Q N | E T X C J N;Q
T B H M Y G V | V H B G T M;Y
A I W S D B Z | A Z S I B W;D
G D Z P S L A | G P D A L Z;S
L D G B O Y M | Y L D O M G;B
W Q U L Y V G | Q U W V L G;Y
Y C D K E Q S | Y Q K E C D;S
N Z U L E V B | B U Z L E N;V
H Q L B T U R | L R U H T B;Q
D C B X Q A T | X Q A T B C;D
L N E R J A C | L N E C J A;R
C T H B K J A | C K A H T B;J
J E S M F N I | M F N J I E;S
N D T S R X I | S I D X N T;R
P T A L J K Q | J A K T P L;Q
G W E H F I Q | F W G Q E H;I
R H L M Q Z D | R M Z D H L;Q
D M V K J O W | W K M O D J;V
G J O Z N D Q | D N Z Q G O;J
V A C J R Y Z | R Z J C A Y;V
D N I T Q O Y | T Q D N O Y;I
D A H E I X P | E A D I P H;X
I J Q W K G D | K D I G J W;Q
T G C P W B O | T B P C W G;O
R S D T B L M | S L T B M R;D
C W V Q P K O | K V W O Q P;C
R I Y K T M D | R I M Y T D;K
G W O B A I S | S O I B A W;G
L U B O W T P | B U L W T O;P
V C O P B N I | B N O V P C;I
J D U Z N A T | J U D Z N T;A
K A M S E H V | K S V H M E;A
V B R T F P D | D T R F B V;P
G H Z E M C R | M Z H G C R;E
R E N L Q U C | U E L C R N;Q
I K Z F J C E | F Z K E C J;I
O Q C G A L M | M A Q C O G;L
H K A F W B G | A F B W H G;K
K Q X B Y F R | R Q Y X F B;K
V O D W G I C | D I W O V G;C
S A O V E J I | I E S A O V;J
P J K E U T X | X J E P T U;K
B D U J L V Z | D U B L Z J;V
Y F L T X Q C | Y C L X Q T;F
X D S Q A U I | U S X Q D A;I
Z V L O N G J | J O Z L V G;N
X R P Q H Y A | X Q R H P Y;A
E D X V M T W | T E W X M V;D
K D L H J S M | M H K D J L;S
X M B O Q W S | W M Q O X S;B
L P J N B I Q | B N P L J I;Q
L Y T A U W S | L U T W A S;Y
M J Q N R Z F | F Q Z R N M;J
O V M B H E N | M B H V N O;E
J V E H L K O | L J K O H E;V
T H Y A X U P | Y P A U T X;H
T N Y V K U X | X U K V T Y;N
F P U I J A N | P N U A J I;F
S P T W G D V | W D T G V P;S
R A S J B O M | B M J A S O;R
C O N Z H G L | O G H Z N L;C
U N T B J E S | N T B E J U;S
G C L Z U O X | O G Z X C U;L
M O R W X P Y | W R Y X O P;M
M V O E J A R | M O J A E V;R
J K F O T S Y | S T Y K F O;J
C E W J K P H | E P H K W C;J
Z A U E F C H | U C Z E F A;H
M T L F Z I B | T I B Z F L;M
T D W M K G P | M T D K P W;G
H C V K X J Q | V Q K X J C;H
O Z P R C K N | N C K Z R P;O
D G U C K S E | E C K S G D;U
B L S Y H N P | N L P Y S B;H
K M O J S F R | O S J M R K;F
M V A Z B U G | G Z B U V M;A
R Y G I E D L | L G R I D E;Y
B P R T G W M | R B P W T M;G
E Y I V M Z U | I M U E V Y;Z
Y D X S J G A | S A J D Y X;G
A M X T I E B | X T B M A I;E
K Y G O N P F | Y G O F K N;P
P Y M Z L F J | J P M L Z Y;F
F R H G M D E | D M F E H R;G
H U J W S A N | H S A W J U;N
S G J A W H C | W C J A G H;S
E L Z N B W G | B L G Z E W;N
H J L D U Z O | L H Z U D O;J
S O H W P B C | O S B W P H;C
T D S V Q P N | N D P Q V T;S
H N I A W U O | N H I A U O;W
O Y Z D B M S | Z D S O M B;Y
K O S F A I Z | Z F K S A I;O
S Z C P G A R | G Z A S P R;C
Y F T I N O U | I O F T U Y;N
T K E H W D P | P E W T K D;H
W T A U Q D J | D W Q J T A;U
B K I G D F M | I G D B M K;F
J V D G O W M | D W M G V J;O
H D B Z N X U | H X B D Z N;U
U M Q F I P G | P Q I F U G;M
D R F S V Q P | D F V P S R;Q
W L D R H B Y | H L W R Y B;D
S X V R O E A | A O S X E V;R
O E A H V Y N | H V Y E A N;O
W H R S I K N | N W R I K H;S
X R T W I Q L | R Q T W L X;I
B H M U J N E | B E H M J U;N
H Y E X O D K | E H X K D Y;O
C M W Q V I E | M V C W I Q;E
E B C U X J W | U W E C J X;B
D H J M A U G | D J A U M G;H
M T L O B N Y | N M T L Y B;O
O Y J W M F S | M S F J W O;Y
K Y Q N U L J | Q K L U J N;Y
J I M O T F P | T O P I F M;J
O U H E P C K | U E K C H P;O
H L P D C T G | P L D C G T;H
L Z P R T V W | R Z L T W P;V
J U A D F T I | U J T I F A;D
U D W F H B C | B W U H D F;C
R L G E J U K | E K L J U G;R
A D X R V I L | A D L X R I;V
P C F N I K D | P C I K D F;N
F Y L U O K H | O L Y K H U;F
A H I Z T Q F | I A H Q F Z;T
Y U V N F I M | I F N M U V;Y
N L O J Q S V | V N Q L J O;S
Y W V H U Q K | W H U V Y Q;K
T S O H M G C | S H G T O M;C
R I J B S E K | S E I B J R;K
N U S P J V B | N V B P S U;J
V X F G Q H C | Q C F V H X;G
Z V Y K A X J | V Z J X K Y;A
Q L A G K W M | L Q W A M G;K
P J W E H S F | S H E J P F;W
R A C P H W M | A C W H M R;P
M S L J Z D V | M J S Z V D;L
U H G K C I D | H C U K I D;G
T I W V J U R | R W U V T J;I
A R F J I G Z | G Z I R A F;J
H S D X Y C L | D L C Y H S;X
U H C Y O T N | O N Y U T C;H
H E Y J X O U | E H Y O U J;X
A N E W Z F K | F K Z W N E;A
K M Q C Z I T | M Z Q C K I;T
V G H W X N B | B W X N V G;H
L N X D C S U | D N U X C S;L
S C J L X K N | S N J C L K;X
I O B R C N F | C N R F I O;B
G I R F M K Z | G K R Z I F;M
E Y H B C V T | C V E Y B H;T
A C D P Q Z U | Q D A P C U;Z
P C H T S L O | O C H L S P;T
C J S E X H U | E S U H C X;J
U M K Q D C F | M Q C U K D;F
S U B R A P I | I A S U P B;R
J U P T L C N | U N L C J P;T
P U O Z F G D | Z P G F D O;U
P L W H N Y C | N P L Y W H;C
C L H B A Y K | C H Y A B K;L
A M C X E T U | U A X E T C;M
E U Q I B K H | Q H K E B I;U
R C T H A L X | L A T C H R;X
I N W E X O M | M W N O X E;I
X Q G P Z H W | Z H W G P X;Q
A I K C W X D | C W D K A I;X
V G W T K R A | G A V T K W;R
F X N K Y B J | J F X K N Y;B
L T P U E B Q | T B U L Q E;P
P F D R O Y Q | Y R P D F Q;O
W X B I Y U R | B R U I Y X;W
F I J L R E X | R I J X E F;L
L K X D Q S M | Q X K S L M;D
A J N R U Z V | A Z R N J U;V
H S A U W G X | X W G A H S;U
V Y U P A D S | U Y V S D A;P
F M W E Z B O | W M B O Z F;E
R B G D Z K J | Z D G K R B;J
S Y X V I W D | Y D W S X I;V
Y L R D B H Z | R H Z B Y D;L
H E R V M C U | M U H R C V;E
C X A N Y O F | X A C Y N F;O
O S N L V Z D | N S L V D O;Z
K X D H E A S | S K E A X H;D
M I E T S W F | I T S E M F;W
E O Y P U K A | O U P A K Y;E
Y T D E J M C | C D Y E M T;J
E I A W V M U | A U W I E V;M
M Q L K C A F | K A F C L Q;M
K J R M V L P | L J K P R V;M
Z E T H D G X | H D G E T Z;X
I H G W A X U | U I W X A H;G
R P O U I B T | P T I B U R;O
A Y U R E L M | L R A Y E U;M
K T C G H Z A | C T H A G Z;K
K J H E I X P | X J E P K H;I
W Q S F U V K | U W F S K V;Q
C Y Q I B P N | N Q P I Y C;B
Q F J L Y I O | Y J F L O I;Q
F S E U W K C | F S W K C U;E
T Z E L N A B | E B Z L N T;A
M G Q E H Z O | Q H O Z G E;M
C U H O L J K | U C K O L H;J
J V C T W L G | L W J V C G;T
H X O J G I P | J H O P I G;X
Z F T R P M N | P Z F M R T;N
D X R L G N H | L G D X R H;N
O P G B F H M | M F B P O G;H
J Y V O C H N | Y H J C N O;V
R Z M S C B Y | R M Z Y S B;C
H S I Z Q D K | I Q K D H S;Z
R C N E G Z L | N L R E G Z;C
F Z V X D K A | F Z V K D A;X
D Z K Y E O Q | E Y Z Q D K;O
I C F A E P J | P J I F A E;C
A I S C G E T | E S C I A T;G
S O A U J K G | J K S A O U;G
W N J Z X B Y | Z Y J B W N;X
G O R Y E Q F | F E O G Y Q;R
R E L U I H N | L U I H R N;E
B X W V T I O | V B W O T I;X
W Z X V G A L | W V Z A X L;G
A K O Y B E Z | E A O Z Y B;K
R T M N Z Q K | T M Q R Z K;N
P R E U D L J | E L R U P J;D
U I K R E O D | O E K I U R;D
H E G D J Y A | D G E J A Y;H
L J H I D B R | J R B D I H;L
G C U W T Q P | T P G Q W C;U
X N V B E K Z | E X Z N K B;V
H Z P Q O V J | O P Z Q V H;J
Y P M G O V B | P O V B Y G;M
T X C B R I H | I H R C T X;B
S W V T D J Y | W Y V T S J;D
N V K B Q U T | K Q B U T V;N
E U F Z L A I | I U E A L Z;F
K L S X O Z V | L X O V K Z;S
T Q Y Z G U E | Y G Z T Q U;E
I C T G H M A | M I H G C A;T
Y A S D B I W | Y S I W B D;A
U O M L E R V | U V M E O L;R
N U K B L O I | L B U N I K;O
K D T H Z M A | D A K M Z T;H
E I O K A F L | E F O K I A;L
S U L I W F E | S I W L E F;U
Z B D P C G V | G Z D B P C;V
M O S L K H A | K L O H A S;M
F A J V E S N | S A V E F N;J
H O J D F K Z | K J H F D Z;O
J I G Q A H P | A Q I H J P;G
O V X A M T J | J A X O V M;T
H L X B T G P | H X P T L B;G
I D K P W R F | K F D W I R;P
B R J S F L Y | S L R Y J F;B
J R W V Y N A | R W N J A V;Y
I T L X E A J | J I X E A T;L
D L V K U T B | T U B V D K;L
E P U X Q J Z | U X Q P Z J;E
P R S U J K L | J L R K P U;S
I D K Z F C P | K F P C I D;Z
C Z S U E I X | C I S U Z X;E
K L N B I F A | F B A N L I;K
F K C M T I R | T I R C F M;K
U D M P R B L | M L R U D B;P
F Q A R C K G | A C G F R K;Q
O U H C R V N | U C N R V O;H
K B V Q T O W | K W Q O T V;B
G V N J S X E | E J G X N V;S
L I T R O U B | T B R L I O;U
D F X C R I W | I W D R X F;C
O X B S T E L | E O S L T B;X
E I C R H A K | H A R C E K;I
J R I Z V P B | V B J Z P R;I
R U J H Q K C | U H C J R Q;K
W A U F E X P | A U P W E X;F
Y I U N P Q J | J Q U N I Y;P
W P H V K O Y | O K P H W V;Y
D Y W K E X J | E X Y K J W;D
K R C B H G S | S G H K R C;B
L H U X O C B | L C U B X H;O
A F W L U N K | K N A F U L;W
D W H E M B S | H M D B E W;S
R N C G K Q J | N Q K J R G;C
N Y Q C P S R | C S N Y P R;Q
B U S R K Y G | S U Y B K R;G
Q A O N B L S | L N S Q A O;B
X E O I L A F | L X I E A F;O
C H W K J N R | J H R K W C;N
D P H A I S V | S I D P A V;H
P E M N X K R | P M K E X R;N
O P F E X Q M | X O Q P F E;M
I N M C Z Y V | V N Y I C Z;M
R U S V Z Y N | V N Y R Z U;S
L T K G A I B | G T I L B K;A
D M V Q W G A | G W A Q M V;D
Q A N E I C B | A I C E N Q;B
F J A T N U R | T A J U F R;N
X Y S Q G Z E | Y E S Q X Z;G
R F U B X C T | U B F R X T;C
Q R A K U I P | U P K A R Q;I
Z N G A P F H | N A P Z G H;F
U R W Y C E M | C R U M Y W;E
T M N G O C U | O M T C N U;G
D Q O S L Z G | G D O Q L S;Z
J Q V U H C I | V J C I H Q;U
K G W X P M D | X P M K W D;G
D A S J G E H | E G A S D J;H
O B C H D R W | W D H O C B;R
C S D J H B E | J C B D H E;S
A E N Q T C M | M C N Q E T;A
K D B Q J A E | E B Q J K A;D
J T R B D G K | R J K G B D;T
P C D L B E G | L B E P D C;G
D R M N F B X | X R M B D F;N
R X U J A P O | J O X P U A;R
H K U M L F W | K H M W F U;L
E P X Y I Q M | P Y M I Q X;E
Q N C M R K Z | Q N M C R Z;K
A L V S D T B | B L S D A V;T
O D V X L P T | X P D O V L;T
M O E S V Z G | G M E O Z V;S
P O J U X B E | O X B P U J;E
W X V N Z G L | Z L X V N W;G
P H C Q W N X | N X H P C Q;W
Q Y F L K M E | E L F K Y Q;M
I P K U Y L D | Y U K L D I;P
A Z N T I J P | N P T Z I A;J
K N H D L O G | H N D G L K;O
X P G B Q V U | Q B U P G X;V
J W V E U P H | E P W U H V;J
S Q B G L R O | R B S Q O G;L
Y D V O E B N | Y V B N D E;O
U X G B M S N | S X M B G N;U
M Y R S W P X | Y S W R X M;P
Y I U C H O M | C M H U O I;Y
D G Z W V S X | S G V W X Z;D
N L A T Y R B | B R L A T N;Y
B E D Y T R O | D B O Y T R;E
L O A D C V R | R D L V C A;O
L P K T Y C H | L Y P K H T;C
L T N J D B C | J T N D B C;L
K T J I B F V | V I J B T K;F
R K E W Y H O | E R W O K H;Y
F O H R A C P | R C P H O F;A
F W N C Y R K | K W F C N R;Y
W H X V J I L | J X V L H I;W
T A M L O G V | A V T L G M;O
U M F C K Y A | Y K C F M A;U
L Y B M C R X | X M Y B C R;L
O Q C S T X L | S O X Q T L;C
V M U B X I K | K I M U B V;X
R Q A U N Z D | Q Z R U N A;D
E L G Z C V R | G E C L V Z;R
V M A D N P G | M G N A V P;D
F Z H N G T Y | H G T Z N F;Y
B Z L H X R I | B L H Z I X;R
G Z T D K P I | I T Z P G D;K
G D Z O K V A | A G D K V O;Z
J O E F Q C B | J F E C O Q;B
H M U T S G Z | M Z H S G U;T
S Y X V D A L | S X V A Y D;L
N O A C J G M | J G O A M C;N
T P V L R B E | P R E V B L;T
A N H E X G Y | A Y G E N H;X
T O M J W G C | O M C W J G;T
S J U N I C X | X C U S J N;I
F X T M S J C | T S F M C J;X
P Q R E M D T | Q P D M R E;T
F O Q Z B X P | O Z F B Q P;X
H K O A P R I | H K P I A O;R
M L J N F G K | M G F L J K;N
E P B R H T W | T P B W H E;R
C V E K J W U | C J W U V K;E
F W P O A L H | H L O P W A;F
M R H C B W U | M B R H W C;U
U F Q L B O M | L F Q B O U;M
U O V H P S I | S H I U V O;P
K C H Q M E V | K C E H V Q;M
L R U O M Y S | L R U O M Y;S
K M H W P X V | M K H X P W;V
A D U O F Q E | Q A F E D O;U
A L O G P Y U | A O Y L U P;G
I D M E G J A | I J E M D G;A
P G N C F V J | V G J F C N;P
B U Y L P R X | P R Y X U L;B
E H V C F L B | H F C L B E;V
A N F Y T R C | C F Y R T N;A
P L X S E D A | P D A X S E;L
W V A J L B R | J B A W R L;V
J N B O E W Q | Q N J E W O;B
P O X Z A N R | Z P N R O X;A
Q M Y F N P B | Q N F B M Y;P
Y U A Q H O D | O H U D Y A;Q
O G X J U Z S | G Z O S U X;J
L U Y I T A Z | Y U L I T Z;A
P G X R F C K | P X G C K R;F
T Y J Z C R B | Z B T C R J;Y
F P J V N C B | V C J B N P;F
M Q S T E N Z | M N Q S T E;Z
Z U N O L K C | Z K L C O N;U
E P V X K W B | X P E W K B;V
Z R D A P J I | R P I D A J;Z
Q V U W I C O | U C V I W Q;O
J N K D G S I | G J D I S K;N
U E Z C G A L | C E G L U A;Z
J W O P A L H | L A O H J P;W
N U G I Z V P | P Z I V N U;G
Q T B O F Y E | B O E F Y T;Q
X O P Z D G A | D X G P Z O;A
K N O H V S Z | H S O K Z V;N
X A R D Q K P | P Q K R A D;X
R P I J G X L | I P L G R J;X
P N M R Z L K | P M L Z R K;N
T M P O F Z J | M J P O Z F;T
X B K T U Y R | T U B K R X;Y
I P G E Z Y H | H Z I G E Y;P
R K T P J Z Y | T J Z Y R P;K
R V X J G L C | J X V R L G;C
S T D X O G Q | X G D O T Q;S
U M T G Z A B | Z U M G A B;T
U A P D N M S | P A D N S U;M
D T C R M X L | R T X C L D;M
E G S H I V D | D H I V S E;G
F D R J Y U S | S U D J R Y;F
N B T O D V E | D N T B V E;O
M J E N Z T K | K T J N Z M;E
T W F R J V E | T W R F V E;J
D Z E B Y N I | B Y E D I Z;N
O E W C S T K | T C W K O E;S
B V N H C S E | E B C N V H;S
K T H Y R F B | F H T K B Y;R
B X R S F J N | S J N F R B;X
Y H X Z B N E | Z Y X H N E;B
M O S G F H Y | O H F S Y M;G
P W V Q L F U | Q F U W P L;V
R M T J B C Q | M R J Q B C;T
O S N X F A D | F O D A N X;S
B Q D I W P F | I Q F W P D;B
Z B G M Y T E | M G Z B Y T;E
X P U B S J L | U P S J L X;B
Y H K P C B L | H C Y K B L;P
S F Q X I M V | V M Q S I F;X
G I J V Q H B | H G V Q B J;I
C H S A D Y O | O C S D A H;Y
M C H W X A U | W H X C M U;A
S Y G P U L R | Y R S P L G;U
Z L H O T X K | T O Z X H L;K
G E R C O U X | U E R O C G;X
Z L T M V S H | H T S M Z V;L
Y Q G D O S T | T S G Y Q O;D
I E T K C L S | E C S K L I;T
H Q V K M C J | K M V C J Q;H
Y I C G O A W | G W Y O C I;A
I H D O R L B | O L H I B R;D
V K Y A U D M | V D A Y U K;M
O J A V M N Y | J O A N M Y;V
J G U P K Q Y | J Y K P Q G;U
O Y A Z N U X | N A X Y U Z;O
U M E L X W V | V L E W X M;U
O G E W J L S | S L E J W G;O
I O G J D V M | D I M O V G;J
H I F L K C J | K J I L C H;F
T M L W I R F | W L F I R M;T
M G V U B P N | B N M G U P;V
D X L E O T C | O T X C D E;L
U Y O W Q S Z | Q U O W Z S;Y
S B V Q T E R | E T B V S Q;R
B E I N K M L | M B N L E I;K
Q R O N V K X | V R Q O X N;K
Z O Y T L A G | G T A O Z L;Y
J C H T B A V | A H J C T B;V
F X N E C H M | C X H M F N;E
K E F D A B C | C F D E A B;K
S C V Y N E Z | C N E Z Y V;S
S H K I W Z O | S O Z H I W;K
C J A K Y O S | K Y A O C J;S
C N X G E V P | X V P N C E;G
C J Y T L M U | Y T L U M C;J
P I R Y T B J | Y T R B J I;P
V S Q E Z D R | Z D V Q E R;S
F W D S I N C | D F W C I N;S
D Q P N L U I | P Q L D N U;I
Y D G P R K L | R G L Y D P;K
L M I W Y T O | T L Y O I M;W
T A H Y Q N M | N Y M T Q A;H
K E N I Y V X | Y I K N X V;E
U H S T P B M | S P M H T U;B
R N C S U M Y | S Y R M N C;U
B X F G A L R | R X F L B G;A
O N Y W H K V | K W O V N Y;H
K P U Z V G D | D Z P V G U;K
J U N M T D I | U M J I N D;T
B J S H F V U | B J S U V H;F
W Y X U B J G | Y X J B W G;U
H Q J O G Y V | G O H V J Y;Q
H I G D V O J | H G O D J V;I
K P W V C J O | C W V O J P;K
D J Y V K Z G | V D K Y J G;Z
Z K J N P D F | K J D N P Z;F
G Y S P K N A | Y A K S P G;N
S Y G E R A U | G Y R A S U;E
E X O U W I S | E X S I U W;O
Q N U B K R G | Q G K U R B;N
Z R I F G A B | B A Z R F G;I
R X S B J H K | R K X H S J;B
E F N T V B H | V N B E H F;T
Y C P N E I U | I N C Y U E;P
I Q T R J A N | T N J Q A R;I
Z B C I P O S | S O Z B C I;P
U V D I C M R | R M D I C V;U
M C R W Z Y P | C M R Y P Z;W
Z H J D O K C | C J D K H O;Z
O B T D N C E | O E T N B C;D
J K Y N A C R | C R J K Y N;A
X O N M P B E | X P O E M N;B
R W Z B X G J | B W G X R J;Z
Z T R S D U L | U D S Z L T;R
Y C Z L F R N | N L Z C R F;Y
Y E R X C F M | C E M Y X R;F
H Y T W V C Z | H Z C V Y W;T
O D T K C G N | K O C D G N;T
W B L X U S R | R U X L S B;W
A R T C J M H | A C H T J R;M
M B H J F G O | O G M F B H;J
Q J F T W D O | J T O W D Q;F
U Z X O N T D | Z T U N O D;X
Y M W D Z R G | D M R W Z Y;G
P M J Z S K B | K P Z J M S;B
V E U K P A C | E K C P U V;A
Q B S H R Z X | B Z R X H Q;S
B U S P I C L | L U B S P C;I
X H R N C S A | X A C H S N;R
X N H Q I F R | N R I H Q X;F
U O G B P X R | R G P U O B;X
B Y E V I R K | V R E Y I K;B
M Z Y P O F H | F P M Y H O;Z
O P I F X K W | K P F O I W;X
Z Q C P O G N | G Z Q O P N;C
U F M K L H V | H L U K F M;V
G E M L Z H W | E H L W G Z;M
A M W V I X N | N A W M V X;I
G L X F N M U | L G M U F N;X
O U L D Q I W | U L I Q O W;D
P C N L X I V | X N L I V P;C
G R M O T N V | M R V O N G;T
P K W H F V S | V F W P H K;S
C B G F K Y J | G B J F K C;Y
W A M N E K X | M K N A E X;W
K J Y I H G N | G K H Y J I;N
Q J E Z D C I | D Q I E C Z;J
J V B Y S U H | J B V S U H;Y
N W O V A I S | N O W V A S;I
W L K R D Y B | Y W B D L R;K
N M E B K Q I | K M N B I E;Q
N D V Z W Y J | V N D Z Y W;J
H B U J I E C | B U J E H I;C
N E Q U F T C | Q T U E C F;N
M W H I Y F A | M I W H F A;Y
X N L E R Q Y | R Y X Q N E;L
V I J L F P U | F U J L I V;P
A E Q W M V Y | M Q A Y V W;E
M P E F I B W | B P I E M F;W
Q P X G M O T | P G O X M Q;T
S H Y B G D Z | G Y H S D B;Z
Z K T H M E Y | H T Y M Z K;E
V G F P H E N | G N F H E P;V
C A S Y H O Q | C A Q S H Y;O
Q K L T U F S | F T S Q U K;L
Y G C Q S L U | U L S G Q Y;C
A Y C F D M E | D F Y C M A;E
I F J L T C S | F I S J L T;C
O A M I U H L | L O H U I A;M
M G K I O R V | V M K G O I;R
K C Q I D N S | N K Q C S D;I
X M L I J F P | L F I J P M;X
L C O S N Y Q | S Y N L C Q;O
U R K L J S P | L U J R P S;K
S I G W K T O | T K S O I W;G
Y C Z T O A V | A T C V Z Y;O
L P I U O T E | L U I T P O;E
O A I Z S D R | S R O D Z A;I
T M E X O C R | X R T O C M;E
C Y I E G N R | G N C I E R;Y
V C M K Y S P | Y M V S C K;P
P N O M X I F | O X F P M N;I
W F Q X B I J | W F B I J X;Q
O M X A N G T | X M A N G O;T
R K O V B U I | U R B V O K;I
U O Y Q K Z X | O Y Q K U X;Z
T C X N Y E M | C X T Y N E;M
K Q X O Y D R | X K R Q Y O;D
N H X Y J P K | J X H N Y P;K
E J L B Z T V | J B Z L T E;V
U K X Q O T R | T R X O Q K;U
Y N M T Q D A | N M Y A D T;Q
E F K A Y M Z | E A K Y F M;Z
V G R N A U C | U A R G N V;C
Q D T M F V A | A T D V M F;Q
Q O B G T R M | O T G M R B;Q
F U R C T N J | J F U R T C;N
R U B Q Z P O | R Z B Q P U;O
K F E M Y S A | E A M Y K F;S
B R F P S T G | G R F S T B;P
R P U X N L A | L A U X N R;P
L J S Z F B V | L B J F Z S;V
S U J X E Q A | E S X J Q A;U
A K I Q T R H | I A K T R H;Q
H S A D J I C | A C H S D I;J
Z T J L R U O | T J Z U R L;O
Z O H C J N F | J N F O Z H;C
A C G M S I T | M T I C A S;G
P M U N S L H | P M N U L H;S
E B N X D O Z | E O D Z X N;B
C A L X G V S | V G S L C X;A
L W U Y H F I | W L H F U I;Y
R B M G D J E | E G B R D M;J
O V S G Y C K | Y V S K C G;O
Y W Z P G R H | Z R Y W P H;G
R X Y H D E M | M Y X D E H;R
Y N F G R U D | U Y R N G D;F
G T X W P A O | G O X W T A;P
N E S J Q V K | E V S J K N;Q
S H K W M E F | F H M W E S;K
D F O H R Q C | F H Q O R D;C
Z S Q H Y P M | H Y P Z Q S;M
E H D F L B O | O B E H F L;D
I J L E P R U | E R I J L U;P
J C P E S X W | C E P X S J;W
U L X H O Z W | Z X W O L U;H
S E G L P T B | T B G L S E;P
M P A V F N X | N P F A V X;M
T D R V O B L | L D R T B O;V
S H N F L V B | H B F L S V;N
U R F A P J X | A R J X P U;F
O N Q J I C E | C J Q I O E;N
Q O C D G E R | G R O D C Q;E
Y G A L E D Q | G A D E L Q;Y
E R X Y H C J | Y X R H E C;J
X J W S D P U | X S J D P W;U
C O I B E R Z | Z R B E I O;C
B J X C W H L | W H C L X B;J
R G J W Z P L | P L G R J W;Z
A L S P Z D R | Z S D L R P;A
L D W U F X H | D W F L U H;X
W D F X T E N | N W T D F X;E
J Z I H R V K | V J K H I R;Z
T P D H Y R E | R E D T P H;Y
M T J O A P Q | O A P Q J T;M
Z B S D E U P | B D U P E S;Z
D N T J X I P | D I J P X N;T
R L X S N C W | L R W N C X;S
H G Y D C J N | H C D N J Y;G
B S V A I L H | I H B V A L;S
P O C U K D A | U P A O K C;D
U T Z P F M Q | F Z Q T M P;U
K N W X P D F | N X F K D W;P
Q L Y V K E N | V N Q E Y K;L
Y W T O P I Z | Z T P I Y W;O
O J G E M Y N | E J M Y O N;G
J Z H T A R C | J R C T A H;Z
X C I O F U H | I U C O X H;F
I J Q R L Z H | J Z R L I Q;H
W F L D S M P | W S D L M F;P
R L U D A N E | L A R U D E;N
A U Q V L O W | V U Q L A O;W
Z G P L U Y S | P S G Y L Z;U
C M A P L O K | P A O K L M;C
E N A P F D C | P C N F D E;A
Q T N X S U K | T Q N X K S;U
O E D K M S C | O S K D E C;M
C T A E P U Y | T Y P U A E;C
I D X R V M H | X D I R M V;H
O V Z C R A T | O R Z C A V;T
U F O B D W L | B D U L F O;W
X M O T A K J | O A M J K X;T
S C J U T E F | C J E S T U;F
R F G T N E X | N X F E T G;R
G K E D J Q M | Q E G D K J;M
R Z T E N D Y | E R Y N T D;Z
A H N I Y F V | Y V I N A F;H
G B Q T I W J | T Q J I B G;W
A U D Q B R H | D A U H Q B;R
X E J U Z B D | J D X U E B;Z
L I Y H D X B | B H L Y X I;D
T Y K L Q E O | T O Q Y L K;E
O K R J E B T | J R O T B K;E
X E Y I S T G | E X S I T Y;G
N I Q E R H B | N R Q I B H;E
B Q W Y N O Z | N W B Z Y O;Q
F Y P U G E H | F U P H Y E;G
I P F O S W A | I O A S P W;F
M K D Q B G I | G I D Q K B;M
L N Z B R C J | J L Z C N R;B
C K O V T P F | P F K V O C;T
E Y V O H T Z | H O V Z E Y;T
I P S W L B Z | P B L I W S;Z
R A P N F E T | A E F R N P;T
W O C S I R A | I W C A R O;S
Q L G T D E R | E L Q D R G;T
L A C J O I S | L I S A O C;J
S N F C K Q E | Q E F K C S;N
O F U Y W R P | U P F W R O;Y
I X H M B A S | X M I A B H;S
Z P D Y U S L | U L S D P Y;Z
K A C X H N B | K B N A H X;C
E Z U Q J G N | E U G Q Z N;J
P E L B D T R | L B R T P D;E
X M K U Z B G | G X K U B M;Z
A E O K H N M | A H M N E O;K
E I H R B C U | U C I R B H;E
X E T B W S Z | S E W B Z T;X
R I Z L N D K | I K D N Z L;R
D G U V B L N | G N B D V L;U
A T J I K X B | T A X K B J;I
Y E H Z O P G | E Y P G H O;Z
A T N J I F D | T J D A N I;F
U L K Q F A Y | Q U L F Y A;K
W O L G A U T | G O U A L T;W
B U M I Y H T | I B Y U H M;T
A C Q K B U V | B Q K V U C;A
T F W R A O G | O F G T R A;W
L G X Q W Z R | W G R Z L X;Q
V I Z H J N U | H I V U J Z;N
N M I C K R A | C K A I M R;N
G S B E Y M I | B M G I S Y;E
W B T O K R C | K W T C O R;B
Q P J D E M H | H J E D P Q;M
P H T W A R V | T H V W P A;R
D R I F M Y P | P F M R D I;Y
L J W E Q S U | L E W U Q J;S
I U S H Z V F | I U Z V S F;H
Q L K R B U T | U Q R T K L;B
U B T M V J S | S V M J B T;U
B Q Y J P R A | J Q R A Y P;B
W N F Y M I U | F M U I W N;Y
B K Y F X M I | K F I M X Y;B
N T E M V D H | E H V D T M;N
A N H V S J O | N H J A O S;V
C W Y X R L S | L R W X S C;Y
F Q B A Y I P | F A P Y I Q;B
O P Y F C W J | F C O J W Y;P
E A X M D N L | D M N X A E;L
B R H V K S M | H K R V B M;S
Z X V K N R S | R K Z S V N;X
Z C P D U B Q | C B Q P U Z;D
W C S G T K F | K S C G T W;F
W C H S T M R | R M S H C W;T
F T E J L W D | L T W F D J;E
Q W H V Y T M | M T W Y V Q;H
I Z L T E Q N | N I L T Q Z;E
C X S R E J L | C J E L X R;S
G H E Y O D A | E Y D O H G;A
X Z Q I E K P | Q I Z K X P;E
