R F Q P H | H P F R;Q
U X R L N | R X N U;L
M Y L R B | M B Y R;L
T U F Z G | T G Z U;F
N Q Y X P | Q Y X P;N
A U S R K | U A S R;K
X P G N Z | Z N P X;G
J S T D N | J D N S;T
Q L X O K | X O L Q;K
W F V I K | K V W I;F
E W I T J | E T W J;I
B N R I O | O R I N;B
U Q T Y V | T Y Q V;U
E T Q U X | E X U Q;T
F M S V Z | F Z V M;S
T Z L M I | Z M T I;L
E G K A M | M E G K;A
E B X S W | E X S B;W
S B O V I | V O S I;B
B F X G O | G X O B;F
I B J S L | J L B I;S
U C L H Q | H C U L;Q
J F M T P | J F P T;M
N L E Q G | G Q E L;N
O K L D C | L K D C;O
O I Y F D | Y O D I;F
I R O T P | T O R I;P
I E T V A | A T V I;E
Q J X T R | T R J X;Q
V G K N Z | N V G K;Z
D O G R M | R D G M;O
Q M W V T | Q V W T;M
J F Z C V | F J V Z;C
K Q C P X | C X K Q;P
I C V S K | K I C S;V
W P R C L | R W C P;L
N C G L S | S N C L;G
G P H K I | G K P H;I
O D Q N R | Q O R D;N
A I R E V | I E R V;A
P J F T N | N P T F;J
I Y O U Z | Y U O I;Z
G D X K S | K D S X;G
H A X F C | C F X H;A
F I G N S | F S G N;I
Q E R O M | M E O Q;R
I Z M K B | B I K M;Z
N F Y M V | F M Y V;N
L P O Y F | F O L P;Y
C N H O K | H N O C;K
D I Y J U | Y U D J;I
J H M G F | M J H F;G
G C O N J | J N G O;C
R W D F N | N D W R;F
L S Q R O | O Q L R;S
D H K Y P | K P D Y;H
T Y W C G | C T Y G;W
W B P J F | W P J F;B
C Y V F G | G F C V;Y
R B V H Z | R Z H V;B
C H W U L | L C W H;U
A W B Y S | A W Y B;S
V K Z R P | R V P Z;K
E I U N H | U N I E;H
F H D T Q | D H F Q;T
Y T H O P | O Y T H;P
M K V W Z | Z M W K;V
L F V W O | L V O F;W
O H D R L | L H D O;R
T M J N V | M J N V;T
L H G X O | X G H O;L
A J Y N T | Y J A N;T
B N D H Q | D Q N B;H
Y C V S M | S C Y M;V
R G S H A | A S H R;G
K L P G H | P K G H;L
U S N B A | S N A U;B
D O W T Z | O Z W D;T
U G K W Z | U K G Z;W
O Y H Q D | Q O H Y;D
C T Z Q S | S Q T C;Z
G H A W D | G A D W;H
H G U C J | J G U C;H
C A P X O | C P X O;A
Q O Z I J | I Z O J;Q
O S Z E Q | S E O Z;Q
U B C Z M | Z U C B;M
Q Y L N F | F Q N L;Y
H J S U K | H K S U;J
G U I H Y | G I U H;Y
G W M A Q | Q A W G;M
M J Q T D | J T M Q;D
I E B W Y | E I W B;Y
N I B F R | R F N I;B
P G Q U F | P G U Q;F
D P Q R E | E R D P;Q
I Q L T U | L I U Q;T
U B D O Z | D Z O U;B
D G O E B | B E D G;O
C R N X H | N H X R;C
D A H W L | A H L D;W
A M R X N | R X N M;A
O P J N M | N P M O;J
V B Z P Y | B P V Y;Z
W F Q I Z | Q W Z F;I
L D Q M K | L D K Q;M
G X K T V | G X V T;K
B U M G Y | U Y M G;B
C I V J Y | I V Y C;J
A Q W R F | Q A R W;F
Q B Z M W | Q M B Z;W
P G R Y K | G K Y R;P
Q W H Z E | H W Z Q;E
Q K N D E | K Q D N;E
R P B A D | A B P D;R
B Q M V K | B Q M K;V
J L U R T | U L J R;T
U P D B Q | B P U Q;D
C Q H A S | C A S H;Q
R T B E V | T E B R;V
N Y D W R | R N W D;Y
Q I O J P | I P J O;Q
F Y O K A | K F Y O;A
N Q V K P | K N P Q;V
V B W P Q | Q W P B;V
B R U Q E | E R U B;Q
L E A N D | L A N E;D
Y J V Q O | O Y Q J;V
R U G S O | R G U O;S
D Q G N W | D W G N;Q
B D Y O W | D B Y W;O
R E M Q Y | M E Q Y;R
F O W I N | O N W F;I
O Z H K T | H Z O T;K
L Z E X M | L E M X;Z
W C D P E | E W C P;D
F E P V S | V P F S;E
H B Q U J | J B U Q;H
S J Y V F | F Y S J;V
P D H C W | C D H P;W
W E R Y Q | R Y W E;Q
V T Z S H | V H S Z;T
T B L O A | O L T A;B
Q W D I Y | I Y W D;Q
J T F O V | T F O V;J
X E F O I | E X F O;I
H I X B C | X B H C;I
X S R B I | I B S X;R
L M S A G | L M S G;A
R N L G K | K L G R;N
L X M H I | H I X L;M
L B Q E O | Q O B E;L
X M O L I | I O M L;X
G M L P R | M L P G;R
B V H I G | G I V H;B
J Y F K H | Y F K H;J
Y X E Q K | X K E Y;Q
C A R I M | M R I C;A
E P X O G | O G P X;E
E W G I X | G E I W;X
B M C X G | G C B X;M
G P E Y M | G P Y E;M
M V U C F | M C U V;F
X P W A G | W G X P;A
M A X Q C | Q M A C;X
H E L I Z | I Z L E;H
S F Z N J | J S N F;Z
E R L N V | N R V L;E
M Y B E G | G E M Y;B
E N S B F | B E F S;N
W X P A E | A E W P;X
V X S K T | X T S K;V
A D V T C | V D C A;T
V M U J N | N U J M;V
B N D C F | F C D N;B
D E R G N | R E D N;G
K U P D J | P K J U;D
C N X L V | N V X L;C
M J I D W | D J M I;W
C I O E P | P C I E;O
G B H Q U | Q G B U;H
H V U I F | H U F I;V
E W R I F | E R W I;F
K Y P C U | U C P Y;K
X Z F K Q | F K Q X;Z
R Y X H V | V H Y R;X
G U O N M | U M N O;G
B S Q M A | M A Q S;B
R B E X U | X U R E;B
M F C G X | F X M G;C
X D H B L | X L D H;B
Q U L O R | U R L Q;O
Z L H C S | S H C L;Z
P D R N X | D N X R;P
L T D W R | L W D R;T
N Q W H C | C H N W;Q
E I G S Y | S I Y E;G
X P E C I | I C P X;E
S M E Q R | M S Q E;R
T W V H Y | Y H T V;W
W C F L O | W L C O;F
C V O M F | F V O M;C
S J K X N | X K S J;N
K B H R P | K P H B;R
E D R W X | D W E X;R
I P C T O | T O C I;P
O R N K E | R N O K;E
E J C P K | K J P C;E
M F A T K | A K T M;F
N U F K A | U K N A;F
S P H N O | S H O N;P
Y X H D P | H D X Y;P
Q W G M A | A W G Q;M
I J U B V | U B V I;J
T Q N X L | T Q N L;X
G W B E O | W O B G;E
T W H E M | T H M W;E
K H I Z V | K V H Z;I
G H L M Y | Y L H G;M
D N I E R | D N I E;R
T F O W X | X O F T;W
K A D S Z | K A D Z;S
Y C Q B N | Q Y C N;B
R H B X C | H X C B;R
I N C L J | I L C J;N
H J O D K | D K J O;H
Y B F O L | F Y L O;B
S U W H K | K H U W;S
Y O J P X | Y P X J;O
O P B A L | A B P L;O
B G I U J | U G I J;B
G K J A S | J A S K;G
U J K Y O | K U Y J;O
L G Q U R | G U Q L;R
T M H G E | G M T E;H
E C D P F | P E F C;D
O V N X T | X T V N;O
M U Y Q I | I Q U Y;M
F V Q W K | Q V F W;K
N I H T X | N X T H;I
U Q Z X N | N Q U Z;X
K S L A R | K L S R;A
T P V Y H | Y P H V;T
A W J C F | C W J F;A
N I G M Q | I Q N G;M
W Q N A G | G N A Q;W
M L Z B K | M L Z K;B
S W Z K F | S F W K;Z
A T O G S | A G O S;T
W Q X Z G | G X Q W;Z
A J F C E | E C A J;F
W V M I X | X M I W;V
J B M D T | M B D J;T
B D C G K | B D C K;G
Z R B K N | B R N Z;K
M T U Y F | Y T U F;M
S W P F N | F N S W;P
X H C Y R | X R C Y;H
X B E M R | E B M R;X
L U T F V | F T U L;V
F R Z E V | V F R E;Z
O D Q X R | X Q D O;R
N V M L K | M N L V;K
O P N M S | M O S P;N
P E H I R | E R H I;P
Y Z F J M | Z F J M;Y
Z A C W K | K W Z A;C
B X C W F | W X B C;F
X Y D Z F | Z D X Y;F
D U J G V | U J V G;D
C K P M X | X P M K;C
T J E C U | C T E J;U
P B D Q F | F B P D;Q
F V O B E | F V B E;O
J P H F T | H P F J;T
Q I J U F | J F I Q;U
I X L G K | L K G I;X
L F B N Z | L B F N;Z
Q G K B R | K G B Q;R
S M R H Q | Q H R M;S
N B H E L | B H L N;E
R K Z E H | E K R H;Z
K R Z D U | U Z R K;D
U E C P Y | C E P Y;U
P Y U T N | P T N U;Y
C J L G R | J R C G;L
B O A D T | A O T D;B
J O R N D | N O R D;J
E W A G Y | W G Y E;A
F L C Q H | L Q H F;C
Z Q L I N | I Q Z L;N
D I C J U | I D J C;U
L C A S U | A C U S;L
B Z J P Y | Y J P Z;B
B K Y F J | F J B K;Y
W I S Q T | W I T S;Q
Y U R A Z | R U Y Z;A
E C S R Z | E C S R;Z
E U X L K | L X K E;U
T E A Z M | T A M E;Z
W A B Z Y | A Y Z W;B
M I Y O R | Y R I M;O
C S B A W | C S B A;W
Q Z K X Y | Y K X Q;Z
A I N V O | I N O V;A
Z V Q I B | B V Z Q;I
E Q A Y P | E A Y Q;P
A N D H Z | N D A Z;H
O G J S Q | Q S O G;J
I Y N U K | K I U Y;N
I V W D A | V W I A;D
D J N Z A | Z A N J;D
U O C W R | R W U C;O
H K U Y J | H K Y J;U
O H S T R | T H S O;R
P R M Y A | A Y R M;P
L G W F P | L G P F;W
V Z K O F | F O Z K;V
F X N H C | C X N F;H
B F E X Q | B X F E;Q
F S X R E | F X E R;S
X C W K F | C F K X;W
L N S J K | J L N S;K
Y H Z C S | C S Y Z;H
P W S J N | W N P J;S
S G O A U | A U G O;S
G Q H W S | G W Q S;H
J S U L Y | Y L U J;S
X H C P F | C F X H;P
V C I G P | I G P V;C
A H F V S | V A H S;F
Q U G P F | P Q F G;U
R G C K Y | G K Y R;C
M L I Z X | X L I M;Z
I B T E O | B T I E;O
P G V T M | V P G M;T
M S U R Y | S R Y U;M
E C G S X | C E X G;S
J A S X Q | X J Q S;A
S C P Q R | C P Q S;R
F Y I K B | F B Y I;K
K E W N X | E N W K;X
D F G Z I | I F D G;Z
Z L I N J | Z L J N;I
X T K C J | J K C X;T
G D P Z T | P D Z T;G
T C U G Y | G C T Y;U
U Z B E G | E Z B U;G
B V H N D | V B N D;H
E T A J B | A B T E;J
T A V R G | R V A G;T
C K V L A | K C V L;A
U W G C Y | Y W U C;G
C R A W E | E C A W;R
X C B S M | C X B M;S
A Q N E L | L Q E N;A
K C Y Z M | K C M Y;Z
S C P I W | W P I C;S
K G Z I E | Z G I K;E
M O N T G | G M O T;N
E F C L O | L O C E;F
K V U C G | V K G C;U
H C B Z E | H E B Z;C
N I S L Q | Q I N S;L
S H P M Z | M H S Z;P
C J T E R | J R T E;C
W B M L I | L B I M;W
N Y F W V | W Y N F;V
E T P H S | H T P S;E
F U G Z D | U G Z D;F
C O B Z G | B O C Z;G
W F R Y N | W N F R;Y
Y X G E A | G X E Y;A
S L E J M | L E M S;J
K F Q J C | F J K Q;C
T X F U W | T U W X;F
D E L V F | E D F L;V
Q O K I U | I K U O;Q
S J D O Z | J D S O;Z
F H Q S A | A Q S F;H
F O N R D | D R N O;F
J N I U P | N J I U;P
G F E S A | A E G F;S
R E O G Y | R O G E;Y
G J N S Q | N G S J;Q
J C U R H | J R U H;C
B N O H Z | H O B Z;N
N C A F V | F A N V;C
F O Z P H | P O F Z;H
C O T N H | O H C T;N
P S E D U | U P S E;D
S O K E W | E K S O;W
L N F G Z | F Z G L;N
G D F J K | F J K G;D
R X B A Q | B R A Q;X
G V T L B | V G B L;T
A C Q I T | C Q T A;I
Q D H Y G | Q D G H;Y
V X U E Z | Z U V X;E
R D L M T | R M D L;T
F Q I R B | B R Q I;F
E O F D R | E F O R;D
X M Y R P | P X M Y;R
H M W V R | V H M W;R
T M Z G V | G T M V;Z
G F S Q M | F Q G S;M
Q L S V N | S Q N V;L
J D R S X | R D X S;J
B C X E T | E T C B;X
V K Y M S | V M S Y;K
M K J U E | E U J K;M
F E B K J | E J F B;K
C A F H N | H F N C;A
D C R M S | C D M S;R
Z Q U B J | U Q J B;Z
G W I O Y | O Y I W;G
T U W A K | W U T K;A
I X R G K | I X R K;G
H P U Y I | U Y I P;H
V Y Z E W | E W Z Y;V
T D Z Y E | Z T Y D;E
U B J X M | X U J M;B
R G C F X | G F R X;C
O S X C L | L O C S;X
Q G R H D | H G R Q;D
L A H B S | H B A S;L
E C Q B T | C T B Q;E
S W K N Y | S N Y K;W
T U X Z B | Z T U X;B
E K B L A | B E A L;K
E R H D G | H E D G;R
B Y D K O | B O D Y;K
X D K Y P | P K Y D;X
J Q L A P | Q A L P;J
W H Y Q U | W U Y Q;H
A O R K L | A R O K;L
A N D Q M | N A D M;Q
B D E O P | B D E P;O
I M U V J | V U J M;I
P Y T K I | K T P Y;I
P W B U H | U W H P;B
H Z E L J | H E Z L;J
P J T V Y | P J Y T;V
C Y H Q G | C Y Q H;G
W I P D C | I D W C;P
Z G E F Q | Q Z F G;E
I C S F D | C I S D;F
V R A Q X | A V R Q;X
C J E A G | E C A J;G
S T F V R | R S T F;V
R A W K E | E K R A;W
F P A Z I | P F Z I;A
Z O P J U | J O P Z;U
A F U N Z | Z U N A;F
S T K L W | W T K S;L
X R P E M | E X M R;P
K E V I O | V K E I;O
N P O W G | N P O W;G
N C J X G | X C G N;J
F N Y I L | F I L N;Y
Q R P H X | P X R H;Q
O U P D G | O P D U;G
K X Q Y L | Y L X K;Q
H C R F J | F R C H;J
Y Z D H O | Z H O Y;D
P T X V O | X T O P;V
O S X Q U | X U S Q;O
N V T F B | V T B N;F
W J B D N | J D N W;B
J T Z U D | Z D T J;U
E J H F A | F J H A;E
Y T P I K | I P Y T;K
Y C A R L | R A Y C;L
K S H F M | F S H K;M
W G O S R | W S O G;R
U G Y I Q | Q G U I;Y
L H B P S | H B S L;P
N M R T V | M T N V;R
G I K B F | B I G F;K
T Z O C Y | O T Y Z;C
J E V R I | E J V I;R
B H N A Y | N H Y B;A
P U Y L H | Y L P H;U
D F M L O | L D O F;M
G B F S O | F B S G;O
L H A Y U | H L A Y;U
R F K W X | K X R W;F
K P Z W R | P R Z K;W
E W P B U | P E B W;U
J G R Q Z | Z J Q R;G
P L B R W | W R P L;B
R C I D L | D R I L;C
Q L F E W | F W E L;Q
I D O U V | U I D V;O
N G T W Y | W Y T N;G
B C F V X | B X F V;C
M Z C N K | Z K N M;C
S M G C D | C D G S;M
B T Y D P | Y D P B;T
F L P Y W | P F L Y;W
E C H Z N | E N H Z;C
H B G M J | B G H J;M
Y R D U C | D U C R;Y
H I Q O J | J I O H;Q
H T G K B | H G K T;B
T J P H E | P H E J;T
C M Z D N | N Z M C;D
D L N P C | C D L P;N
S W M U G | U G S M;W
F Q O L P | F P Q L;O
Y J V B F | V B J Y;F
X Q T P Y | Q X P T;Y
K N B Y D | K N D B;Y
I L T V Z | Z L T I;V
H R S N F | N R F S;H
Q K R F X | X R Q F;K
S E Q G I | Q I E G;S
L N W C Q | C Q L W;N
G R Z T D | G T Z D;R
R Z X V D | V X R Z;D
R Y U F H | H U F R;Y
I X D H E | D X H I;E
J X W E Q | E W J Q;X
O J C Q U | U O Q J;C
B D R T W | R D B W;T
R H M C E | H C E M;R
M G E A U | E M G U;A
H I E P B | B I P E;H
N X M A H | N X M H;A
R U T N W | T U W N;R
W M R V F | F R V W;M
V G X W Z | V X W Z;G
O F A Q L | F Q A O;L
X Z R D P | D P Z R;X
E N T J Q | E J N T;Q
Q H N P R | R H N Q;P
B S E W J | E J W S;B
I P O J F | O I J P;F
G Z S I B | Z S G I;B
L R U F T | F T L U;R
B R D E S | D E R B;S
W S F O C | S O C F;W
U C F P R | P C F U;R
Z V F K O | V O Z F;K
A I S J O | J A I O;S
N C Q G A | Q C N A;G
Z S A D O | A S Z O;D
H U N E V | V E N H;U
A D P Y M | M Y P A;D
J Y G M H | J G Y M;H
R S B N H | S N H B;R
Z A K U P | A K U Z;P
K W F O C | K C F O;W
B V N U D | D B V U;N
W N E D K | N K D W;E
M X B P K | B M P X;K
V J N H X | J X V H;N
M A C O U | O A U M;C
E O J H F | E O H J;F
L E H Y N | Y L N E;H
O M A C W | O A W M;C
Z K U Q N | Z Q U N;K
O B J R H | R H O B;J
M K T P Z | P M K T;Z
Y U W D V | V U Y D;W
G F K J M | M F K G;J
Q C U O I | Q C U O;I
A P B T J | P T A B;J
C M R W N | C M R N;W
F R S O H | O F H R;S
S C H Z N | N C Z S;H
V G H X R | V R X H;G
Y U D K Q | D Y Q U;K
L P E U C | E L P C;U
P Y Q T N | Y N P Q;T
D Z X H B | B Z D H;X
K I B Z T | I K T Z;B
W U O C X | W O X U;C
R A C E X | A X R C;E
K L Q E M | K Q M L;E
R A M E B | B M A R;E
F J A V W | J A F V;W
O Y D E Q | D E Y O;Q
M L C Y U | M L C U;Y
M Z R V O | V O Z M;R
R T M B A | R M A T;B
F P J G Z | Z J P F;G
T L D V C | C L T V;D
B T Q Y X | T Y B Q;X
Z P A N F | Z A F N;P
J O Y S P | Y S J P;O
K H V R J | K V J H;R
O H N V R | H N V O;R
V I X M U | V I M X;U
Y K S X B | S B X K;Y
Q D J F W | J W Q F;D
N B A U M | N M U A;B
Z S U Q N | S U Z N;Q
J O G Y U | J Y U O;G
A K E Q U | Q U A K;E
B R O K E | K O E B;R
R U G P C | P U R G;C
U R J V I | U J V I;R
M X T U Y | X T U Y;M
O L B A X | B L X A;O
Q R L V S | V Q L R;S
F N H K C | F K H N;C
F T I X U | U X F I;T
P S O Y J | P O Y S;J
T V K B X | B X K V;T
L Q E W A | W E Q L;A
S C Q N K | S C Q K;N
Y P M D H | D P M Y;H
O U K R L | R L O U;K
V G J S Z | V S Z G;J
S M W R H | R S H M;W
Q M S J E | M E Q J;S
X F G D I | F I X G;D
J Y D T G | Y G D T;J
F B U E W | U E F W;B
F R T V W | T W V R;F
K Y I G B | I B Y G;K
U C X T L | U C L X;T
B H O L S | O B L S;H
Q P M X V | X P V M;Q
E D R P H | D H P R;E
R U W L Y | L U W Y;R
B O C A I | A B I O;C
K V S Z C | K Z S V;C
K X S O P | S O P X;K
N J D C O | N J D O;C
U B H X Z | U Z H B;X
B D A K L | D K L A;B
X H L B S | S H L X;B
U Z G Q J | U Z G J;Q
X N E G B | G E N X;B
D J W S P | J P D W;S
M E K G S | K M S E;G
S X J A H | A X S J;H
T C Y X Z | Z X Y T;C
G W M H L | W M L H;G
A S B T Z | A S T B;Z
F T J Z P | F J P Z;T
T S F M O | T M O F;S
B K F T H | F T H B;K
N M Y K O | Y O N K;M
C V J E G | C V G J;E
K P V L F | P L K F;V
S X H T O | X O T S;H
X S O H M | X M H O;S
X K F E O | F E K O;X
N I R X B | N R X B;I
O I W E F | F O E W;I
D Q E O K | K D O Q;E
B Y Z I L | L Z I B;Y
Q A E F I | F I A Q;E
O T E I B | T O I E;B
R Q U D Z | U Z Q R;D
R A V I E | R V A E;I
U Z T M Y | Y Z T U;M
I M Y N L | N L Y I;M
C O X R F | C X F R;O
H R J O A | J R A H;O
Z K A G X | G K X Z;A
M O W K J | K O W J;M
O Y N Q V | Q V N Y;O
V P N R U | V U R P;N
M X B I W | B M X I;W
M T G Z S | Z T G S;M
Z H N O G | G N Z O;H
V B O K Y | O Y B V;K
R A V Q G | G Q V R;A
V R Y J Z | V J R Z;Y
C Y X A Q | Q Y X A;C
U E W D M | W M D E;U
R J D P B | P B R D;J
G Y P V F | V F P G;Y
Z S C N H | N C H S;Z
M N T C I | N C T M;I
E K M I N | M E K N;I
T M Y U W | U Y T W;M
I B W P F | F B W P;I
J X F H M | X J H M;F
J E L B P | P B J E;L
F H Q Y W | H Y W Q;F
L X F V I | I F X V;L
E L I O K | I E O L;K
J X S U E | U X E S;J
S H A U D | H D U A;S
R H T S A | H A T R;S
S F E H B | B F H E;S
C B P A Q | A C P B;Q
Y T W G U | T G W U;Y
J K C Q A | C J K A;Q
E S U V L | E L S U;V
D C Y F N | N Y D C;F
C U D L S | C L D U;S
N X Z T A | T N X Z;A
G Z T O F | Z F G O;T
E L Y I G | G I E Y;L
Y Z U W Q | Y Z U W;Q
X U K Z C | X C K U;Z
Z T G E A | Z G T E;A
E F X O J | X E O J;F
Z G M T L | T M L Z;G
L X F R J | X J L R;F
H P Q G S | S P G Q;H
J X P W M | M J W X;P
X F B Q T | X Q B F;T
G I M T C | M C I G;T
I E V C O | E O C I;V
N V I F W | I V W N;F
H V S G Q | H Q V G;S
U O P C X | O U P X;C
O E J W F | O E W J;F
X F B T Q | X T F B;Q
K F Y R A | R F A K;Y
X U H K M | K U X H;M
A F M D L | A F M D;L
C U J G Q | G J C U;Q
G H Q X T | T Q G H;X
Z D A L Q | D A L Z;Q
Q Y O E P | Y Q O P;E
Z E T U B | T U E Z;B
T A K U F | F A U T;K
T P H V F | F T P H;V
C I O M L | M C I O;L
K F R W J | R K F W;J
R X Z U N | R U X Z;N
D O P B C | C D B O;P
T Z X A J | A Z J T;X
O W N J G | J O W G;N
L Y J X D | D J X L;Y
U Y T L A | T Y A L;U
T G D B O | G O T D;B
H G Y C O | C H G Y;O
P S T Q X | T Q S X;P
V W A B O | O V W B;A
E H W J X | W H E X;J
H X P L O | P L X O;H
E H J G C | H C G E;J
J V B F C | C B F J;V
G S E A P | G P S A;E
B G K Z L | B L K Z;G
S P B T Y | S P T B;Y
R H Y G S | H G S Y;R
E M C Q F | E C Q M;F
B Y U Z E | B Z U E;Y
B F Z R Q | B Z F Q;R
J H Y S Q | H Q Y S;J
K F G I D | F D G K;I
O M D T E | D M O E;T
T L I E M | I T L M;E
O K N C U | K O U N;C
X I T A S | S T A I;X
W U Q I B | Q B U I;W
M P K X Y | K M P Y;X
K J A P D | J A K D;P
A O P R I | I A R P;O
C K R Z I | R C K Z;I
S D I A C | S A C D;I
R I E L S | S E R L;I
Y F A G C | F A C G;Y
L T F I Z | Z L F I;T
E D A S F | S E D F;A
Y K R L D | D K L Y;R
W Z N G P | P N G Z;W
W S A D Z | A Z D W;S
C G L O Z | L Z C G;O
Q J V G B | Q B G J;V
W A Q G D | D A W G;Q
Q S F R Z | S Z Q F;R
D O T N L | T D N L;O
D E W Z F | D W Z E;F
F E Q X J | X F J Q;E
C T J U M | U M T J;C
O W M B N | B O W M;N
U B Z N T | T B N Z;U
M U H V E | H M V E;U
N M C X V | C N V X;M
E K M L F | K L E F;M
L S G T J | J T L G;S
Y L A E I | L A I Y;E
G S L V B | B S L V;G
U C W K Z | W K U C;Z
C S O Q B | Q B C S;O
R B V T A | T R V B;A
Z L W U N | Z N L U;W
Y P Z B X | B Y P X;Z
J D I R N | D N R I;J
U X W I O | O W I X;U
X S V J B | B V J X;S
L Y A W M | M A Y W;L
Q S V F B | S V Q B;F
H S G U T | S U G H;T
T D X L E | E X T D;L
E P Y K J | P J E Y;K
L Y F S W | S W L Y;F
K Z P H O | K H P Z;O
U V R O S | S O U V;R
R C E A J | J A E R;C
L A C J M | J C L A;M
O U M K S | K S O U;M
W Z E K D | W E K D;Z
O M V C D | M D V O;C
D T U K V | T D U K;V
Z T Y U M | Y T Z M;U
A E F Q R | Q R E A;F
A Q G W S | Q W S A;G
N G F J D | F N G J;D
M U L N J | U L N M;J
E V Y I H | V Y H E;I
R H Q G E | Q R G H;E
D Z T A K | D T Z A;K
S I K Y P | P I K S;Y
I O Y L V | I L Y O;V
W H A L P | L P H A;W
R L A H B | L B R A;H
Y A S D L | L S Y A;D
T S Y Q W | Q S W Y;T
R U P K X | U X K P;R
P Y W V M | V Y M P;W
L E W F V | F V L E;W
T R E C O | T C O E;R
Z U Q E V | V U E Z;Q
H S Q L F | H L F S;Q
M F K G V | G K F V;M
H U I F V | H U V I;F
H S B X I | X H B S;I
A M U V H | H V A M;U
D L S V Z | Z S L V;D
B J A E P | P A J B;E
A E R P V | E V A R;P
J X I S H | J I H X;S
Y R U I H | U R I Y;H
J I G Z L | J G I Z;L
N B J F V | V N F B;J
P O Q M T | P Q O T;M
B Y I T H | H B I Y;T
O K Q X V | K V Q X;O
J M A B E | B A J M;E
K B V F E | K B V E;F
S C W B Z | S W C B;Z
K Z B S M | S M K B;Z
X C Y R Q | Q Y X C;R
S T A U F | A F T U;S
V X J M B | B J X V;M
U I G M T | G U M T;I
N G B J P | N P G B;J
T L X I O | L I T O;X
R N G H S | S G H N;R
Y T D W R | R T D W;Y
K H M R N | K H M R;N
P A T F I | A I P T;F
G J O L W | G O L J;W
M H Z A Q | Q M H A;Z
J N P O X | N J X O;P
F Y U X D | U D X Y;F
R B J U N | N U R B;J
A T O I J | T A O I;J
S Q L M O | S O L Q;M
S U W K C | C W S K;U
S L Q E G | S Q G L;E
V N C G L | C L G V;N
T N P R C | R P C T;N
E G Q B W | B G Q E;W
U K G A D | U D K G;A
A T O P W | P A T O;W
A I W X C | C A X I;W
J X C N H | H C N J;X
D Q G W Z | W G Z D;Q
W Z C P Y | Y P C Z;W
E Q B O P | Q B E P;O
Z K X E S | S K E Z;X
L F W G Q | W F Q G;L
D Q V W B | V B W D;Q
D N G V Q | V D G Q;N
R B P A W | B A R W;P
V D Y W E | V D E Y;W
L A N Y K | K Y A N;L
Y A N K E | Y A N E;K
T Y O L V | V Y O T;L
E S R F P | R S P E;F
C P W H D | P W C H;D
N J Y A P | N Y P J;A
R V U W S | U W V R;S
C X U E F | U E X F;C
K A E S P | P A K E;S
I R V H K | R K H V;I
P I L X S | I P S X;L
O W H A Z | H W A Z;O
J H M A S | J M A H;S
C N I A Y | C A I N;Y
M A D K Y | Y M A D;K
Y M E F P | E M Y F;P
T Q Z F N | F Z N Q;T
U V Q G K | V G K U;Q
U N H R K | K N H U;R
J A Y N S | S J A Y;N
X J W E T | J X W T;E
O Y J E M | M O E J;Y
L C D Z O | Z D C O;L
A L D K N | D K N L;A
S A L N H | S A L N;H
M H J D N | D N J H;M
F K T Y L | Y F L T;K
C N H B W | H B N C;W
U H R T F | R T H U;F
O U A T W | T O W U;A
F K R E H | E H F R;K
E W A U P | W P U A;E
K C V X E | V E K C;X
D F R O E | F R E O;D
L Y G I S | I Y L G;S
D G A T B | D T G B;A
K Y W M X | W M Y K;X
V J O R A | R O V A;J
G T U A H | U H A T;G
A T B L N | B T A N;L
A J C V P | P J V A;C
P Y G Q V | P V Q Y;G
P Y T M S | S T P Y;M
H V L Q P | H Q L V;P
K R I T J | K I J R;T
P L E A C | L C P E;A
A R F H U | H A F R;U
F T W U Y | Y U F W;T
N T J D Q | N D J Q;T
J D I W H | H W J D;I
I P R C M | M C I R;P
E G W U P | W P G E;U
W I A E O | I A E O;W
Y M H G A | Y G H A;M
B G O W N | B G N W;O
Q N Z D E | Z E N Q;D
O U V W J | J V W U;O
N K O R E | K O N E;R
W A Z Y L | L Y W Z;A
Q D S W J | J W Q D;S
Y F G R B | Y B G F;R
S C Q K U | Q U C K;S
A H X K M | K H A X;M
P Z T X C | C X T P;Z
M K F S T | M S F K;T
M W K A G | M W G K;A
Q H I N X | H X N I;Q
T N K Z W | W K Z T;N
W Z U C V | C W V Z;U
Q J R V S | V R S Q;J
P J G V W | P J V W;G
M B V Q R | M R V Q;B
W M U Y Z | Y W U Z;M
Q N W A D | Q D A W;N
H G L F O | G L F O;H
M X J U R | M X U R;J
P V Q D U | V Q P D;U
Z T H K D | H K Z D;T
H X P L M | H L M X;P
M O J V U | V U O M;J
U I H X B | I B U X;H
W L H I V | W L I H;V
C L T Q Z | Z T C L;Q
G J A D R | J R G A;D
C W G L E | C G W L;E
Y G X M Z | Y G X Z;M
T Q O D S | O T S D;Q
N F L G K | G K L F;N
Q P M Z I | P Q M Z;I
I V E J R | J E R I;V
N F L O P | O N P F;L
M O W H B | H M B W;O
M G Y L H | L M H Y;G
K L T S C | K S L T;C
K O X S N | K X S N;O
Q O F A G | F A Q O;G
B Q D T S | T B Q S;D
R C U A N | R C U A;N
D F W C G | W C F G;D
T A V Z K | T Z K A;V
V U K F I | K F V I;U
D F G W H | H W D G;F
C G S N Q | S C N G;Q
H Q M A Z | A Z H Q;M
Z B J S Y | S Y J B;Z
K A X I P | K P A X;I
G J U D X | J U D G;X
A S M L U | U A S L;M
X N R C Y | N C R X;Y
N F G X H | H G X F;N
G T Q I D | T Q G I;D
R M Q S V | R M Q V;S
S J O K R | J K O R;S
B K E D V | K V E D;B
C I K V U | C U K V;I
I Z K P N | K Z P I;N
L K E P V | E K L V;P
R B V C N | R C V B;N
S Q F R M | Q M F R;S
R W I Y L | W Y L I;R
D Q Z J Y | J Z D Q;Y
W X O J E | W J E O;X
E P O X Z | P X E O;Z
P D V F R | P F R D;V
G W V U A | A W U V;G
Y A I B Q | I Y A Q;B
C Y O S D | O Y S D;C
O L G P I | L G O I;P
X R O D E | O D E R;X
S V X L A | S X L A;V
R N Q G I | Q G I R;N
K R L I A | K A R L;I
O I E J T | T J I O;E
X O M K H | M X H O;K
K I E D L | I D K E;L
H O G K V | G O V H;K
F Q U A Z | Z A F Q;U
A F D B Y | F A D B;Y
W S H Z M | H S W M;Z
H M R Z S | Z R S M;H
F Z I C G | Z F G I;C
R I V Z J | J Z I R;V
K J L S I | L S J I;K
A E Z X P | A E P X;Z
D I R T Z | D R Z T;I
Z Q A R N | A Z N Q;R
I J X S A | J S I A;X
Q Y R V G | Q G V Y;R
I M F Y V | Y M I F;V
L K G C V | V K L C;G
R Y O J P | R O J P;Y
F N R G C | R G F C;N
C B Y J T | C J T B;Y
V K N H S | K H V S;N
M U V G C | U G C V;M
O X R T J | X O J R;T
I C L Q K | L I C Q;K
N K X Y J | N Y J X;K
A G T H J | G A H J;T
P G U N I | G I U P;N
K U H P Z | P Z H K;U
U E B H D | H E D U;B
L W Y B C | B Y C W;L
Z D K L E | L K Z E;D
F J Y L V | L F J V;Y
G J M L S | J G S L;M
Y V W I A | A W Y I;V
B P H F T | P T F H;B
B J G X W | X G W J;B
Y Z E A O | Z E A O;Y
C D N M R | M N R D;C
U Y C I O | U C I O;Y
L M A P F | A M P L;F
M U E I S | M I S U;E
J R U X S | S U J R;X
I O T S J | J O S T;I
M N O W I | I N W M;O
D A C G X | G C X A;D
I G Q L B | L I B Q;G
Z F B O D | O Z D F;B
W B O X P | X B P O;W
R U A O P | U R O P;A
M H L K T | M L T H;K
F K T J I | F I K T;J
I G B J C | C G I B;J
Q Z D N P | D P Q N;Z
W Z V G K | K Z G V;W
X L Y Q Z | L X Z Q;Y
N A G C X | N C X G;A
I M L H X | I L H X;M
B E U N Z | U E Z N;B
I S U L O | U O S L;I
A I O U Z | A O Z U;I
W P X S B | W B X S;P
D B G J Z | J G Z D;B
Y W F S Q | Q W F Y;S
F S N I Q | N F I S;Q
T F S C I | S F T I;C
M C V S W | M C S V;W
L V H I G | H G V I;L
R F T G M | F R G T;M
S Q H V G | G V S H;Q
D Y I J Z | J I Y Z;D
L K D Q N | D K Q N;L
R I X S G | X R G I;S
B J M U I | B M U I;J
X Y A J K | Y X K J;A
R V P Q D | V D R P;Q
K Q R Y S | Y K S R;Q
R N P Y L | R Y N L;P
M J Z W S | J Z W M;S
R B P Z X | P Z R B;X
C A W S J | A S W J;C
M S T F G | S M T F;G
J F W A C | W A F C;J
P G J B C | J C G B;P
H Q J Y M | Q H M J;Y
P W Q Z V | Q V Z P;W
R J Z D E | D R E Z;J
E A U N Q | Q U E N;A
W M H D J | W M D J;H
M V H L I | V I H M;L
D U I K Q | I D U Q;K
U P B A S | S B A U;P
K G Y S M | G S Y M;K
E C A L I | L E A C;I
W E F Y Q | E Y F Q;W
T H X G E | X E G T;H
W Q V S J | W J S V;Q
H X N W V | V N H X;W
Z G T M P | G T Z P;M
L I J P W | P L I J;W
W J R Q E | W R E J;Q
P L Z Y T | T Y Z P;L
K S Y A W | K Y A W;S
Z I B P X | I X Z B;P
T Y S Z P | P T S Y;Z
D I A S F | D I F S;A
S C W B Y | W C B S;Y
N R F X V | F X R V;N
E U B P H | E H B U;P
F W B Z I | I B W Z;F
N W Z P M | Z W P N;M
L J N A W | A L J W;N
R Z X V K | K Z X V;R
J D X B Y | Y D X B;J
F B K Y L | B K L Y;F
I F V N E | N V I F;E
F D W Y K | D K Y F;W
Y O U Q I | U Q O I;Y
W T M J H | M W H J;T
M K L W S | W S K M;L
D P U T K | T K P U;D
P Y D I B | P I D B;Y
T I R E V | V T I E;R
M B J D G | J D M G;B
A E Y K U | U K E A;Y
M Q B X L | X M B Q;L
I S Y R K | R Y K I;S
V L R M B | B V R L;M
M N B D K | K M N D;B
T P N H S | T H P N;S
M Z O H C | H C M Z;O
L E B D S | S L B D;E
C K G M S | C G K S;M
G M X K N | X G N M;K
G Y Z F O | Z F Y O;G
T F E S Y | S E T F;Y
T Q N M K | M N Q T;K
H E W Z Y | W H Z Y;E
D M P C A | C D A M;P
J Y N D H | D J N Y;H
A Z V B Y | Y B A V;Z
C O L U N | C O L U;N
P B H L J | B P H L;J
Z B L P N | N P L Z;B
D I R N Z | N R Z D;I
S V F W D | W F D V;S
Y V X I G | I G Y V;X
K B U P J | U K B J;P
W G N M Y | M Y W N;G
O G D T Z | T Z G O;D
E T Q S Y | S Q E T;Y
W T A C X | X T W A;C
H U W C P | H U C W;P
N E P I J | P N I E;J
L K U D R | K R U D;L
A T D G U | D T A G;U
Y B I K J | I K B Y;J
O E I W D | O I W D;E
T K G Y H | T Y K G;H
N S P F Q | F S N P;Q
N X E M G | G E N X;M
S F V K C | S V C F;K
L G I K H | I K G L;H
X C D J S | C S D X;J
Z D O B C | Z B C D;O
W G N O X | O G X W;N
Q R F K X | F X K R;Q
O E Q N D | O D N E;Q
C N T D W | T W D C;N
H S O M N | H O M N;S
M R I D Q | M Q I D;R
L T M G J | M L J G;T
X I O J B | B J I O;X
K R I J W | I J R K;W
L I K U H | I H L U;K
V L G U F | U V F L;G
K M H Y Q | H K M Y;Q
V E J Q H | J Q H V;E
W J R L I | J L I R;W
T H R Y V | T V R Y;H
S M P E U | E P M U;S
G Q A Y V | V A G Y;Q
U I X S E | I S E U;X
S Y M I P | S P I Y;M
P G N H M | N M G P;H
U K N T X | X N T K;U
T Q C Y U | U T Q Y;C
U P T X N | N T P X;U
T Z G P L | T Z P L;G
D H C G B | B D G H;C
L C A M K | C M L A;K
M S K H E | H E S K;M
I H V M U | M U I H;V
Q R C B Z | C B Z Q;R
L A U F M | U F M L;A
T L Y X Z | Y T X Z;L
K X T E J | X E K J;T
D G C R U | G U D C;R
S X G Y B | Y B X S;G
K E Y U D | U E D K;Y
K E F Z C | C E Z K;F
N O B F L | B F O L;N
T J X Q L | X J Q L;T
M C W F S | C S M W;F
L C B T N | T L C B;N
P A C V E | A E V C;P
L T Q B N | N L T B;Q
Q V K F C | F Q C K;V
C M D U O | D U M C;O
M P E A O | P M O E;A
M T H Y I | Y T M I;H
C J X E M | C E X M;J
P Z A X G | P A X Z;G
T D P S H | S P H D;T
Z T G C Y | Z C G T;Y
J P M U G | J U G P;M
Q V B J O | J O Q B;V
D Z H L B | D L H Z;B
F D H P Q | D Q F H;P
J Q A W G | W Q A G;J
W L M P F | W F M P;L
O X I D J | O I J D;X
V O Z M J | J O Z M;V
G R P X C | X R C P;G
L S N J O | J N L S;O
I R Z H C | R I C H;Z
C B R I U | I B C U;R
K P H Q A | K A P H;Q
M Z P Q D | M Z D P;Q
O D W T U | O U W D;T
W A P N K | K A W P;N
U O H Y A | Y U O A;H
E N F Y B | F B N Y;E
R X Z H E | X E H Z;R
D N Y H W | D H Y W;N
K V A H U | U A V H;K
S U L T I | U T L I;S
R N Q F M | F Q R N;M
F K A C O | K C F O;A
V B H J G | V B J G;H
E H L M X | E L M X;H
T O J M K | M J K O;T
E D A S F | F A E S;D
L I O R Q | Q O I L;R
G E L V N | N E L V;G
T U J G P | G P T U;J
J D T M H | J D M T;H
N E I G X | X I E N;G
S B D K L | B K S L;D
T R W M G | T R G M;W
C M V J R | R C V J;M
Z U C E R | R U C E;Z
I W T V O | T W V O;I
R K Z B E | E Z K B;R
P Q T E X | E X P Q;T
N J U S Q | J Q U S;N
A J R X V | J V R A;X
S D V X I | D V X S;I
B J W L P | B P J L;W
A P M S K | S K M A;P
T M H R N | T N H R;M
Z C D J H | Z J H D;C
O J A L C | A C O J;L
D V H I S | V S I D;H
L F H K X | K X L H;F
V Z B W D | Z B V W;D
S I N V F | I F V S;N
J V N F I | N F I V;J
V R T K U | V R U T;K
L C O H G | L H C G;O
P G K D X | D G K P;X
O A R M S | O M R S;A
O R T C Z | O T R Z;C
M B Q K O | M Q B O;K
B S W G N | G N B S;W
F Q B S A | A Q S F;B
E W H I S | I S E W;H
P A R W S | W A P S;R
L A M W Y | Y L M W;A
N C Y F Z | Z N C Y;F
P G C J M | C J M P;G
K Z X P T | P X T Z;K
X C L M I | I M C X;L
F A H U M | A M U H;F
B S T L A | B S L A;T
I D M B O | B M D I;O
G I E W M | W I M G;E
X T U S G | X S T G;U
D M K B V | D V M K;B
L N Y I Q | Q L I N;Y
E D Z A H | H A D E;Z
I C J U H | I H C J;U
V I U D O | V I O U;D
P W R G J | P R G J;W
H J N C P | J P N C;H
K N R C O | R C K O;N
I A F R S | I F S R;A
D O B G E | O E D G;B
Q K L P G | L Q G K;P
T X U I C | U T I C;X
H D R C L | L R D H;C
A C G X Q | C Q X A;G
S O K T E | E S O K;T
V S D W P | P D V W;S
Q J D I Z | J D Q Z;I
N A Y B U | A N Y U;B
O I L K M | O M L I;K
E L G D K | G K D E;L
E D R M L | M E L R;D
E Q O M R | O R E M;Q
D F M V G | D G V F;M
H M P O V | V M O H;P
L C R U G | U R C L;G
E H U O B | H U E O;B
O W B L Q | Q B L W;O
W B L D E | E B L W;D
G Y Z N F | Y F N Z;G
D K T H G | G K D H;T
B D H F P | H D B P;F
M U W C I | U C W I;M
Q J T H D | T Q D J;H
K N E U Q | Q N K U;E
V Q M Z B | V M Q Z;B
O T J D Y | T D J Y;O
Y K V T R | K T Y V;R
J F V M I | J V F M;I
A P F X H | A H P F;X
F V L B X | X V F L;B
J K E I A | J K I A;E
U B W J E | W E J B;U
Y K S E W | W S Y K;E
G O A S M | S G M O;A
Q D R O C | C R Q O;D
L S Y V C | Y C V S;L
S U B Q N | B U Q S;N
E K T Z R | R T K E;Z
A I F X T | X A I T;F
X H M Y F | H F M X;Y
S A Z H U | H S Z A;U
U F T Q X | U T X Q;F
O M X J F | O F M J;X
E W A O I | O E I A;W
W K N J H | K N J H;W
M H W L N | M H W N;L
G P F E J | F P G E;J
U P N L X | U N X L;P
V B U A T | T A V B;U
T V F I B | V I F B;T
M C B L P | M C B P;L
H S U T Z | U T H Z;S
Z W G S P | S W Z P;G
T I V Y J | I Y V J;T
R K I A B | A I R B;K
Y S T V H | S Y T V;H
E W M O I | E W I O;M
P Z C B L | Z C B L;P
H A V B U | V H U B;A
Z D W E L | Z E D L;W
Z M S I H | S H M Z;I
B V G D C | V G B D;C
T S L M U | U T S L;M
W C R J O | J C W O;R
O S N V U | S O N V;U
Z I C L O | C Z I L;O
L F D E B | F L D E;B
Q N W D V | Q N V D;W
H V P C X | X V P C;H
R B P O T | O T P B;R
E F H V K | V F H K;E
N A Z P S | A N S Z;P
R F K T M | R F M T;K
X P Y Q F | Y Q F P;X
F E U P N | E N U F;P
V E L M Z | Z V L M;E
U K W T J | J W T U;K
T L R E D | T L R D;E
K O M N B | N M O B;K
H B M O L | B L M H;O
H S C G X | G H C X;S
T Q G D H | G T Q H;D
T E B V F | F B E V;T
X S R L F | X F S L;R
Y W X R K | W Y R X;K
E P S A Z | E P S A;Z
H Q G S C | G C Q H;S
F N O C W | W C O N;F
O Q B F V | B O Q F;V
L Y W F Q | F Y W Q;L
K H C O P | H C K O;P
N C M B V | V N C B;M
X A I U P | X A U I;P
K Y M U N | K U M N;Y
D F B E M | F B M D;E
E V H N I | N I H V;E
G E T V K | G V K T;E
N U Q A P | A Q N P;U
D U B N A | D A B U;N
V F Z L P | P L Z F;V
D W V N X | W N D V;X
O C T N H | T C N O;H
A Y L P S | P A Y L;S
Z W M A T | Z W T M;A
J Q Y I P | Y P Q I;J
F T D R A | T F A D;R
D G J L O | D J L G;O
G I F N V | V G F I;N
O P H S U | S U P H;O
G J R U W | J W R G;U
R F H K Y | R H F K;Y
R A C Q V | A V C R;Q
Z M O V Y | Z Y O M;V
G J P L M | L P G J;M
I E F U Q | Q F U I;E
M N T Z J | M N T J;Z
S L F X W | L S W F;X
O T M X G | M G T X;O
C Q T J I | C T I Q;J
H P N J Z | H N J Z;P
Y H O J D | H Y J D;O
D V K L S | V L D S;K
B L A T E | A T E L;B
P X S L I | I S X L;P
Q P E S R | P R E Q;S
T G B V X | G V X T;B
Q T S N K | Q N S K;T
L I P O T | T I P L;O
L X D C H | D C L H;X
W X E O N | O W E N;X
P O V Q N | Q O N V;P
O K E S Y | S O E K;Y
U Q A P S | U S Q P;A
C I V A L | I C A L;V
E W S B N | B N W S;E
F T O A E | E O F A;T
K G P M I | M I P G;K
T D U F G | U G F T;D
N F O V C | O V C N;F
D P T G B | B G D P;T
U F L K Q | Q K U L;F
J U T O R | U T R O;J
F E Z L H | H L F E;Z
H K N B Z | H Z N B;K
I K C D Y | Y C I K;D
V Z M O K | Z M V K;O
T K U V C | C U V T;K
S C R A P | R P C S;A
L Y C Q B | Q B Y C;L
G O T H E | G H O T;E
U Y R Z W | U Y W R;Z
E V H M L | H M L V;E
U Z B M Q | Q U B Z;M
J V U O Z | O V U Z;J
F K W A G | W A K G;F
I Y U R N | Y I R N;U
P I B L H | H B I P;L
A G J H Y | G A J H;Y
U X Y D F | X F D Y;U
M J S X F | J X F M;S
N O E S J | O N S E;J
J Y X R P | P J Y X;R
Y S R W Q | Q Y R S;W
H Q W L D | D Q L H;W
N X C K W | W X C N;K
A V Y O X | Y O A X;V
V F M O N | M N V O;F
E A T Z Y | T Y A Z;E
I U O K W | U W I O;K
F K M G T | K G T F;M
W G U X L | U W X L;G
W M U P S | P M W U;S
R V U S N | V R U N;S
O S B Y D | O D S B;Y
L F Z O V | V Z F L;O
Z F D U K | K Z D U;F
I W N Q P | I N P Q;W
Z L V W T | L V W Z;T
L H C S F | H S F C;L
E M G A Y | Y A E M;G
B O I W C | W O I B;C
F D X I Z | F D I X;Z
Y X K O D | X K Y D;O
F O U V C | V C F O;U
G L V C H | C V H G;L
V D S Q O | S V Q D;O
T C M G Z | G T M Z;C
B R S F N | S F R N;B
Q D H M F | H Q D F;M
C Q S G B | B S G C;Q
T I G A Y | I Y A T;G
I H M P D | D P H I;M
P K E Y A | E K A P;Y
O W J I C | I W O J;C
T I E F J | T F J E;I
X R T M Z | R Z X M;T
Z F P H R | Z H F R;P
N K O F M | M F N O;K
F X T U J | T J X U;F
T C V F L | C V F L;T
K D W Y Q | Q D W K;Y
X I K L P | X K I P;L
O Q D V F | V O D F;Q
J E Y X M | J M X E;Y
Z J R Y K | J K Y R;Z
G X T Z C | X T C G;Z
Q I S Y F | F Y I S;Q
U Q K I E | K E I Q;U
U K Q E B | B E K U;Q
L T G R I | I L G T;R
Z D P C O | P Z D O;C
M O Y G W | O G M Y;W
Q O E J G | O Q J E;G
X R H F N | N H X R;F
S B O Z Q | B O Z Q;S
X T E J O | T E X O;J
K N G Y Q | N Q G Y;K
J C U B K | C U B K;J
I X Z E O | E O Z X;I
S E R Y Z | E R Z Y;S
N C I G Z | N C G I;Z
T N J B P | B N J T;P
U T I V L | I V T L;U
E Q T A K | E T Q A;K
O K J Y A | J A K Y;O
Z W E A N | A W E Z;N
U B D V A | V D A B;U
G B U L N | G N L U;B
C S Z G I | I G S C;Z
R S C D V | C D R V;S
B W E M O | B E W O;M
G X P U N | U P G N;X
H Q M S I | S Q M I;H
S T M L A | T M A L;S
X M C W I | M C I X;W
C E X K P | K X P C;E
B X G D N | G B X N;D
R M I S A | I A S R;M
Q U A X V | V A U Q;X
T E R I A | R I A E;T
Q G L X P | Q G L X;P
R Y G O J | Y J O R;G
B Z S N L | B N L S;Z
O A F Q Z | A Z F O;Q
A H K U T | H T U K;A
X L Q I P | I P Q X;L
I A H V R | H R I A;V
C S L P I | I S P C;L
E R D X G | G R E D;X
Z B U X D | D U Z X;B
J D E W V | D J E V;W
Q C U N G | C N G U;Q
T D M K I | M K D I;T
M R J H Z | Z R H M;J
C Y K B T | Y T C K;B
R G O B P | B R G P;O
W K T X N | N W X T;K
F K T P D | F D T K;P
H G M O N | N G H M;O
E U Z A C | Z U A E;C
C F O U X | X O C U;F
H E V P F | E H P F;V
Y R C N G | G C R N;Y
X H J B Y | J B H X;Y
Y J C R G | C R J G;Y
O T J C Q | J Q C O;T
Y O L T V | V Y L O;T
R N S W V | N R V S;W
H R G A Y | A H R Y;G
Z K G F J | K G F Z;J
W V J Z G | G W J V;Z
E R X G H | E G R X;H
I Q L T Y | I Q Y T;L
V R E I B | R I E B;V
L N I W P | L I P W;N
L V R X H | R V X L;H
S I E Y N | I N S Y;E
R H N I Q | R Q N I;H
C R X M P | R C M P;X
X P E D H | X E P H;D
A B X K E | K B E A;X
V O H B X | V B O H;X
B T X J A | T X A B;J
F L K Z U | L U F K;Z
C V H Q E | C Q E H;V
U A P O M | O A P U;M
J O Q U X | U Q O X;J
J N B P W | B W J N;P
E Q A O Y | E A Y Q;O
S P N R Z | N S R Z;P
I M X T N | T M X I;N
J T L A N | J T A L;N
F A V Y R | V A Y F;R
V N Z A O | V Z A N;O
X F C U D | F U D C;X
B T W Y F | F B T W;Y
E W I Z G | I Z E W;G
T X P L H | P L H X;T
A N E K F | E K A F;N
R H J U M | J R M H;U
I Q G C T | I C Q T;G
U K R Y D | Y K U R;D
M Q N L X | L X N Q;M
Z O W C F | Z W O F;C
U A R T M | M A U R;T
F A T R V | T V A R;F
D T K Y P | T D K Y;P
Z V X Q A | Z V Q A;X
O A D J C | D A C J;O
N X Q L V | Q N V X;L
P N I U A | P A U I;N
Z Q W L D | W Z D Q;L
Z I M S N | I Z S N;M
N U D L S | L D S U;N
G Z O H S | S H G O;Z
P I E H K | P E I H;K
D X Q J V | Q D J V;X
H Y U R K | H K U Y;R
M P Q B K | Q B P M;K
V W J O Z | V O W J;Z
W D K J Q | J Q K D;W
Z S N V Q | S Z V Q;N
N H S L D | H D N S;L
M U A G P | A P G U;M
T F U Y S | S U F T;Y
F N P S U | N P S F;U
D A P G U | P G D U;A
Z X D S Y | X Z S Y;D
X M V J Q | J M Q X;V
I D K Y U | I U K Y;D
A H K G N | G H N K;A
P M T E N | T P M N;E
L P M G F | P G M L;F
A K Q P G | Q K P A;G
C X W T D | D X W T;C
H D L S I | D L H I;S
K P V B X | X K B P;V
H K G D Q | K Q G H;D
L D B W F | W L B F;D
Z O K N Q | N O Z Q;K
R S B F U | F R B S;U
D V H M C | C V H M;D
N D K J H | J H D N;K
J L V C O | C J O V;L
A O N V L | L A N O;V
U Y O B R | R U B O;Y
G C I B R | B I G C;R
S J A V X | J X A V;S
F S O M R | S F M O;R
E K C T D | C D T E;K
Q K L V N | L N Q V;K
Q C P V Z | V Q Z C;P
A J T E G | G A J E;T
J E Y V F | V Y J E;F
O G W P Z | O Z W P;G
R U M A K | U K M A;R
X G D I T | T I G X;D
D W Z K X | D Z W X;K
W V O J L | J V W O;L
J X S F T | X S T F;J
E O Y X T | T Y O X;E
K V G F R | R G K V;F
J I V G D | J I V G;D
S A M I U | U A I S;M
Z J S X I | J I X S;Z
F K V Y U | K V U Y;F
H Z G I X | Z X I G;H
J M S V Z | V S Z M;J
E M T X F | M X F T;E
S K M I N | S K N I;M
W X Y F C | X Y F C;W
A Z I X D | A Z I D;X
D Q S O E | O Q E S;D
M N A J Z | J Z M A;N
O N I R Z | I Z N O;R
T D V H W | H D V W;T
Y X A S Z | A Z Y X;S
Z A G C R | A Z G R;C
X U I O Q | U Q X I;O
H Z J R B | Z H R B;J
P U D S C | C P D S;U
O P W J X | O P W X;J
U V Q C K | V Q K U;C
Z R P K N | N K P R;Z
Y K C M P | Y M P C;K
S Z J B K | Z S K J;B
Z H F M G | H M G Z;F
Z F P L I | Z L F P;I
J V S P F | S J F V;P
K A Z X W | K A W Z;X
C O D M H | H D O C;M
T L A P R | T L R A;P
W A F C L | W F C L;A
O C V F G | V O G C;F
B D K P O | K D P O;B
A Y Q E O | A Q Y O;E
V I N L Q | V I L Q;N
T D M Z B | Z D B T;M
T Q O N J | Q J N T;O
M R U O G | O U M G;R
C E Z N I | C Z I N;E
S F D J B | D S J B;F
R Z L B E | R L Z B;E
D H Q X R | R D X H;Q
V K C O S | S C O V;K
H G P Z C | Z H C P;G
J O N L T | J T N O;L
J W A S K | S W J K;A
A W D Z Q | D W Z A;Q
Y S A N F | N Y A S;F
G F V E B | B E G F;V
T E N I F | F E T I;N
R H E P V | P H V E;R
T Q P L I | T Q P L;I
N E R F A | F R A E;N
M F Q D E | E Q M F;D
P S G T B | T S G B;P
H I R P L | R L I P;H
S O V R W | W S O V;R
J R Y K X | Y R X K;J
K P X W L | P L X K;W
Z I B V J | Z J I B;V
T F A W G | A F G W;T
H F J R G | G F R H;J
C A Y G U | Y A C G;U
K F Q J W | Q F W K;J
T C G Y B | T C Y B;G
M D E R H | D E H R;M
N C W I M | C I M W;N
O H N U B | U B H O;N
P O J A T | J O A P;T
L M A E C | E M L A;C
F Q I U E | I F E U;Q
J B H Z Y | B Z H Y;J
Q Z U W F | U F W Z;Q
G Z A H X | H Z X G;A
Y C F L G | Y L C F;G
M H Z A C | H M A Z;C
Z X R Q H | H R Z X;Q
M G X K Q | M X Q G;K
F Y K C E | Y C E F;K
Q E S D C | Q E D S;C
I T G W L | W T G L;I
F U W Q S | U Q S W;F
M P J I N | M N P J;I
X B O L V | V X L B;O
T U V G K | G V U K;T
B R H A E | E H A B;R
B U L F T | B U F L;T
U Z D J R | Z R J D;U
K P D B F | P F D K;B
X J Y L U | U J L Y;X
D W V Y B | W Y V D;B
R B H Q P | B R P H;Q
X I B L K | X L K I;B
X V P U D | V P D U;X
B E X F Q | E B Q F;X
I K Q U R | K R U Q;I
O N C V J | N C O J;V
X C E M R | M X C R;E
G M O C Y | M G O Y;C
W S G C V | S C G V;W
Y W C O A | A Y C O;W
E P T Y W | E Y T P;W
Y T J P N | Y N P T;J
W T C G K | T W C K;G
F E W X G | E W G X;F
L P Q B F | B P Q F;L
I A Y N B | N I B A;Y
G N S K B | B S G K;N
O Z S Q B | S O B Q;Z
Z A B J O | A J B O;Z
J X M P Z | J P Z X;M
O E Z U H | H Z E O;U
B Q N Z L | Q B L N;Z
F H R U T | R H U T;F
S C P V W | P W S V;C
I S Z A D | S A Z I;D
N W G Q U | Q G U N;W
E G B Q Z | E B Z G;Q
S K F Y Q | F Q S K;Y
N E O X L | X N E L;O
B F W I D | F W D I;B
Q W V K O | W K V O;Q
T D V I S | S T D V;I
Q V R E O | O Q V E;R
P B I O Q | I Q O P;B
X R U C P | R X C P;U
U T X H N | N H X U;T
F X W H B | H W B F;X
Z W B O T | W O B Z;T
O F H L G | H O G F;L
J V F S E | J S F E;V
C S A P Y | A Y S C;P
X C Q K N | Q C X N;K
F D T A L | A L D F;T
Y R H I L | R L Y H;I
A U L Z M | L A Z U;M
B R V J Y | R Y V J;B
Q X O C T | Q O X T;C
Q D O L B | Q B L D;O
W M Q N Z | N M W Z;Q
F A X U P | A F U P;X
X S T L E | S E X T;L
K D T I Z | K I Z T;D
G A Q R L | G Q A R;L
H V D L R | R L V D;H
R P L F Q | Q L F P;R
C P N O Q | Q C O P;N
T N Z A P | Z T P N;A
W P C U B | U W C B;P
I E L Y W | Y I E W;L
R O C B P | C B O P;R
B Q I A N | B I N Q;A
M Q K R W | M W K Q;R
H Y F L S | Y H F S;L
V C J W R | J W V C;R
G W E I K | I E K G;W
T I A Z Q | A I Z Q;T
I N D B Q | B D I Q;N
N S A L E | A L E S;N
V W B U H | H V B U;W
F T L A R | A L F R;T
G C A I Z | C Z A I;G
C T X G J | X C G T;J
B G O C P | B P G O;C
A L B Q J | A L Q J;B
C G F P J | F J G P;C
X Z M K F | X F K M;Z
S D R V Q | S D V Q;R
E X Q W V | W Q X V;E
W S O I T | I O S W;T
Y F K X D | D Y K X;F
P C G S U | U G S P;C
V W G M E | V W E G;M
X L V G A | L V X G;A
Y A U W V | A Y U V;W
M D O P L | L O M D;P
H F A Q N | N H F Q;A
E L M H T | E L T M;H
S Q R N V | V Q R S;N
P X W B K | K B W P;X
H G J Q R | H Q R J;G
Q J P H W | Q J P H;W
C I T Z M | Z M T C;I
B P E N X | P X N E;B
Q L C R N | Q C L N;R
C F W E P | W F C P;E
N J C M W | J N W C;M
Q I X O A | Q O I A;X
Y R N H I | H I N Y;R
R G N B X | N R X B;G
Q M I T S | I Q S T;M
D E F Z P | E Z P D;F
G W Q K F | K W G F;Q
Y H R A C | Y R A H;C
X E A Y V | X E Y A;V
J I O N L | I L J N;O
Y Z O D R | D Z R O;Y
F H W P J | P F J H;W
W Y X N I | I N W X;Y
C J F A O | A J F C;O
B O U W R | B O W U;R
T O M P G | P O M G;T
I B R P A | A I B P;R
D C W F B | W C D F;B
N R K E H | H N E R;K
P Q X S R | S Q P R;X
J E W U M | J E W M;U
L R G A B | A L R G;B
Z H G W T | T H Z G;W
P M U R V | P V M U;R
B J O Z N | Z J B N;O
M E U N V | E M V N;U
J G H O N | H G O N;J
K U W X J | U W X J;K
Z B K V X | X Z K B;V
W F K H V | H V W F;K
I J A G V | J A G V;I
L I P J C | P C I L;J
L A U O B | B O U L;A
G Q H U E | E G U H;Q
I F X M V | X V I F;M
B L T I W | W B I L;T
U A R N W | W N A U;R
F W J A D | D F J A;W
D T Y E O | E Y O T;D
A S Q Y X | A X Y Q;S
W P M Z V | Z V W M;P
W Q G X U | X Q G W;U
D V H S Z | D V S H;Z
M A I F J | A F M I;J
X M K P E | M E K X;P
O F T Y Q | Q F Y O;T
K B V O R | O K B V;R
B F X O D | O F X D;B
H B R X V | X B V H;R
T C A Z J | T A C J;Z
J D S X B | J B D X;S
J X L S D | D L X J;S
B J D Y K | B Y J K;D
S X C V Y | V Y X S;C
S K Y J I | J I Y S;K
G E S R P | S R G E;P
R C M N J | J M N R;C
X Z L O I | I L Z X;O
P C V I X | V C P I;X
M B Z H U | B M U H;Z
I Z L C Y | Y L Z C;I
A S N Z I | A Z S N;I
S Y J O K | J Y S O;K
A R E Q P | A E P R;Q
C H S Y A | A C Y H;S
F K H D I | H D F K;I
F V D Z N | V D Z N;F
B L O V E | B V O L;E
E B V Z C | B E C V;Z
U Y K S J | U K Y S;J
L O U S Z | L O U Z;S
M W X S R | M W R S;X
B W S F I | S I F W;B
Z E C X R | Z C X R;E
Y U K E V | Y K E V;U
S O T G N | S O G N;T
D H L Q F | Q L F H;D
B I U A K | K B U A;I
J H V Z S | Z V H S;J
P W Q E X | Q E W X;P
D J W A S | S W D A;J
D W E Y O | D Y O E;W
O E P G D | D P G O;E
T S M N R | M R S N;T
A K B H P | P H A B;K
C W X D I | X C I W;D
N D Y A E | E Y A D;N
X A E O M | O A M E;X
J T R A G | T G R J;A
Z J E S K | Z S J E;K
D Y O I M | O Y M I;D
F S M B V | V F S M;B
J R O F C | R O C F;J
L M B Y H | L H M Y;B
T P G H Y | Y P T G;H
Q O C M I | O Q M C;I
Y C I N G | C G I Y;N
F M W J V | F J V M;W
R J O B I | O R J B;I
K A D J I | K I D A;J
W Y P S R | Y S W P;R
S X Y W M | S X Y W;M
D J G W C | J G D W;C
T P D K J | D P K T;J
B Y E T C | E Y B C;T
D L H T I | D H T L;I
B G Q I T | I G Q B;T
O Y C D F | Y C D O;F
B Z E C R | E Z C B;R
A R C Y M | A C R M;Y
E C M T X | C E M T;X
L D U I T | L T I D;U
Y N G T Q | N Q G T;Y
Y A H U F | A U H Y;F
N J K W Z | J N Z W;K
B Y Z H O | Y Z B O;H
B R A U S | S R U B;A
E N I D T | I D T N;E
U B W Y V | B U W Y;V
A B G M C | C G A M;B
B D K Z O | K D O Z;B
W J I Z N | I Z N J;W
E H S L J | S L J E;H
I E B Q C | C Q E B;I
C N J V Z | V N J Z;C
F M X K E | E F X K;M
W X H Z P | Z X H P;W
Q G J S R | R G Q J;S
L W I V D | I V D L;W
R J P X C | C J P X;R
G N T W E | T G E W;N
Q F B N S | S N F Q;B
N P D Y V | N D P Y;V
E M G H U | U H G M;E
B Z A V J | V Z J A;B
U V A M D | U M D V;A
M T S F P | M T F S;P
V J T Q W | V T J Q;W
N T S P O | N T P S;O
J D T K S | K T D J;S
S O M J H | O S J M;H
F X Z H M | Z F X M;H
X Y R T A | A X Y R;T
Z F O U V | O F U Z;V
O F D J X | O D X J;F
Z I P F R | R P F Z;I
C S O I T | S C O T;I
V S W T N | T V N W;S
L V R U I | V L I R;U
Y C O K U | K C Y O;U
Y O D W R | R Y D O;W
F X C W E | E W X F;C
A U N Q P | U Q P A;N
A V M E P | M V E P;A
Q L V D W | Q D L W;V
Q G L Y V | G Y L V;Q
K M L E D | L D K E;M
G R X P F | G R P X;F
P T Q A D | T A D Q;P
W F L P A | L P A W;F
F W R Q U | U F W Q;R
J E Y O P | Y P E J;O
G L D W H | G D L W;H
Z I A Q K | Q I K Z;A
Y Z G E N | Y G N E;Z
C P N M U | N M U C;P
T N C H I | T H C N;I
L Y H O G | L H G O;Y
Z K O D G | O D Z K;G
V D S P K | S D V K;P
X D Y M L | L Y D M;X
Q W M Y J | J Q Y M;W
N G V B K | G K B N;V
T L M N W | N T L M;W
Q W K C E | W C K Q;E
E C P G Z | P G E Z;C
P X M V A | M V X P;A
Q P R H U | Q R P H;U
C X K S U | S X U C;K
N F I E G | I N G E;F
R D Z A W | W R Z A;D
Z T H S K | Z H T K;S
D G U B Q | U G B D;Q
H C Y R B | B Y H R;C
F V M Z Y | F Z M V;Y
S U Q B R | R U S B;Q
P Y V K Q | P K Y V;Q
I H W B F | B I H F;W
Z H O K D | H K Z O;D
Q V D K P | K P V Q;D
O W N U T | U T O N;W
V P W A M | M P A V;W
J H V I W | I J H W;V
C I M B E | M B E C;I
K T N M V | V K T N;M
F A C U Q | U A Q F;C
E C M P B | C P E M;B
O G B Z S | Z S O B;G
B R J M O | J O M B;R
Q L U A O | U L A Q;O
Q V S G M | M Q V S;G
O Q C W X | O Q X C;W
V P Z Y L | L Y V P;Z
H S T V W | S H T W;V
H U D C S | S U C H;D
Y E Q X M | X M Q Y;E
Q B A N C | C B Q N;A
O U F A X | A X F O;U
J C H Y T | T Y J C;H
Q C P F N | Q N C P;F
B P D W A | W P A D;B
R M G Q E | M Q E R;G
L H W V Q | L Q V W;H
M O Q F K | M K O F;Q
U Y F M Q | M U F Q;Y
I E X A L | X I A L;E
Q P I Z A | Z I P Q;A
M P L V O | P O L V;M
U L M I D | M I D L;U
R E X L H | H E L R;X
U V I O P | I V O P;U
X Z O S A | S A Z X;O
G Y P X J | P J X Y;G
G J A E Q | A Q G E;J
U S E D H | E U S H;D
N E K D F | E F D N;K
V F X Z P | P V X Z;F
W U G T P | P U T G;W
C E P A R | P E A R;C
R I D C F | F D R I;C
E J D Q P | E D J Q;P
Q Z S D U | D Z U S;Q
A Q V T D | V A T D;Q
U Q I C J | U I C J;Q
L G P S N | P L G S;N
T A H Q U | Q U A T;H
G J B Q T | G B Q T;J
R Y X C V | X C Y R;V
G Y X I D | Y I X D;G
R K F X S | F X K R;S
I A L X O | L O X I;A
M V X Y I | M Y V I;X
O T C M S | S M C T;O
I B C T R | I B C R;T
F P V C Q | C Q F P;V
Z K O E H | H E Z O;K
P Q Y K G | Q Y K P;G
H G B I V | H G I B;V
Y A U O V | A U Y V;O
P G X V S | P S V G;X
O L G Y I | G Y I L;O
N V I C D | N C V D;I
R I C B G | G C B R;I
A E S H R | S H A R;E
F M B Y N | B F M N;Y
W O K U X | K X O U;W
J N W F U | U J N F;W
O G J Q F | F O G J;Q
E X M K Y | E X K Y;M
Z S P T L | L P S T;Z
U N V X K | N V X K;U
W G E Z A | W E G A;Z
I T U N V | T V I N;U
M D S P Y | P M Y D;S
R A I Y Q | Q A I R;Y
H O N K X | X O K H;N
E A N K Q | E K N Q;A
V A N L S | A N S V;L
G M O R T | G M R O;T
M N F Q O | M F N O;Q
N Z M T K | N T M K;Z
B O X Z Q | O Q Z X;B
M Z H O Q | Z Q H M;O
B F T C V | V F C B;T
O V Q C U | U V C O;Q
F C O G A | C G F A;O
C W O I F | F O W C;I
R M H Y Q | R Q M H;Y
V T R J X | X V T R;J
J U X H D | U J D X;H
K Q X B E | B X Q K;E
K F B S M | S F B M;K
U J Y E K | K Y U J;E
C I T Q B | T C I Q;B
C O B L A | L B O A;C
O H B K U | B O H U;K
S N O I L | O L N I;S
D J X U P | D X J P;U
B H A M K | A K B M;H
S G Q R A | A G Q S;R
G J M R N | N G J R;M
C T H E W | T H C E;W
Y H F S K | S H K Y;F
X N L E G | L N G X;E
C T H D V | C D H T;V
U I O Q T | Q T O I;U
I G Q X Y | Y G X I;Q
L W P T O | P T L W;O
C I N T K | K N I C;T
P R J N B | R N P B;J
H Z X B L | L X B Z;H
M Y B L E | Y M E L;B
S F X J C | F J X C;S
F C J H P | C P F J;H
O V J D G | G O V D;J
I M D E S | D I E S;M
S N L B W | L W B S;N
C Q V S B | C V S Q;B
P B L I O | O I L P;B
G E Z B U | B E Z U;G
M B Q X Z | M X Q B;Z
U H M K S | U H M K;S
P X F O U | X U P O;F
Y P X M U | Y X P M;U
W F H U I | F H I U;W
K Z P G E | G K E P;Z
L I H N U | H L I N;U
J Z A E K | A J K E;Z
S Q J H Z | Q J Z S;H
I F R P G | G F I P;R
E I R Z W | W R E Z;I
U A B Z N | B A Z N;U
I O T N K | O N K T;I
S Q W X R | R Q X S;W
U W A J X | W U J A;X
V Q U P W | U W Q V;P
Q V U T C | C U T Q;V
Q Z U Y L | Y Q Z L;U
H J A Q Y | J H Y A;Q
H N J D C | J N D C;H
J T U N O | O U N J;T
G S V X Q | V G S Q;X
L K B D V | K B V L;D
C W S I V | W S C V;I
R V H A J | A R H J;V
I U K J E | K E U I;J
S Y H T K | K S T H;Y
Q Y P V L | Y L Q V;P
C U Z R O | Z U R O;C
K G N W B | W G B N;K
B I H K N | I H N K;B
O M E S T | S O E M;T
S R K D I | D S K I;R
S T C Y U | C S T Y;U
F Q G L N | G F N Q;L
B W J G H | H B J G;W
A P F O C | F A P O;C
A K N J I | J N K A;I
R I V H C | C I V H;R
W R A K U | K W U R;A
Q M N I W | W I Q M;N
U Y A K C | K Y C A;U
Q S L H O | L S O Q;H
V X M N B | X N B V;M
W M E D A | M E D A;W
G U N R Q | R Q U N;G
W E L J H | L H J W;E
N H X I G | N G I H;X
E Q H R U | H R U Q;E
J C L P Q | L C P Q;J
D I M W F | F I W D;M
R S E I J | J S I R;E
V E S K M | E S M V;K
Z Y L T A | Z A Y L;T
S L H B O | L S H O;B
G X O V R | R X V O;G
V Z W N F | W Z V N;F
J U E W A | E W A J;U
C Y G W Z | W G Y Z;C
F D I T G | D F G T;I
E J A H Z | Z J H E;A
Z W K J N | N Z J K;W
K E M Q I | M K Q E;I
O Y X B Z | B Z X Y;O
F N V A X | X F A N;V
B G I N E | E B G I;N
P U R N K | R P N U;K
W P O V Z | V Z W O;P
Z W R C A | A W C Z;R
D N A L M | D M A N;L
M O S W K | K M O W;S
J F K Z I | F J I K;Z
Q C M L D | L C Q D;M
E S Q P O | P O S E;Q
K X C S E | C K X S;E
B M G W P | W B P M;G
F T Z A N | T A F N;Z
A W I Q E | E W A I;Q
M D N F Y | Y F D N;M
I P K V C | I V P C;K
U R G J V | R U J G;V
M U B N E | B M E U;N
Q R D U P | R Q U P;D
X P M T F | T M X F;P
A Z X E S | Z E S A;X
I S M F X | M S X I;F
U O J A H | U O A H;J
U C I D L | D U L C;I
E Z Q C W | E W Z Q;C
M G J T I | G J I M;T
W R I A Z | W I R Z;A
W G M V O | W G M O;V
H E O G B | O H E B;G
I L S D F | I S L F;D
I Q O E A | E A I Q;O
G J R Z M | G M Z R;J
C D K X U | C X U D;K
U L F Y M | Y L U M;F
X R W B K | K B W R;X
D I T Q M | M Q I D;T
L V G S R | G S V L;R
T K R Y Q | K Q T Y;R
Q R A U O | R O Q U;A
O M S B L | L B M S;O
D Q W O P | P D Q W;O
H Y Q A D | D Y A Q;H
G K F Y D | D F G K;Y
X U E H W | W U X E;H
W N Z V D | D Z W N;V
T G P S F | T F G S;P
D P U T V | D V U T;P
L Q B C X | X B C L;Q
L U H M T | T L U H;M
G R L C X | G R L C;X
N P C I S | C P N S;I
T P D Q N | N Q D T;P
B O E I Y | B Y I E;O
Q N D Y S | D Q S N;Y
Y X M N P | X N M P;Y
K N H C E | C N H E;K
U H V J B | B V U H;J
T H L Q W | L H W T;Q
S T H I X | X T H I;S
R K B A T | K A R T;B
N V W Y T | Y N W T;V
V E J X L | E L X J;V
T Z R Y B | B Z Y R;T
M L N R B | L N R M;B
C H M Q B | Q B M H;C
D U J T G | U G J T;D
K R Y V L | Y K R L;V
D O X E Q | Q D X O;E
Q W E B C | Q C B W;E
H K Z S N | N S H K;Z
P A K W O | W O A P;K
M P Z J L | Z M J L;P
B U Q V J | V B U Q;J
U E S G C | U S E C;G
W H M D T | M T H D;W
O X A N Y | X A O Y;N
T E V S J | E V J S;T
R X I Y J | Y X I J;R
N Q W Y B | B W Y N;Q
G D X M T | M T D X;G
U K N F I | N F U I;K
G L S K P | S K L G;P
K Q R H B | K Q H R;B
C M D G A | A G C D;M
K W O X R | K O W R;X
S N T Q I | Q T I S;N
Y B E D P | B Y P E;D
N X U I J | U J I N;X
V E D T O | D T V O;E
U E K V G | E G U V;K
M R F P I | F M I R;P
V B P F D | B P F V;D
A I N M V | I N A M;V
F A Q T G | Q G T A;F
J S N V P | V N S J;P
Q O C D R | Q R D O;C
W J M V D | D M J V;W
R P F M V | F M P R;V
C T N P O | P O C T;N
W S J K Q | W J Q S;K
M S G Q E | Q S E G;M
C M H N T | H C M T;N
P E F C I | C F E I;P
I M R H W | W M R H;I
B Y J D O | J Y B D;O
R H T C L | C T H L;R
T K A N E | T K E N;A
V F I R N | R F V N;I
N C G I R | C I G R;N
G K N D O | O D N K;G
Y E B U K | K E Y U;B
T J V D F | T D J F;V
I Q N V C | I N C Q;V
V L Y C I | C Y V I;L
E T I Z X | E X I Z;T
U T J M Z | Z M U T;J
P Q H E A | P E H Q;A
Z N K O S | N O K Z;S
R F S V H | S F R V;H
T C E U L | C U E T;L
C L T F Q | C F Q T;L
B A U J S | B S A J;U
Q T E I O | O E Q I;T
W G Q O K | Q K G W;O
X U D I S | X S D U;I
Q J X D S | J D X Q;S
R A Y T E | A T R E;Y
O D K H I | O D K H;I
F Z G W Y | F W Z Y;G
U R Z E B | Z U R E;B
J L Z K V | Z L V J;K
E R L A Z | E Z R L;A
G Y P O S | Y O P G;S
W H N S Z | Z H N S;W
B N O Z A | Z N O A;B
R G W D F | D F G R;W
K U B A P | U K B P;A
K B E N T | N B K E;T
C J P D T | C D J P;T
N A S X W | X S N W;A
M D W C R | R M W C;D
G A Y Z K | A Z Y K;G
K I S B P | B P K I;S
F C Z E U | F E Z C;U
Q R J M O | Q M J O;R
A O Z K B | A B K Z;O
K D E L U | K L U E;D
G A V Y K | V G K Y;A
Y Z N O G | N O G Y;Z
C J S A V | J S V A;C
U S C R P | P S C R;U
V L D B I | V B I L;D
O K W L Q | O Q K L;W
Q O Y A G | O Y A G;Q
A W M Y U | A U W M;Y
F L V Z O | Z O V F;L
U H Z S X | S X Z H;U
L G B O F | F L G O;B
I Y E A O | E O Y I;A
J A Q P Z | Z J A P;Q
F D J P Z | F D J Z;P
T S M C F | M F S C;T
L Q V H D | Q V L H;D
Z W K P M | M W P Z;K
T R X B G | X G T R;B
D C E T L | T E D L;C
S C E V A | S E V A;C
T P N J A | J A T N;P
N A T R B | R T A B;N
E B F K V | F B V K;E
X Y I H S | X Y S I;H
A D I H T | T A I H;D
G T L U X | L G T X;U
N Q C W A | Q C N W;A
N C D Q K | Q N K C;D
B Q P Z G | Q B G Z;P
I X O B Y | Y I B O;X
C P O G F | G P F C;O
R I X G T | X G R I;T
S C F B V | B V C S;F
S Z B G X | S G X Z;B
C L B A Y | C B Y A;L
H T W E I | E H W I;T
X M K T V | M V X K;T
X F I Y J | I Y X J;F
G M Q S B | S G M Q;B
I Q Z V T | Z V Q T;I
R X P H W | R P H W;X
T L W M R | M L T R;W
O A H D I | D A O H;I
X C M S D | C S M D;X
G V O B R | B R O G;V
U E C W I | U C I E;W
X R T Q M | Q M T R;X
G Y Z C M | M Z Y G;C
S P H U Y | S U H Y;P
Z V F S U | F U V S;Z
P M H I O | O P M H;I
B V L T X | V X T L;B
U O N C K | O K C N;U
H G Y A N | N Y H G;A
J I E R X | J E X I;R
T S I X O | O I X S;T
A B U V Q | A U Q B;V
A L J X S | L J X S;A
N D V P X | D P X N;V
K L B Q N | K L Q B;N
X O R Y J | X J Y O;R
N V X O E | O V E X;N
D U Q E X | E U D Q;X
B Y E S P | B S P Y;E
V Q F H M | Q V F H;M
U V A S T | U T V A;S
W T X K E | T W E X;K
C B A S P | P S C A;B
A C L I S | I L A S;C
J H Z B X | B H Z J;X
M O Z C U | C Z M O;U
O E J C W | C W O E;J
D F I H U | H D I F;U
U H E O A | E A U H;O
T G W A J | G W J A;T
Z P X G B | B G X Z;P
I S T U W | U T S W;I
V W X T F | F V T X;W
X Z T S I | T I Z S;X
Y R U P J | J Y U P;R
D A F I J | F J I D;A
G X P O N | G P O N;X
O Y G T M | O G M T;Y
F U K W J | J F U W;K
W V P U E | P W E V;U
Y R H D N | D Y R N;H
R J O F W | R J W F;O
B I P J D | J B P I;D
Y E M I D | D Y E I;M
D C L S H | C H D L;S
Q D O B N | O N B Q;D
V E L K T | V L T E;K
G Z D A I | D I A G;Z
F B K P D | F P K B;D
R M P H I | R P I H;M
S H A Q K | K Q A H;S
U I P G Z | I P Z U;G
B T Z P H | T Z H P;B
A L N U I | N U I L;A
P Z F O X | X Z O F;P
O J S T E | S J E O;T
S G K W J | J K S G;W
F A V U S | A F U S;V
M Y D S O | S D Y O;M
Q J C P M | C M P Q;J
G Z U S I | G Z S I;U
M Y W E Z | M E Y W;Z
Y C J G K | K Y J G;C
Y Z S V E | E V Y Z;S
M P L R E | E M R P;L
L O F K R | O R F K;L
B V I Q C | I Q B C;V
R N B Y C | N B C R;Y
I K J L E | E J I L;K
P R M O I | O I R M;P
L A E O I | O I L E;A
U Q Z F C | U Q C F;Z
D A W U S | W U A S;D
P R M D E | M R D P;E
W E J O K | O J E W;K
F U T C R | T R F C;U
X I D C J | X D I J;C
P B F D S | D P B S;F
W S P T H | P S H T;W
Q O W L J | O L Q J;W
Y G E Q N | Q G Y E;N
Y O N S F | S Y O F;N
M R C G T | R T M G;C
S O G T L | S L T G;O
Y E B M Z | M Y B Z;E
Q C O X D | Q X C D;O
O Q U C P | U C Q O;P
R A O U E | U R O A;E
I Y D V H | I Y V D;H
L G F U Z | U Z F G;L
Q P V B C | C Q B V;P
T X Q S M | M T S Q;X
L I Z J S | Z J L S;I
R D I H M | M I D H;R
W H A Y Z | H Y A Z;W
U B S J A | J U B S;A
U L R F I | F I L U;R
V X E F B | E F B X;V
S J Z K T | K S J Z;T
E W S N J | E S J N;W
B H Q J M | Q B J M;H
E D R A T | T D R E;A
K Q I M D | M I Q K;D
N B A X T | X N A T;B
R O V K J | J O V R;K
O J G S Y | Y G S J;O
V H U Y K | K V H Y;U
G S E U I | U G S I;E
D L W K V | W D V L;K
I C X S B | S C I B;X
W Q B X U | B W U X;Q
B D M K E | B D E K;M
M L X G V | L G M V;X
R O N B F | N B O R;F
A X H Z S | A Z X H;S
Z H Q E U | E H Z U;Q
C E N G Z | Z C N E;G
N G B Q V | Q G V B;N
I J N H K | I N H K;J
P L X Q Y | X Y L P;Q
O L C S H | L H C S;O
I M G T U | U I G T;M
O A M Z G | M Z O A;G
W E B S P | P S E B;W
B J W T I | J T B W;I
N L W H U | U H L N;W
U A P Y S | S Y A U;P
G V A Y S | V Y A S;G
P Y G C M | M Y C G;P
P J O X E | E J X O;P
Q C V Y B | Q C V B;Y
O U L E B | L E O B;U
R Y I A X | Y R I A;X
H A M N K | H K N M;A
C A O N K | K C A N;O
X Y R L G | G R L Y;X
P F W A H | H F W A;P
S L G K V | K G S L;V
D Q X A S | D S X A;Q
N L I K Q | N I Q K;L
Z J L N I | I Z N L;J
V M I N R | I V N M;R
V O C W S | C V W O;S
B Y P U D | U Y D B;P
P U M K G | G K M P;U
P U O J N | U N O P;J
K F T X D | T F K D;X
E X V K C | E C X K;V
T X S G O | S X G O;T
W F O B D | W B O F;D
U W I Q E | I Q W E;U
R Q T N Z | N Z Q R;T
N J G U V | V U J N;G
L V H R M | R H M L;V
D J B W E | E B J D;W
X C P K L | L X C K;P
Y Z O C U | U Y O Z;C
N I U G L | G I L N;U
C Z I N P | I N Z C;P
L W E C I | E L I W;C
Z S U N H | N S U Z;H
O Z U J Y | Z O Y U;J
F R T Z C | Z R C F;T
R H I U V | R H I U;V
H C W U L | W C L U;H
C O M P W | P W M O;C
X M D O E | O X E D;M
C P G F E | P F G E;C
L F N Q H | L N F H;Q
J Z W A Q | W A Z Q;J
R F W Y O | O R Y W;F
X Q P Z G | P X Z G;Q
T P B O X | B T O X;P
H V P U J | V P H U;J
I D L T C | L T I D;C
P B F U J | B P J U;F
V L F H U | H L U V;F
D M Y P W | M Y W P;D
Z K I T A | K Z I A;T
T B G N H | H B G N;T
D S H K P | D K H P;S
D O S A K | K S O A;D
U K S Y H | S H Y U;K
L Y F E K | Y L F K;E
P D A M U | U A D M;P
Y J Z D L | J Z D Y;L
O T K A U | T A O K;U
F K L D W | L K D W;F
W V G F J | W F G V;J
L P Q A V | P V L A;Q
B Q X K J | Q J K B;X
T G I U A | G I T A;U
F Y R N E | R F N E;Y
D X W A I | X D A I;W
V M N R Y | R Y M N;V
D Z M T Q | Q M D Z;T
B P E U J | P B J E;U
R E F A Y | R Y E F;A
M V G X I | V G I M;X
W P U X F | X U W P;F
X U P D L | X L P D;U
O N F J C | O C N F;J
G N Z W C | Z C G W;N
L I T U G | T G U L;I
J V G B A | A J V G;B
Z V I S W | V W Z I;S
B Z M U Y | M Z Y B;U
G Q H V Z | Q Z V G;H
G N B L T | N G L T;B
R O J X P | P X J O;R
Q G P K B | P Q K G;B
I F L R A | F L I R;A
C J I Z U | J U Z I;C
C V W K D | V W C D;K
D P O X Q | D O Q P;X
C K H Z O | C Z H K;O
W X N Y R | R N W X;Y
Y L O S M | S Y M O;L
L I K W R | K L W R;I
I N Z L Q | Q L Z I;N
L W D R U | D R L U;W
Y H I M J | J I Y M;H
E X Y N W | N W Y X;E
W K D Y E | D E K Y;W
L K M W J | K M L J;W
E H T L N | H N T E;L
D Q P I N | Q N P I;D
L T D R I | R L D I;T
O Z C K F | O F C K;Z
F L E Z K | Z L F E;K
F S U L I | S F U L;I
J Z N E K | E K J Z;N
E T Q S A | Q A T S;E
R E C Y J | J R C Y;E
Y Q C S B | S C Q Y;B
O S M F D | D O M F;S
D A P L W | D P W A;L
A I V H O | V H I A;O
L P V X O | P X L O;V
S A M D T | S M T D;A
D P T A W | T D W A;P
H M R E T | T H R E;M
W Y S N F | W S Y F;N
C Y F L D | D F C Y;L
Y X B L A | X A L Y;B
B U Y A T | A U T Y;B
A C B Z D | C Z B A;D
M X E K Q | E Q M X;K
L T D A K | K T L A;D
Y C K A L | A L C K;Y
Z N A O V | V A Z O;N
J Z R Y E | R E Y J;Z
K S H Q M | H M S Q;K
U M F Q Z | M U Q F;Z
N V H A U | N V A U;H
K J Z R E | Z K R J;E
X Q K W E | W X E Q;K
U E N G F | E F N G;U
Z W G Q E | Z Q E W;G
K X I W J | J K W I;X
R O B P N | O P R B;N
F U J W X | U F X J;W
Z D L Y Q | L Q Y Z;D
S H Y J W | J H Y W;S
K F H J Z | K H J F;Z
Q O W C T | Q T O W;C
F E Y J R | E J F Y;R
U A I N B | B N I A;U
J Q V K P | V P J Q;K
V E Z I A | I Z E V;A
V Q X J U | Q V U X;J
T C U J Q | C Q T U;J
P K G E B | B G K E;P
N D Z M A | Z M D A;N
Q L H C M | L H C M;Q
C F X J Y | X C Y J;F
C D Q Z R | C Z Q R;D
O N V Y B | B N Y V;O
C N A Q I | N I Q A;C
B R E Z J | E Z B J;R
Y B X G F | G X Y F;B
H G W U Z | G W U H;Z
G T P W N | T G W N;P
L M W J U | W U M L;J
L B N H P | P H B L;N
Y Q M I R | I M R Y;Q
C D F J O | C D F O;J
A I D U Y | D Y U I;A
P R X O V | P V O X;R
W I L R M | I R W M;L
S A C O Y | A Y C S;O
S R O V I | S O R I;V
Q E M H L | M Q E H;L
Z C R Q A | C Z R A;Q
Y J P N G | G P N J;Y
V R U Z H | V H Z R;U
I E R B O | R I B E;O
N O P T D | D O N P;T
P O J N S | O S J N;P
A C J V P | A J V P;C
M A B T S | A S T M;B
B E S A J | A E J B;S
O I D W K | W O D K;I
N Y C U W | C U W Y;N
A T I V X | V X I T;A
U L H R C | C L R H;U
Q H E G J | E G J Q;H
X A F V M | X A V M;F
Q I V Z Y | Y V Z Q;I
A H M Y L | H M Y A;L
V W X J B | V W B J;X
Z B U O J | B Z O J;U
E V K H T | K H T E;V
L B S D J | B D J L;S
C I L D U | L I D U;C
W L H T Y | W Y L H;T
D T F X K | T D F X;K
I O M V N | I V M N;O
T Y C V F | Y T C F;V
Q R L E I | Q L I E;R
N S A P O | N A O S;P
Y R E V K | K R Y V;E
H M D K P | D K P M;H
H M N E G | H G N M;E
N Y T H M | Y N M H;T
W H D X G | X W D H;G
T J L C D | C T J D;L
Y A X J T | A J Y X;T
T S L I F | L F S T;I
I K C Z S | S C Z K;I
R Q N J T | N J T R;Q
F K E P X | X F E P;K
A Q X H P | P Q A X;H
T G L I W | I T G W;L
E L H P D | D L E H;P
W L Y T D | L W D T;Y
G T D H E | H E T G;D
Y V P Q U | U Y P V;Q
P Y J S B | B J P Y;S
N J H O K | J N K H;O
W P K E V | K E W P;V
X V T F E | V X E F;T
S Z V I C | S C I V;Z
Q W T H E | E H T Q;W
H N U F G | U G H F;N
U E T J C | U C E J;T
N Y W G A | A N Y W;G
W U L H T | U T H L;W
I J Z W L | I L Z J;W
K N O X A | K A N X;O
K L T J B | K T B J;L
D T O W Y | T Y O W;D
G C O S P | P O C G;S
K T S J U | K T J S;U
J L E P R | E L J P;R
M V R W L | L V R M;W
Y T Q V M | V T Y Q;M
C F X Y Q | Q F C X;Y
R L Y C A | C L Y A;R
L N E I R | R E I L;N
D G N C U | N D C U;G
F K V E N | E F K N;V
D C W G E | G W E C;D
G A W U X | A X G W;U
X R Y U D | X U Y R;D
A X N O K | X A N O;K
Q N B T P | Q T N P;B
W M R O L | R W O L;M
N M V W U | W N U V;M
C D M R X | R C X M;D
Z P A Q J | J Z Q P;A
M J F D X | X F D J;M
M F H O G | O G F H;M
G H Z O I | O H I G;Z
H N P M V | H V M N;P
F N R S H | H N F S;R
Z R N W V | W N R V;Z
J F R V P | V P J R;F
B V Y K T | K T Y V;B
Y I O M V | I V Y M;O
K N P M R | N K M R;P
P C Q I M | M I Q P;C
U Z A Y Q | Z A Y U;Q
K G J B F | G J B K;F
H I D W T | D W T I;H
E W I Z S | E W S I;Z
S U K D A | K D U S;A
R M G E X | R X G M;E
W E I A H | W A I E;H
I Z B C X | C X B Z;I
U Q C E Y | U E C Q;Y
Y S O V L | O Y L V;S
T O B Q S | B O Q T;S
G U O N E | E U O N;G
C W B G S | C S B W;G
P Y V B J | V P J Y;B
J M T K R | K M R T;J
Z N F L H | Z N H L;F
O A N P W | N A P W;O
S I T D F | D F S I;T
F N S T I | T F I S;N
S Y J P X | Y S P J;X
K B N A V | A B N V;K
L W U F A | L W U A;F
J Q L K S | S Q J K;L
L J D K P | J L D K;P
W P A M T | A M W P;T
H T M A Q | H A Q T;M
P V N R Z | N R P Z;V
R O H I L | L R O I;H
V W N M D | N V W M;D
N E F G S | S F E N;G
X V C M L | L X C V;M
X V M U G | X G V U;M
L J K B D | B L D K;J
S Y C G Z | Z G S C;Y
P U V Q R | P V R Q;U
C N O K P | K N O P;C
I P K U H | I H U K;P
S H M E N | N S M H;E
N G T D U | U G T N;D
F A N Z P | F Z A N;P
R P W J L | P R W L;J
G O S R U | U O G S;R
X E J V O | O V X E;J
W P T L F | T L F W;P
I D B M V | D B V M;I
Z P B A H | P A B Z;H
C B V S J | J C V S;B
L Y C S M | Y L M S;C
E P Q J O | O Q P E;J
D M X R W | W X M R;D
Z R I C D | R I D C;Z
K Q I J L | K Q L J;I
P H I A C | H A C P;I
W S G H Z | W H G S;Z
J S P Z H | S H P Z;J
Z B C M F | F Z C M;B
A U L H K | K L U H;A
G C U D Y | Y U G C;D
A L O J F | L F J O;A
B J E K R | R K B J;E
S A D R I | S A D R;I
O F A Q K | F O K Q;A
Q S L O C | S C L Q;O
Z W O E I | I O Z E;W
L C T J P | C J P T;L
Y N H K S | H S K N;Y
S K X Y D | Y D K S;X
B Z K Y I | Y I Z B;K
T B C A H | H T A B;C
K B D A Y | K B A D;Y
X F E O D | E O D X;F
M W A D I | A M D I;W
V I P O A | P A I V;O
Q O B N Z | B O Z N;Q
I F S M N | N M S F;I
D S R H Z | D R S H;Z
Y I V C S | Y I V S;C
M P R Z H | P Z M H;R
G N O K S | N S K G;O
K H A R J | K H J A;R
Q E M I C | C I M Q;E
O J B A M | B O M J;A
V D Q B O | Q B V O;D
E D W K H | D H W K;E
Z D W P R | Z D P R;W
N K W J F | K J W N;F
Z V J R S | R S Z J;V
A S L M N | L A M N;S
R S B E G | R B E S;G
X H Z F W | H Z F X;W
V Y R F A | A Y F R;V
A I F V P | F P I A;V
T K F H X | X T H K;F
N F X O K | O F K X;N
H M Y L Z | M H L Z;Y
Y W U K X | U X Y W;K
B U P V Z | B Z U P;V
P B T R J | B P T R;J
C D V I K | I C K V;D
R D P A T | T A R D;P
U M X D A | M D A X;U
C Q B W J | J Q W C;B
A Y F D K | F Y D A;K
Z W Y V E | Y Z W V;E
L C P N Z | L P C N;Z
V C Y G T | T C V G;Y
I Z K A J | I A K J;Z
P Y D S E | S P D E;Y
G E J U M | E M U G;J
Q W X J I | W Q I J;X
F Q P D A | D A Q P;F
I Z O W M | I Z W O;M
W Y N Q F | W Y F Q;N
C A K J M | C J A M;K
Q D H U E | Q U H D;E
D N K V Y | V N K Y;D
T N Y V L | T L N Y;V
W L H K A | A L K W;H
M N D A W | M A N W;D
K Y N P E | E N P K;Y
S X C B L | L B C S;X
Q N C B L | B N Q C;L
K F N M J | N F J K;M
R Y U D N | R D Y N;U
E A R Y L | L A R Y;E
A F K T V | K F T V;A
Q J O E I | Q O I E;J
F J L Q B | Q L F J;B
M W L R S | M L R S;W
J E L G T | L G T J;E
H I C Y T | I Y H C;T
L Z Q H R | L Z Q H;R
J S K X D | X J S D;K
S X N Q A | Q X A S;N
P W X B A | B W P X;A
H L C X T | H L C X;T
E W A H Z | Z A E H;W
M A Z Y U | M Z U A;Y
L X I R A | A L I R;X
Z Q B U T | Q U Z T;B
S H G Q W | H G S W;Q
A B E N I | N E I A;B
I L R S Q | Q R L S;I
W C D M O | O D M W;C
Q M I S O | O S I Q;M
G J Q B T | T B G J;Q
C G E Y K | C K Y E;G
F B S I P | P F I B;S
I S B A O | B S O A;I
F B S V N | F V B S;N
S H I F Y | H F Y I;S
T F D W N | N W F D;T
O K A W D | O D K A;W
B O J Y S | S O J Y;B
M P W O Z | Z O W M;P
J C Q R L | R C J L;Q
Y N R A T | R T N A;Y
T Z K V D | K V D T;Z
V P R I O | P V I R;O
B V U W D | U V W B;D
J K P N Q | Q P K N;J
A F T X B | B A F T;X
S T Z Y G | Y Z S G;T
U I K A J | J I K U;A
X R Z G D | X D Z R;G
W Z I X Q | W I X Q;Z
Y V X R H | Y R X V;H
S N K B I | S B I N;K
I N F B O | I O F N;B
T E P J C | E T J P;C
L G C B V | G C L B;V
E X J R W | W X J R;E
N C T A B | A B C T;N
E U J S B | J B U S;E
J P C F G | G C F J;P
I E T U W | W T E U;I
Q M Y P O | O Y P Q;M
G I B O W | G I W B;O
R M S D L | R D L S;M
T E O J H | H E T O;J
F A H T U | F H T A;U
O A B S U | B A O S;U
L F O U W | W U L F;O
K T C F M | F C M K;T
O J F L S | L F J O;S
Y E Z C W | E W Z Y;C
Q O H X B | Q B X H;O
K X H F B | X B K H;F
M G U N H | G M N U;H
D S X Z W | D X Z S;W
M N I J K | I M N K;J
U S P C M | S C P U;M
A P J O L | J P O A;L
W N T A D | A D W N;T
S I Q K O | K Q S O;I
N B G K I | N K B I;G
P H Z V U | Z H P U;V
W I H S R | H I S W;R
C A N Z Y | Y A Z N;C
K O A G X | K A G X;O
E M C K O | O M C E;K
A M Q G Z | M G Q A;Z
J I G H O | O G H I;J
S G H J Y | Y J S H;G
B W I C A | C A B W;I
X F E Z S | F S X E;Z
V D Y O N | O N Y D;V
W S O G P | G W O S;P
I C G L D | D L G I;C
U Y T A I | U Y T A;I
I Q D T F | D T I Q;F
Y M G C J | G C J Y;M
B D L I U | L U D B;I
T D Z J R | Z R D J;T
V N D F T | F V N T;D
A E O F B | O F B A;E
M P A F K | K P A F;M
O K F P S | K O P S;F
E P W I O | E P I O;W
P O Y V G | V Y G O;P
H M E K G | M H K G;E
W M O U L | M W L O;U
L P S O W | P S L W;O
H L T K B | H L T B;K
N C Y Q M | Q C Y N;M
G X W S R | S W R G;X
H K Q S C | H S C K;Q
I P Z W B | I Z B P;W
M I L Y Z | Z L M Y;I
P O A U T | O U T P;A
I Z T R P | R T Z I;P
J R G W E | E W G J;R
J Y G K R | Y J K R;G
A Y Q T D | D Q A Y;T
F K H Z N | H Z K F;N
S R H X V | X H S R;V
I F R Z O | Z R I F;O
M U H A Z | Z U H M;A
U I L R W | L W U R;I
Q N U Z B | B Z U Q;N
Q I K E U | Q U I E;K
W L H E Q | Q W E L;H
B Z Y W C | Y Z B W;C
N Y U B Q | U Y N B;Q
Z M G E J | G E Z J;M
R E V T P | T P V R;E
H O S A L | H S L A;O
M N J O T | N O M J;T
U A Y P B | U P A B;Y
D Q G K F | Q F D K;G
G J V Y X | Y G V X;J
B O P W M | P B W M;O
B I S O L | L O S I;B
V B G J H | B J V G;H
H S I O D | O I H S;D
F A J O M | A J O F;M
L G R Y E | L E Y R;G
B R G I J | J B R G;I
M E N V G | N G V E;M
W M T G S | M T W S;G
I O H G V | H I V G;O
K I N O Y | K O N I;Y
D E M B G | G D M B;E
G Q E O H | O G Q E;H
T N P W B | P B W T;N
C G J X Z | G Z X C;J
O V S D B | D V B O;S
Z V D T O | O V T D;Z
F N U E Z | U F E Z;N
N L D B M | M B L D;N
J P W K Q | W J K Q;P
G A S Z B | G S A Z;B
E N D F C | N D E C;F
E O Z B M | O B M Z;E
H G A W P | W H A G;P
V W F I K | W I F K;V
N J E H G | H E G N;J
X V G Q O | Q O X G;V
I C V J B | I V J C;B
E S V A R | S E R V;A
A R M B W | M W B R;A
E R O U Y | R U O Y;E
N E V F J | N E J V;F
M G W Z U | Z W G M;U
G Q R M X | X R M G;Q
C I A Q U | I A C U;Q
P Q H D V | D Q H P;V
I J V L H | L I H V;J
T W H Y R | T R H Y;W
N K Y V C | Y C N V;K
N H M K O | O H N K;M
W Y O T M | T W O M;Y
M E H A Q | E Q A H;M
F X M G E | M E G F;X
R H U G N | G U N H;R
O T Y R S | Y O S T;R
X B C S I | C X B I;S
F X R T W | F R W X;T
K B Q L U | Q B L U;K
E G T H B | H G E T;B
B E Y T M | T B Y E;M
A Z H X S | Z A X S;H
A X H I Q | Q H I X;A
U J N X M | J X M U;N
F Y I B H | H Y F B;I
A I D H F | A D F I;H
N M W H U | N H M U;W
Z T P S U | P T Z U;S
R A M F H | F R H M;A
K T H F C | C T F K;H
B A E L T | A B E L;T
C J Z G W | J G W C;Z
F I A G U | F A I G;U
I B C L P | P B C I;L
O E K U M | U M E K;O
M D S O L | L O D M;S
B U R K D | R D K U;B
N D F O U | D U N F;O
P V E Q R | V Q P E;R
V N L R C | C L N V;R
Q E D I N | I N E D;Q
C D L F T | F D C T;L
G X I W D | X D W G;I
P U V F I | I F V P;U
O N B Q X | Q X B N;O
Y J I W H | W H J Y;I
C G L W X | L W G C;X
R D H W K | D H W K;R
J I P E X | P J E X;I
J Z D R A | R J A D;Z
N O B H L | B H N O;L
L C W O V | O V W L;C
Q C R D E | C R D Q;E
A F I U M | M A I U;F
B C K R V | R B K V;C
U N W X Q | W N Q U;X
R N H T B | B T R H;N
A M T F P | T P M A;F
W F B Z T | W B T F;Z
A R Z Q B | B A Z Q;R
F A M P W | M W P F;A
Z S C B X | B C S X;Z
N P L K I | I K P N;L
Z X O U C | C Z U O;X
I N B S G | N B G S;I
V Q D X O | X O V Q;D
C Q B H E | C H Q B;E
E F Y V W | V F E W;Y
P A R G O | P A R G;O
T H M Q D | M D H Q;T
U Z J A X | X J U A;Z
T J Q K Y | Y Q J T;K
V P T U K | T P K V;U
W V T L A | W A V T;L
F U W V T | V W F T;U
B F Y A V | B Y F A;V
B T A O V | A O V B;T
P Y Q Z K | Y Z K Q;P
R Y M G D | M R G Y;D
T L Y O I | T I O L;Y
Q P I O W | Q O P I;W
J H E F B | J F H B;E
G K R E S | G E K R;S
L V S P Q | P S V Q;L
W J N F H | N F H J;W
O Z B K M | K Z M O;B
R S K C J | C S R J;K
O A C B E | C A B O;E
D A C H Z | D H C A;Z
Q A V K J | A Q V K;J
I E H X D | X E D I;H
X W V S K | V K W S;X
B H N C D | B C N H;D
U N T P O | P U O N;T
D V E T W | E V W D;T
S B X E Y | S Y B X;E
D E Q W O | O Q W E;D
E L T A K | L T A E;K
I E C K J | K J C I;E
X H U W K | H K W U;X
H G O V Y | H V Y G;O
T J B N A | A B J T;N
H S N A L | L A N H;S
M W F A I | F W A M;I
V I O H F | O I H V;F
H L X E K | K E H X;L
J K D I G | J G I D;K
I Y M X T | Y T M I;X
V B F I M | V I F M;B
C S Z M Q | Q M S C;Z
O I D Y X | Y X O I;D
D M W J U | U D M W;J
G F B C W | B C F W;G
C D S N P | C D P N;S
Z G M E T | G E Z T;M
B S P A O | B A P O;S
I Y C W T | T W C Y;I
Y P L B Z | Z Y B P;L
B I L Q S | B S Q L;I
C M H X J | X J M H;C
E B O S G | E G O S;B
N L P Q R | N Q L P;R
I Q V W F | W I Q F;V
B C Y P F | F Y P C;B
E J A T I | J T A I;E
O G Z V C | Z O C V;G
O Y R Z B | R Z Y B;O
T W V S C | C T V S;W
K D S A F | A F D K;S
D V N P M | N M D P;V
I U T V F | V U F T;I
L J H R G | H L J R;G
Y L E B R | Y B L E;R
Z N V T X | T N Z X;V
E G Y J C | C E Y G;J
R Z S W I | I R W S;Z
U A Y W D | Y U D A;W
C A I Q Y | C Q A Y;I
H S Z D M | S D Z H;M
V T W D O | O T D V;W
B H L O M | O B L H;M
K L A H Q | K H Q A;L
Q O E F M | Q O F M;E
N L U E D | L U E N;D
K J L W V | W K V L;J
S J T Y V | S J V T;Y
U D I H Q | H I D U;Q
W Y Z P L | L P W Y;Z
Y E V D P | V D E Y;P
O I F C W | I F O W;C
C N Q J A | A J Q N;C
E J F W Z | F E Z J;W
V M Y I F | Y F V I;M
S X U A N | U S X A;N
K Q U Z H | Q Z H U;K
X M N Z F | F X N M;Z
M F P J O | O M P F;J
E J O R I | I J E R;O
E A G F J | G E J F;A
T R N S O | O R T N;S
Y N K D U | N U D Y;K
Y Z S U B | Y Z B U;S
H Q C A D | H Q D A;C
R A M S O | A S M O;R
L C H M D | M C L D;H
U Y M O Z | Z M U Y;O
R Y J M B | J R B M;Y
F I N Q M | I F M N;Q
S K A F W | S F W A;K
C W T O V | C T V W;O
U C D Z G | Z C U G;D
T K A R B | A B T R;K
R Y W O V | R W V O;Y
S G K R A | K G S R;A
U W H P J | J U W H;P
G D Z P J | G Z P J;D
L N I Q Y | L Q I Y;N
M O H B T | T H B M;O
H N I S T | N S I H;T
B C O D J | J C B D;O
O Q T U A | A T O U;Q
A P F O K | A F P O;K
N X K G F | N K X F;G
V A W I J | A J I W;V
R D J M H | M H R D;J
A G L V N | V N G A;L
T W Q X C | W C Q T;X
V M Y J T | V Y J T;M
Y D X U S | X U S D;Y
L X F K Q | K Q L X;F
Q R Y J A | J R Y Q;A
M R Q A F | M A Q F;R
H M L O I | H O L I;M
I G X R M | R X G M;I
V I G C J | G I C J;V
Z E J T R | J E R T;Z
M T A G R | T M A G;R
J F C E K | C J F E;K
P Y D S T | T Y P D;S
I Z K R H | I R H Z;K
C T R L I | L R I C;T
K Y T F U | Y U K T;F
B A W H L | B H A W;L
Q B I S P | Q S I B;P
O R F V E | E O V F;R
L V J X Z | Z V J X;L
G K V A C | V A K C;G
V U G F K | G U K V;F
X V U D G | V G D U;X
N F T K H | T H F K;N
I L X S R | I L S R;X
A O Y R N | A Y O R;N
M H I V O | O V H I;M
X C V L S | L S X C;V
V Y E S K | S Y E V;K
S W I M F | M I S F;W
K J R Q E | Q E J R;K
O W A E L | W A E O;L
L A W P C | L P A C;W
C J I B M | C J B M;I
Z C G B J | G C J Z;B
C M R Z H | Z C R M;H
Y D I S B | B Y S I;D
C L G I X | C I G X;L
B O J S C | C J B S;O
M Y N L T | Y T N L;M
Z P W K M | M Z W K;P
T L N W H | W T N L;H
B C X U V | C V B X;U
P B N I G | P B N G;I
D Z S E W | W E S Z;D
J L G R V | V J G R;L
P Q I A O | O A I P;Q
Q C N G W | W Q N G;C
P G X K Z | K Z P G;X
A O T R M | T A O M;R
M W O C A | M O W C;A
R O A F S | S R A O;F
E G U Q R | Q R E G;U
L M W Z B | W M B L;Z
M Q Y J P | P Q M Y;J
R H S O P | O H R S;P
P V T I O | T O V P;I
U J S D R | D S R U;J
O N R Z M | R Z O N;M
D U A X P | U P A D;X
O D I H A | I O A H;D
J I B A G | J B A G;I
X O D F W | D O F X;W
V J L B R | V R B L;J
Y G S J M | G M Y J;S
M G N I H | M H N I;G
K S X N T | N X T S;K
I M C Z R | I R C M;Z
W U Z E F | F Z E W;U
S V U Q P | Q V P S;U
X H R F I | I F R H;X
G R S V C | R S V G;C
T S H Z C | Z C H T;S
U S V P H | P H U V;S
S V M U Z | M S Z U;V
N G L K F | F L K N;G
O R C M Q | C R M O;Q
L G J R U | G U L R;J
W M F K S | S K F W;M
J Z I O K | J K O I;Z
G C Q V Y | C G V Y;Q
V I W S Z | W Z V I;S
H B C A J | H C J A;B
S Y K E D | E Y S K;D
N B W R O | O B R W;N
M J N L V | V N M L;J
J T B M N | B J N M;T
W O T N G | W G O T;N
E X L V K | E X K V;L
M J N X R | M N R X;J
V X L E R | R V L E;X
E I Y O U | E O I U;Y
G L Z N I | I Z N G;L
A U M B Q | M A U B;Q
A J T R M | J R M A;T
N C V B U | N C U B;V
Z G N D Q | D Z N G;Q
R Y G X T | Y R T X;G
M D C X W | M D C W;X
H M N T B | T N H M;B
D Y X H Z | Z D Y X;H
Q Y W Z L | W Q Y L;Z
J V M F Y | V J Y M;F
J U K R V | V J K R;U
J I P F G | P J G I;F
J S T A X | J A X S;T
Q G H R A | Q G H A;R
Q Z D Y C | D Y C Z;Q
A Q D P X | D P Q X;A
T K W R U | W R K T;U
M J I L K | M L I J;K
S T V P C | T C V P;S
Q Y S J G | Q G Y S;J
V U R K G | V R K U;G
Q W R X V | V R W Q;X
B Y V Z X | B Y X V;Z
C X R H I | X C R H;I
B H E X W | H E W B;X
J O P A H | J O P H;A
F P M R X | P X R M;F
N Z J D L | Z N L J;D
M H A G K | G K H M;A
W H N V B | N W H V;B
E C T S I | S E T I;C
E Q U J O | Q O J E;U
U S P W E | W S E P;U
O F S Z D | Z S O F;D
H P C K Q | K Q C H;P
K J U H S | J S K U;H
W O J L Y | O J L W;Y
Q L O C B | B Q O L;C
S J Q I C | J S Q I;C
O L P E Z | Z P O E;L
T K B Z N | N B Z T;K
L W O D I | O D W I;L
E C Z I G | G I C E;Z
F L S R H | F S R H;L
D Z X L B | Z X B L;D
L R A I C | R L I A;C
F Y Z A V | V Z Y F;A
V K O M Y | O K M Y;V
J I A X Z | Z X A J;I
Z H P L X | H X Z P;L
X A L S W | W L A S;X
P D U X S | X D U S;P
V L Y Z E | L V Z E;Y
T H P L F | H P F T;L
Y Q E Z W | Z Q E W;Y
D B N L E | E B L N;D
M J U I C | J U M C;I
I V N W C | I N V C;W
A M Z L H | L M Z H;A
V L D A I | I L D V;A
H N X T A | H A N X;T
K G U X P | P X G K;U
Z L E G Y | Y Z E L;G
W M C F U | F M U W;C
K C O T X | X O T K;C
H O M F D | M O F H;D
X E P S V | P V E X;S
C J M N Y | J Y N C;M
D E Y J M | Y J M D;E
P N I J M | J P I N;M
G C B W P | G P B C;W
A N J G K | K N G A;J
O H S X V | V X H S;O
F N T C V | V C T N;F
J L K A T | L T K A;J
G R V T Z | R Z V G;T
G N D M L | N G D M;L
R P V X M | X P R V;M
Z F U D R | D F Z R;U
K V X J P | V X P J;K
B K R W E | K R B W;E
N J I V U | I N J U;V
F W R V C | R V F C;W
S X M F K | F K X M;S
E Q A I Z | Z Q A E;I
D W V F S | D S W V;F
B Q T S A | A Q T S;B
D L C O B | L D C O;B
K Q D E W | K D E Q;W
H D W V F | D F W V;H
N U V B C | C V N U;B
H T D X V | T X D H;V
K A W S I | K S W I;A
V W O S U | V U W S;O
T B K L M | T B K M;L
X W K V G | X G K V;W
Z G L Q R | Q L G R;Z
C Q V Z O | O Q Z V;C
N O G X P | G O N X;P
Z R N M S | Z S N R;M
A Y U Z H | Y U Z A;H
R Q Y P X | Y P Q R;X
Q S J V M | J S V M;Q
G S D P I | S I D P;G
H A R B O | R O B A;H
E C B V R | B E C R;V
L E Y P Q | P L Q Y;E
P L W F I | L F I W;P
R E U C L | U C R E;L
W Y X H J | W J X Y;H
D S C N X | C N D X;S
X S F I A | X A S F;I
A W G F P | G P F W;A
Q U T H S | U S Q T;H
F L O K C | C K O L;F
A L Y Q R | Q R L Y;A
N U R B G | U B N R;G
L J Q F D | L F D Q;J
X H M F Y | Y X H M;F
G V S Q K | S V Q G;K
Z W A U N | W A Z U;N
Z Y X K E | Z E K Y;X
P S A G D | P A D S;G
X D E R U | U R D E;X
D E C G K | C K E G;D
U T Q B H | T Q B H;U
Y O L X B | Y B X L;O
L C Y U I | C I L U;Y
A N T B X | N X A T;B
Y T V G E | T G Y E;V
M A T X N | T X N A;M
C Z O N W | Z O N W;C
M X F P U | X F P M;U
E R S I C | E R I S;C
X Y S Q A | X Q Y S;A
S V J A L | A L J S;V
V Z U N L | N L Z V;U
M A N V Y | A N V Y;M
J U W L D | D W L U;J
C L J Q F | L J Q F;C
C Q V Z N | C Q V N;Z
G Q E I S | E Q G S;I
B H F A O | B A F H;O
B W D E H | W E B H;D
B H S P W | P S H B;W
A W N G E | A W E G;N
W N H P Z | Z W P H;N
Q O U G P | G U P Q;O
K P J C T | P T K J;C
I H C J D | D I J H;C
V E U F W | E V U F;W
W E T Z D | D T Z E;W
H Q A P T | T P Q H;A
P F V K D | F D K V;P
V Q S I G | I Q S V;G
K J G V X | K X J G;V
B O X D T | B T O D;X
Q Y F C R | Y C R Q;F
O T U S M | S T U M;O
G Q P D I | I G D Q;P
A K P O N | K O P A;N
L W N R Z | N L W Z;R
C Z F S M | C Z S F;M
K N B X W | W B K X;N
Y T C I A | A Y C I;T
F A V P Q | A Q V F;P
O I C B M | M O B I;C
R G O V P | R O P G;V
D P Q K L | K P D Q;L
F A I Q T | A F T I;Q
H I B U F | B U H I;F
V G O Q E | V O E Q;G
L E Q V I | E L Q I;V
P E H C U | E P H U;C
S H U L B | B U L S;H
L K X E U | K L U E;X
Q L H O N | Q H O L;N
D Q G O V | O V Q G;D
Y M O A N | O M N A;Y
H W U Q M | H U W M;Q
S T I E O | T I O S;E
I Y B W O | Y B O I;W
M Q W K F | W Q F M;K
S F X R L | R F X L;S
W Y K M E | K M E Y;W
S W H G K | H S G K;W
Y G W R Q | R W G Q;Y
X K V J M | V M J X;K
R Z T Y J | T Z R J;Y
F V U M E | M U E F;V
K D H C S | D S C K;H
V X E K F | E V K F;X
E F O M V | V E O F;M
H I P V J | P H V J;I
U A K J M | U K J M;A
L T G H E | H T L G;E
C L B S Q | L B C S;Q
B J S X W | B W X S;J
Y M O K S | O Y K S;M
J Y W U K | Y K W J;U
G L V U P | G U V L;P
H W Y A U | Y U W H;A
P J T C K | P J K C;T
I D S A N | D I N A;S
Y J F Q I | I Q J Y;F
W U E R C | U R W C;E
Y D Q K N | D K Y Q;N
S R W Y H | H Y R S;W
C F R H L | H R C F;L
E M S G X | M G S E;X
D H C R V | R D V H;C
T O G U X | X G O U;T
M U T N X | X M U N;T
L V I W A | V W L A;I
D Q N V O | V D Q O;N
G Q R D Z | Z Q R D;G
W S B Z Y | W S B Z;Y
T L B I Q | T B Q L;I
P H E R Z | P Z H R;E
S F R G T | T G F S;R
O L X C B | L X B C;O
W C T Z K | K C W Z;T
J P Y E X | P J X Y;E
Z Q X U O | Z X Q U;O
I Q G X W | W G X Q;I
N P W G S | G W N S;P
Q X D F O | F Q X D;O
R P F J O | F P R J;O
Q N A B V | Q V N A;B
B T J P R | T R B J;P
A D T B G | G T D B;A
R C J Y I | J C Y I;R
S L C X U | L S U X;C
M G E Y H | E H M Y;G
C A U W G | C U W A;G
X B P Y W | B W Y P;X
H W D Q U | W Q D U;H
S B W T Y | T W S Y;B
S I K Q B | Q S B K;I
M V N A B | N A B M;V
Z L I D U | Z L I D;U
Q F A P V | V F Q P;A
H Q Y D L | D Q Y L;H
K W E C V | W C V E;K
B D P Z Y | D B Y P;Z
P A I M N | M N A I;P
X K A N O | O X N A;K
C S T M H | M H T C;S
Y G F N B | F B N Y;G
C Q G V Z | V G C Q;Z
L I G X P | I L X P;G
O C T B F | F O T B;C
I H N X U | N I U H;X
K E B F Z | K E Z B;F
D R L Q Z | L Z Q D;R
R Q J F A | J R A F;Q
X K M D Y | D M Y K;X
U O D K L | O U L D;K
J L A Y N | Y L N J;A
B N M G K | G M K B;N
M Q P C F | F P Q C;M
J P W G I | W J G P;I
Y X C S E | X C S Y;E
U I T F H | T F I H;U
O D I F P | O I P D;F
I N U D B | D N I U;B
F M D S J | D J S F;M
E T W O R | R T O W;E
B W Q A C | W A Q B;C
V U S F M | V U M S;F
D E I Y B | D E I B;Y
N B Y L D | Y D B L;N
Y N R C E | N R Y E;C
B Z E W Q | B Z W Q;E
N B C U L | C B U N;L
D O Y F B | B O F Y;D
B D L J U | B U J L;D
Q F S T Z | F S Z T;Q
H Y T O B | T B Y O;H
U M C R B | U R B M;C
Y P D F G | Y P F D;G
U R S H I | U I R H;S
L W B D H | D H B W;L
A E Z R D | Z R A D;E
O M W C A | C M O W;A
F M C X U | F U M X;C
I J E Q U | E I U J;Q
H O A I V | I A H V;O
C V R S N | C V R N;S
A X K M E | X E M A;K
A O I Q V | O A V I;Q
E R P K I | E I R K;P
H U Y V O | H V Y U;O
A Q W C N | A N W C;Q
C O N Z E | C Z O N;E
I C W T N | T C N W;I
J Q M L I | L M Q J;I
M C Z S J | S J C Z;M
O A R Y U | Y U A R;O
P R T S B | T R P S;B
V F Y H I | F V Y I;H
P W M T G | G P T M;W
X Z H W U | Z U X W;H
V X E M O | O E X M;V
G B M L T | T M L B;G
G L J K T | L G K J;T
X C B J M | J C B M;X
U K H Z X | U H X K;Z
M Y S C A | A Y C S;M
W S E D J | W D S E;J
J V K H B | J V K B;H
P Q N B U | U N B Q;P
F N U P R | P R N U;F
L N I M H | H N M L;I
K T Q P R | Q R T P;K
S K O Y Q | Y S O K;Q
Z X D L C | X Z D C;L
B J L C Z | C L B J;Z
U N X G B | N U B G;X
O Q J F G | G J O F;Q
I U K G V | V K I U;G
Z Y H F K | H Z F Y;K
D P N Y C | Y P D N;C
U B A Y G | Y B U G;A
F Y Z W P | Y P F Z;W
O B E I H | O I E B;H
G P N Z J | Z N G J;P
D W X T A | A T W D;X
P Q Y T L | Q P Y L;T
Q S H L E | H Q L E;S
G W L B O | O B L W;G
M S P I K | M I S P;K
T C I B W | T I C W;B
A F L T J | L F A J;T
C H U R S | S H R U;C
I N D C L | C I N L;D
C A T U S | A T U S;C
O C X J M | X O C M;J
W R M T G | T G W M;R
D T B F P | F P T B;D
F T S Q D | Q F D S;T
R N E S T | N R T S;E
Q J E N Z | N Z Q J;E
S U K Z O | U O S K;Z
M O N R J | J N M O;R
I Z O A P | Z I O A;P
Y I A M W | A W Y I;M
R U O N P | P N R U;O
N L R T G | R G L N;T
B V I D H | H B D I;V
W V R J D | J V W R;D
X D B G J | G B D J;X
P T E O N | E P T O;N
D W B I H | B I D W;H
N Y W Z M | Z Y M N;W
J U Y W B | U B Y W;J
Z M J Y P | J Z P M;Y
D B T Y N | B T Y N;D
E R B G X | G X B R;E
Z P R A O | O R A Z;P
K M X C L | L M K X;C
G T J K N | T G K N;J
Z T J W X | W J X Z;T
J D Q C B | C J B Q;D
Y I C W X | C Y I X;W
K E R G A | K G R A;E
Z G H U C | C U H Z;G
U Y C L Q | Y Q L U;C
I W D G J | J G W I;D
B D R Y N | Y R N B;D
M V Q E W | V Q W E;M
U Q Y R D | Y Q D U;R
D A G S I | D G A S;I
H E T V P | V T H E;P
C H M F L | M F H C;L
G S R M Z | R S Z M;G
U A F M B | B U F M;A
V L K E O | V E L K;O
U K J Q M | M U J K;Q
A K N I Z | N K I Z;A
N G S Q V | Q G N S;V
X H K N I | K N H X;I
A K N J B | B N K J;A
X L R Y A | L X R Y;A
J F L S X | J F X L;S
M U B K T | K U T B;M
X L J C F | C L J X;F
O Z V U J | Z O U V;J
Y V Z K U | V Y Z K;U
C J A T E | E T C J;A
F X H Z Y | F Y X H;Z
Z J R Y P | J Y P R;Z
S A T X Y | S X T A;Y
D Y J Z M | Y M Z J;D
V U Q E K | K U E V;Q
F Z T D B | F B T D;Z
F X O E Z | E F O Z;X
E S D G J | E D J S;G
Z O X A U | X Z O A;U
U A Q I O | I Q U O;A
A N W L Y | N L W Y;A
H O S Z J | Z H S J;O
B E J Z L | E Z B L;J
D J X C V | J C X D;V
K F Z C N | F C Z N;K
P D K T W | T K P W;D
Y O L T R | O R L Y;T
W F N K D | K N W D;F
W X Q M N | X M N W;Q
M J B N K | N B K J;M
C Z X M O | X O C Z;M
F D B Y P | F P Y B;D
B E C P A | E A B C;P
G N Y H B | G H B N;Y
H E X I V | E X V H;I
D T K B R | B D T R;K
X W I J C | X I W C;J
D A E R O | E A R D;O
V Z R J P | R J V P;Z
E P O V L | O V L E;P
B R F N U | U B R F;N
Q Z U R M | U Z M Q;R
F Y A L I | A F Y L;I
V G R K T | R G T K;V
T A D W X | A X W D;T
R V Z Y M | Z Y R V;M
E R Q C G | C R G E;Q
H J Z S X | J X S Z;H
M C O E Y | E M C O;Y
A Y U J B | Y J A B;U
V A L R C | R C V L;A
S D B Z I | I S D B;Z
U A N X B | N A U X;B
B N M W Y | W N M Y;B
K P T A Q | Q A P K;T
A I B K O | O K B I;A
L C W Y T | L T Y W;C
J T U M F | M U F J;T
Y B D G F | D B Y F;G
L V C K S | K V L C;S
A S J P K | A S K J;P
K J P U S | K P J U;S
E A B C D | C B A E;D
O S X G L | L G S X;O
E U N Z F | Z F E N;U
K E M D B | B E D M;K
V B I A H | B I V H;A
K S H E Y | K H E Y;S
N A F M Y | F M Y A;N
N K D E S | D E S N;K
R T P F I | F R T I;P
E I Y N S | N I Y S;E
Q S D G A | A G S D;Q
F V C G M | C F G V;M
J X Y G M | G X M Y;J
J U W I V | W U V I;J
L X S I Z | S L Z I;X
L Y G E X | L X Y E;G
H Q W Y S | W H Q Y;S
L D G Z X | G X Z D;L
Q N M E Y | Q M N Y;E
A G D M V | G V A D;M
P W F Q X | F X W P;Q
D U C Q J | Q D U C;J
D U A E H | A E U H;D
K T O W J | K W O T;J
I J K M C | M I J C;K
Q K R B D | K Q B D;R
Y A S E F | E F A Y;S
O T D M H | D M T O;H
S F Q T B | F T S Q;B
V X I S M | X I S M;V
N Q E R Y | E R Y N;Q
G Y J L A | Y L A G;J
H V D F N | D F N V;H
Y E T N S | E N T Y;S
E I J W S | W S J I;E
K G S C L | C G L S;K
I U N X P | I U X P;N
D F O Q N | F D N O;Q
A S N Y I | A S N I;Y
E Z X V J | J V X E;Z
Q K Z D M | D K M Z;Q
W U F T M | M T U F;W
W K B H Y | K B Y H;W
Q S E L F | L Q S F;E
Z U X V J | U X J V;Z
P L E O C | O L C E;P
C T N Y Z | Y Z C N;T
Q T B L E | L Q E T;B
M Q N O S | S O M Q;N
U V W R L | W V U L;R
H U T W K | T W U K;H
N T B G K | B T K G;N
Z U Q L F | Q Z F L;U
A J V S D | A D J V;S
U A V D N | N D V A;U
Z C E Q N | Q N Z C;E
C J S T O | O S T J;C
M O A G R | A R O G;M
Q W X N K | W Q N K;X
Z L S Y B | Y Z S B;L
R S A N K | N K S R;A
K E B W H | B K W H;E
M A T F Y | Y M A T;F
R Q G W H | G R Q W;H
L D H V A | A D H V;L
C V A X S | V S A X;C
A H U S E | H S A E;U
J O N U L | J U N O;L
H K S Q A | A S Q K;H
I Y Z O N | I O Y Z;N
L G O M S | L G M S;O
S U D J A | S U D A;J
K S H U O | K S U O;H
V Q G W P | V W P G;Q
U P G N Z | P G U N;Z
O Z R X U | U O Z R;X
A J F T Z | A F Z J;T
Z I Q X A | Q Z I A;X
Z H C R E | H E C Z;R
D O F P B | F D O P;B
T R Z X E | Z X T R;E
W M T I S | S I M W;T
L N D I P | D N L I;P
L D B W U | L D B W;U
F A D R C | A C F R;D
O C U Q P | C U Q P;O
G W D T Z | G T D Z;W
E V J U T | U T J V;E
A Z S F R | A R F Z;S
T D A K S | T S A K;D
B J W Q K | K J Q W;B
R B V F A | B A V F;R
D T O I Q | I Q T D;O
Z O I B D | Z O B I;D
R K V B E | V E R K;B
Y F G L E | F E L G;Y
R B M I C | I B R C;M
P W G R Z | G P W R;Z
W B X K G | W X K G;B
Q V M B U | M U B V;Q
L K B U P | K P U B;L
Y U A Z W | Z Y A W;U
Q L C X G | C G X L;Q
Z L N M C | Z C M L;N
G K H F W | G H F W;K
D V T Q E | D E Q V;T
U M N W V | U M N W;V
E Y I X T | Y E T X;I
W E G Y B | E G B W;Y
V Z F W A | V Z F W;A
I W V U G | I U G W;V
J U H Y X | U Y H X;J
V T C G R | R V C T;G
X K T Y S | S T K X;Y
H L V U Z | L Z V H;U
L Z P U W | W P U L;Z
G I O D H | I H D O;G
B X S U R | R S X U;B
D X O B K | B K O D;X
M G N U X | N G M X;U
C U E Q K | K C E U;Q
T B S G F | S T B F;G
T V E G S | G T E V;S
L U C Q D | Q L D C;U
R H Q K L | Q L R K;H
I B Q O V | I B V O;Q
F R I V E | V I E R;F
F S J Y H | S H F Y;J
J G R X S | X J R G;S
T P A Z J | P T J A;Z
E X U O L | U L X O;E
T Z U Q F | F Q T U;Z
G I S Z H | I H Z G;S
K M A B W | K M W A;B
N W Z D X | W D Z N;X
J M T I B | J B M I;T
Q B E R X | X R B E;Q
O K F Z E | O E F Z;K
P U E D B | P D B U;E
Z M W Q V | Z M W Q;V
S Z H V P | Z S H V;P
B W H K U | H K B W;U
U D I J A | U A J D;I
F N Z C D | Z D F C;N
V B P X H | X V B P;H
O C K H V | V O C H;K
I T P S W | S T P I;W
J U O V L | O V J L;U
H I M Z W | Z W H I;M
M I U F L | U I L F;M
J O N M D | O J D N;M
P A W Y U | Y P U W;A
I W X R G | I R G W;X
J T U Z H | T J U H;Z
X V P K U | K V P X;U
X J A S Z | A X J S;Z
N V D A X | N D V A;X
J U V S W | J S W V;U
N S D L K | D K N L;S
N K G Y Q | Y K Q N;G
N A Z W R | W Z A R;N
E R I T U | R U E I;T
O C M U H | M H U C;O
J H A L G | L H G A;J
P E Z L Y | L P E Y;Z
R A E Z X | A X E Z;R
H B V D G | D G V B;H
X F H O P | X P F O;H
Y D W J I | Y W J I;D
O U D M W | O W U M;D
Q I N U G | G U Q I;N
G E V D Q | Q D G V;E
Q J I D T | D T I J;Q
U H D Y N | D N Y U;H
K U M E S | K E U S;M
U G Z N Q | G N Z U;Q
N K J F D | N K D J;F
S K Q L D | S L Q D;K
D Z H W F | W H D F;Z
Q N A E V | N E A V;Q
Z D N E U | N Z E U;D
M Z D V P | P M D Z;V
G I Y O L | I O G L;Y
M J D Z G | M D J Z;G
B R D C H | R D H C;B
J S H T U | J S U T;H
T O V J C | C T V O;J
R J Q I L | R J L I;Q
A T V M I | M T A V;I
S J V T K | K V S T;J
T I H U Y | T Y I H;U
T S A V Y | Y A T S;V
D Q F W G | Q G D F;W
V H F P A | F H V P;A
A X E S N | A N E S;X
B N M L H | M L B H;N
U Y I B H | H B I U;Y
X M J G N | G J M X;N
R N W Y M | Y N M W;R
W C T K Q | C T K W;Q
F A G X N | N X G F;A
T P W D V | T V W P;D
S I K A B | B K I S;A
S P K H Q | Q P K H;S
U C V E M | E C U V;M
A I F T C | A F C T;I
J R O E Q | R J E O;Q
X Y S K M | K S X M;Y
Q J S E U | Q J E S;U
T O Q N L | O T L N;Q
I C H K L | C H K I;L
Y R E B P | E B Y R;P
A E U D O | A D O U;E
A J E K T | E T A J;K
W P X R Q | R Q P W;X
A M T F D | M D F T;A
X C P K U | C U K P;X
M W R B C | C M R W;B
L G F U N | L U F G;N
I Q O V E | E O Q V;I
M U Y W R | U W M Y;R
C Q I G K | K I Q C;G
N M U T W | N U T W;M
W C N E Q | C Q E W;N
T R A J H | T J A R;H
H Z P F L | H P F Z;L
U C Q A V | C V U Q;A
Q V D U O | V U Q O;D
D L Z A M | M A L D;Z
P H O C S | C S P O;H
A F Z P B | B A F P;Z
G A D X I | X I A G;D
O Q P V B | B Q P O;V
P L M T N | P M L T;N
Q D F Y P | P D Y F;Q
I F R P L | R F P L;I
L U V X E | L V U X;E
W N H P C | N W C P;H
W M J T R | M R W T;J
U O J P X | O X P U;J
G B U T F | F G B U;T
V I S K R | R K V I;S
N O G B Q | B Q O N;G
N Y L O V | L V N Y;O
Y U L W R | U R Y L;W
T F O W D | F W T O;D
G J I S R | I S R J;G
T L D I H | I L D T;H
E D G M Z | E D Z M;G
C J O Q H | C H Q O;J
X N S U I | I N X U;S
Q U N L X | Q L X N;U
U A F E P | F A P U;E
F N X R A | N F A R;X
W T D F B | F B W T;D
T N V U F | V N T U;F
U E I B M | M I E U;B
U F H B Q | B F H U;Q
J X V O L | J O V X;L
Y A M N L | A N Y M;L
K Z J T N | T N J K;Z
C J H N Z | H N Z J;C
K O E G Y | Y K O G;E
A Z B I M | M I Z B;A
P X N R J | J N R P;X
P B C E M | E B C M;P
V X J N G | V G N X;J
I B K Z N | I N B Z;K
G W Z F I | Z I F W;G
J R L A S | A J R S;L
R A P D Q | Q R D P;A
T N I F S | F T N I;S
C R G S X | R S G C;X
Y B Q O Z | Z Q Y O;B
L Z J I T | J I Z L;T
J O X P V | O P J V;X
T P J U R | U J R T;P
T W M V Q | M T V Q;W
Y Z G A S | G S Z Y;A
Z N K L J | J K L Z;N
B X Y P A | A Y B P;X
G Y V B N | B G V N;Y
T M Y G W | Y G M T;W
V U F M O | U M F V;O
G D L V K | K V D G;L
N K Y B W | N K W Y;B
J U C S X | X S U J;C
O S Q B T | Q S T B;O
Z U Q K G | U Q G Z;K
J F U P S | J S P U;F
H L D O Y | H Y D L;O
Y F D E Z | D Z Y F;E
Q B V I J | B J I Q;V
L H U C F | C F H L;U
T C Y L E | Y L E C;T
P K F Z U | U F K P;Z
W R C V E | V C R W;E
X I C H J | X J I C;H
O E H L W | O L E W;H
O Z L C K | O L K Z;C
W M R O F | O R M F;W
V M Y K O | O V M Y;K
W U F K T | W K F U;T
F J X H I | J F I X;H
L D I P G | I L D P;G
A S O I J | I O S A;J
Z L Y V G | Z Y L G;V
F O N Q U | Q N O U;F
U K Y N D | K Y N U;D
C K J B Y | Y J C K;B
B V A J H | B A V H;J
A F H J M | A F M J;H
R Q L F C | F Q R C;L
M C Y T J | M J Y C;T
N R B Q Y | R N B Q;Y
D Y T J W | J D Y T;W
C M U H X | X H M U;C
J G N L E | L N J G;E
G M D A U | U A D G;M
K J B Q E | J E B K;Q
U G T W D | T W U D;G
Y A G N S | N G A S;Y
U C L B W | U C L W;B
J N R T M | T N J M;R
V R E T X | V R X E;T
S G R P C | C P S R;G
C R N K H | N R H K;C
U A W G X | W A U G;X
K A H J N | K N J A;H
I O R Q M | O I Q R;M
K W C P O | K C O W;P
G X S V Y | V S Y G;X
L W I V X | I W X L;V
E Q I P F | E I P Q;F
P N A Z U | N Z A U;P
E R X O Q | O E X Q;R
H F G M I | M H I G;F
S B W X M | M S X B;W
B T U V Z | Z T B U;V
G R K X B | R K G X;B
M S Z B X | S B M X;Z
F L B C O | O L B C;F
P M F V C | M V P F;C
L R E K P | K P E L;R
B W F E O | E B F O;W
T C V I U | V I U T;C
B H R U O | U B H O;R
K B O Q G | K G B Q;O
K C A Z P | P Z A C;K
I E C V D | D I C E;V
B Y E F J | B F J Y;E
K G W R V | G K W R;V
Z G U W P | G U W P;Z
O E Z L T | Z T E L;O
H K O T S | O K S T;H
W F Q S B | S B Q W;F
E A U M F | M A E U;F
X P Z I O | P Z I X;O
B O V W N | N W O B;V
N G F X L | G X L N;F
X S K W G | G K W S;X
A S I T E | I A E T;S
Z D E I Y | E Y I D;Z
I B O F S | B I F O;S
H A B N L | B H N A;L
D S G I A | D G I A;S
J U I F D | F J I U;D
B X G E L | E B L G;X
X J G Z L | G Z L J;X
B O Y X A | X A Y O;B
U K J H W | J K U W;H
W C J A M | J M A W;C
F C M S O | C M F O;S
B F O K A | O A F K;B
V D L S X | L V S X;D
B Q W Z H | B H Z Q;W
Y I K P C | K I P Y;C
Z W U F H | H U F Z;W
B M W I P | W B P M;I
W O P K Y | K W O Y;P
L G J I X | X I G J;L
S T B H I | T S H I;B
F V Z C S | V S F C;Z
F W B Z L | Z L B F;W
O R J E P | P O J R;E
J N P I Q | Q J I P;N
P A T K F | A P T K;F
G Z F Q N | G N Q F;Z
N O E T A | N O A T;E
W Y L O F | L W F Y;O
J K H L D | K J H L;D
Q Y P M F | Q P F M;Y
E G O F X | G O X E;F
B R P X U | R X P U;B
I Q J E B | B I Q J;E
J C Z U M | C M Z J;U
K S I J L | J K S I;L
T L O H V | T V O H;L
P G D Z E | P Z G D;E
T J L Y S | Y L T J;S
C V G J Y | Y G J C;V
B O Z K C | C Z O K;B
K Y N E Q | Y E K N;Q
Y Z J A H | J Y Z A;H
M E D X N | M N D X;E
J D O Z E | J D O E;Z
E T A F S | A T E S;F
O G Y N F | G N F Y;O
N F G W Z | F Z G W;N
Z K Y E O | E Y O K;Z
Y K Z F Q | F Z Q Y;K
J L B V N | V B L J;N
W C Q X M | M W Q X;C
J K D U L | L J U D;K
H C O G W | C W H O;G
A C T P X | C A T X;P
G O J L C | J C O G;L
B V L D I | I B D L;V
O X A F N | F N X A;O
Q H A J K | H Q K A;J
S V R W O | W V O S;R
W Q N I M | I N M W;Q
X K R D M | R M D K;X
S X B U Z | X U Z B;S
R E O J L | R E O J;L
X N I C U | C X N U;I
I U B H P | I B U H;P
X B A U E | X U A B;E
A U M I B | U A M B;I
S J Z V D | D V Z S;J
U P A D Q | Q P D A;U
Y H U Z V | Z U V Y;H
I L R T H | H L I R;T
J O M C K | J M O K;C
W X U F S | S W X U;F
P Y N O S | O S P N;Y
Q V C P N | N C Q V;P
S Z F W X | W Z F S;X
A D V Y I | D A I Y;V
Q L A C V | V A C L;Q
T W C H A | H W T C;A
H J F Z I | H Z F J;I
X P Q Z T | P Z T X;Q
S Z V T E | Z V S E;T
I V A P L | I L P V;A
H X Z W K | X Z H K;W
R U I X Y | U Y R I;X
W E Y I F | E Y I F;W
O K E Q D | K D O Q;E
G E R D N | G E R D;N
T M W D E | D M E W;T
D Q W U Z | D U Q Z;W
I A F H W | I F H W;A
X U C K T | T C X U;K
E O G I C | I C O E;G
H U J E R | U H E R;J
N Y H B Z | Y H Z B;N
Q G E Z F | G F Q E;Z
Y R X I T | Y I X T;R
D P G L O | O D G P;L
X B D C J | C X B D;J
D F U A E | E U A D;F
X Z F W L | F L W X;Z
D H W G N | N D H G;W
A G C Q S | Q C G S;A
Q P U H V | V P Q H;U
M L K N O | O M L N;K
O C E I K | K E C I;O
C R E N X | R N E C;X
J Z V C P | J P C V;Z
H Y U M G | Y H M G;U
X M A L Z | A L X M;Z
E H J M P | J H P E;M
H I M P G | G P M H;I
I L Y C O | C O I L;Y
Y H I Q W | Q Y H W;I
N L Z C H | C H N Z;L
I U L H P | U I L H;P
Y X N O F | X O F Y;N
L M G A P | G A M P;L
P I K F N | P I F K;N
Q K B V L | Q K L V;B
O U B A J | A J B U;O
M V O S D | V M D S;O
U M W P K | U M P K;W
E I F U O | I O U F;E
G K D C Y | G D Y C;K
Y C U N V | V Y C N;U
E B A U P | B A U E;P
L U K D P | U K L P;D
G R I S N | I S G R;N
U W C X L | U X C W;L
D O B Q L | L O Q B;D
Q N G X D | D X G Q;N
L F R S D | R L S F;D
W N I F B | F B N I;W
J D P A L | L A J D;P
Q P M Y J | J Y Q P;M
M R E S L | L E M S;R
H Q A V W | H V A W;Q
H R U V G | H G R V;U
T W P N L | L N P W;T
S E O R X | E O R S;X
K J V Y B | K Y J B;V
N G I T K | I K N G;T
C U D A V | D V A C;U
S X Z Y L | Z L S Y;X
U E G M A | G E U M;A
R L V Q W | W Q L V;R
R C F W L | L R F W;C
L K G W U | G W L K;U
O M R B X | X B R M;O
K V N A S | A K V N;S
X M Y W L | X M W L;Y
P B Q G K | Q G P K;B
B Y I Z M | I M B Y;Z
L H N Q D | D Q H N;L
L O Q G W | G L O Q;W
V W M Y Z | W M Y V;Z
Q C G S K | K S Q G;C
N T G P L | N P L G;T
C P L Y M | C P M L;Y
H B D A M | A M D H;B
S U K Z D | D S U Z;K
K S A Y H | A Y S H;K
D N Z C L | C L N D;Z
A I J B V | V J I A;B
W A Z N B | W N B A;Z
S Q I O B | I Q O B;S
P V C I F | I V C F;P
I C Y Q E | Y E Q I;C
X U A N F | N A F U;X
C P S D F | P C F D;S
Y E X K T | E Y T K;X
C R A S H | A S H C;R
I O L X N | O L X N;I
D I R E O | O D E R;I
F Z Y I X | I Y Z F;X
N E R G F | F G N E;R
Y L J Q P | L Y Q P;J
Z H U L Y | U H Y L;Z
C S W O E | S C E O;W
N Q X V S | X V N S;Q
R Y A D W | D A R W;Y
Q J K G M | J K G M;Q
M B G E Z | M G Z B;E
F R O P I | P F I O;R
K G V M L | V G L K;M
B G L M Y | B G M L;Y
X B P W U | X P W B;U
F R S H D | F D H S;R
N D B P F | P F N D;B
S H E M J | J S H M;E
L J T Q V | J Q V T;L
C Y M A U | U C Y A;M
N Z F E H | N E F H;Z
E B T H P | E H P T;B
K M I N O | M N O I;K
D A X T Q | T X Q A;D
A B F Y P | P B F A;Y
B L K I S | K B S I;L
M E W C R | M C E W;R
C Q V U K | K V U C;Q
G B W U F | G U F W;B
K L D F O | O L K D;F
I D W Z L | W Z L D;I
K E F D Q | E K F Q;D
V O H Z F | Z F O H;V
A V X H W | X H A W;V
W H M J C | J M W C;H
V Q M J N | N J Q M;V
J E T L Q | E Q L J;T
A C Y K V | V C K A;Y
K Z T X N | Z N K X;T
W H E F U | F W E U;H
Z K D W A | K W A Z;D
Q X M J I | I M J X;Q
D U L M B | M L U B;D
Q F A D Y | Y Q F D;A
U D F S J | U D J F;S
B V J A R | V A J B;R
B K Y V W | Y B V K;W
M E P C H | P C E H;M
Q N V K Y | Q V N Y;K
X F M L K | M K L F;X
W A Y Z O | O Z W Y;A
B N W F Z | F W B N;Z
Z X J O R | Z J O X;R
A H U V J | H U A V;J
D Y E X C | C X D Y;E
S I T N Z | Z N I S;T
G A D O I | G I O D;A
S M Z V K | S Z M K;V
W P Z T F | W T Z F;P
Y K S T Q | K Q Y S;T
B V Y H W | H V B W;Y
J R L K U | K J U L;R
R Y L E A | Y L R E;A
U R A B E | R B U A;E
P G K Z L | P L K G;Z
K R U T B | K T R B;U
C X Y K F | Y F C X;K
B R Z P X | B X Z R;P
L Z B H P | Z B L H;P
J X A S W | S J A X;W
I N P F C | N P C I;F
D V L P S | L P V S;D
T R H F N | H N T R;F
U C B Q R | B U Q C;R
G R Z C A | A C Z G;R
G B U C H | G H B U;C
Z U Q H J | H Z U J;Q
D B J Y U | J Y D U;B
B P W O S | S O W B;P
A M P C U | M P U A;C
G T V D F | D F V T;G
X O V E F | V F X E;O
N U F G B | F N U B;G
C Z L B T | C L Z T;B
G Q P T H | P H T Q;G
H I P A B | H P A B;I
O S P W X | O S W X;P
V C Z T M | Z V M T;C
L Y B I H | H Y B I;L
I Z F M W | M I F Z;W
C A N Q I | N I A C;Q
C S A V R | R S A C;V
T H N I W | H T N I;W
S E C A M | E A S M;C
R M I U X | R M X I;U
L F N K E | N K F L;E
L P B A Q | L A P B;Q
M T G S Y | S T M G;Y
W N A X C | W C X N;A
C L M H Z | H L Z C;M
E K C W P | C E W K;P
O U P M G | P G M U;O
D M I Z U | I U M Z;D
P S D J G | G P D S;J
H O N S B | S O B H;N
L Z T F K | K F L Z;T
T N B G Z | T B N G;Z
X Z V S C | X S Z C;V
I Y V K U | K V U Y;I
J G Q C E | J Q C E;G
Y D I Z F | Y F I D;Z
D W K R M | K M W R;D
S W L O Q | O Q W L;S
M P S K V | P K V M;S
U H F P V | U P F V;H
A J D K C | D C A K;J
Z V G A C | V Z C A;G
V A M B G | G M A B;V
T Y Z E A | E A Y Z;T
J Z C F H | C J Z F;H
H B T D P | H P D B;T
A R D B H | R B A D;H
B A M Q V | M A V Q;B
K G F U S | K G F S;U
A Q I C R | I C Q A;R
X Y P E C | Y E C X;P
N Y T I R | I T Y N;R
C R I N K | C N K R;I
B T Q X F | Q X B F;T
R O E P F | R P F O;E
B J D E U | J D U B;E
T H S N U | N S U T;H
L D V E O | E V L D;O
J Z A R Q | A Z J Q;R
K S Z M Y | M S Z Y;K
A W G D B | W B G A;D
F A D W E | W E D F;A
N X F O C | X F N C;O
P G Z D J | P D Z J;G
I R L F Q | I R F L;Q
Z Y T D F | F Z T D;Y
G X P Z K | P G X K;Z
H T N G U | T U H G;N
K B D L F | B L D F;K
Q E F M B | Q M F B;E
V T U E D | U D V E;T
Y F U C R | U C F Y;R
Y F C T M | F C M T;Y
E U D A Q | A E D Q;U
H K I S Y | I S Y H;K
M P I Z C | M Z I C;P
G M W L F | W L F G;M
N Z F O L | F N Z O;L
S Q J T R | R Q S J;T
B T E Q X | T E X B;Q
S Y G P Q | Q S G P;Y
Z S X R M | X Z R S;M
L F X K H | H K F L;X
A R Z B U | U B A Z;R
W B Q I R | I R Q W;B
Q E M H V | Q V H M;E
O W R C K | R K O W;C
M Y A R X | M A R Y;X
S Q U T G | U S G Q;T
K X V R J | J V X R;K
Q R Z B G | Q G B Z;R
T N S V D | N V T D;S
Q P K U H | P H K Q;U
W N T P R | N R P W;T
V F E D C | F D C E;V
L Z K G O | K G Z O;L
X E V G J | V G J X;E
P S U A C | P S C A;U
E A F S W | F W A S;E
P K R B V | B P K R;V
A N Q D I | N I A D;Q
W L O T P | O W L T;P
Z G B W R | G B Z W;R
Q T A Y N | A Q N T;Y
F T S U M | T U M S;F
R V E A Q | V E A R;Q
Q D M C O | Q C O D;M
H U C Q L | Q C U L;H
D Z E P Y | Z D E P;Y
W Q L G E | W Q E L;G
J C E P X | E X C J;P
L Z S E V | E Z V S;L
P H U N W | P U W H;N
L S K R V | L R V K;S
A S B M N | B S N A;M
C B E H D | C D E H;B
F J I N Y | J N F Y;I
F O G E D | G F E O;D
T M C H S | M H S C;T
V X M J I | J X I V;M
S A P B K | S P B K;A
R N L H O | N R O H;L
K T L A O | O K L T;A
Y W O R T | T O R W;Y
G J F K C | J G F K;C
P Q K M I | P M K I;Q
I Z Y U S | I S Y Z;U
I X B M E | X B E M;I
V R J L M | R L M V;J
W X Y E I | X I Y E;W
W S F H T | H W T F;S
Q Z O L U | Q Z L O;U
E V J W I | W E J V;I
F I X B E | I F X E;B
G O L N T | L O G N;T
H N C A P | P N H C;A
U I X C J | C U X J;I
T W B E S | W T B S;E
Y D H V C | V Y C H;D
S Z F E R | R E F Z;S
Z V G I Y | G V Y Z;I
D U A G O | A D G O;U
K X I Z W | I Z K X;W
A G W N Y | W A G N;Y
A B H P I | B P H A;I
S L D R W | R W L S;D
V C N S F | C F N V;S
T H J S M | M H T S;J
U A E N R | A U N E;R
A N I E L | A E L I;N
S L T G E | L S E T;G
U C W M P | C W U M;P
E W B L T | B E T W;L
I S M J B | J I S B;M
A Y K G P | A P K G;Y
D U I N S | N I S U;D
W R O U L | U W L R;O
P T E W G | E W G T;P
U D I P T | I P D T;U
W K D H Q | D W H K;Q
D F S N R | R D F S;N
C K G J W | C G J K;W
T J E U X | U T J X;E
S G V F H | H V F G;S
A L S R U | L S U R;A
Q W I X P | X W P Q;I
A R S C I | S I A C;R
W G S T H | H S T G;W
P Y E I N | P N I E;Y
D Z R U Y | Y R Z D;U
G S E M O | G M S E;O
G A U Z D | Z U G D;A
G N E B S | E N B S;G
C J Q T U | U J C Q;T
W F N X U | N U X W;F
S K A Z B | A K B S;Z
V B Q S Z | B Q Z V;S
Y P F Z D | P Y Z D;F
V F Y K W | W F V K;Y
H U A Y K | Y K H A;U
I H U O J | H O J I;U
B C O G V | V C B O;G
C V Q M W | M Q V C;W
A O D R S | D O R A;S
D R H Y Z | D R H Y;Z
D U X I Y | I X U D;Y
B L C H I | B I H C;L
A K U M N | M A U K;N
P W X M I | M I X P;W
A P U S Q | A Q P S;U
O Z Q B N | N Q Z B;O
Z J E L O | O L Z E;J
Y A M O S | S Y O A;M
S T C H O | H T C S;O
G N U W Z | W G N U;Z
V D W F P | W P D F;V
P K E T L | L P T E;K
F V O Y N | Y F O V;N
C P L X G | L G X P;C
J X T Q B | B X Q J;T
W M K H S | W K S H;M
T I Y W X | T Y I W;X
E J Y R F | J F R Y;E
H F L I P | H F I L;P
X C R D Y | Y R D C;X
U D H N I | I H N U;D
W Y J K M | M W Y J;K
F V A W J | J F A V;W
K H E B T | E T K H;B
T J P F B | P F J B;T
W D G V O | O W V G;D
T I B J E | J T B I;E
V D L C S | V L S C;D
A L E S W | E L S A;W
J Y R V B | J V R B;Y
X Y M K F | M X Y F;K
R P A U W | U A R W;P
X T S R U | R U T X;S
S B K Y R | Y K S B;R
M R W C Z | W C Z R;M
F E V P G | V G F P;E
Y O Z B G | G O Y Z;B
Q C O P N | Q P O N;C
H J V Y I | I J H V;Y
C V R G F | C G F V;R
U A H L G | L U A G;H
C X I U T | I C X U;T
W C K Z H | K Z C W;H
C L Q T Z | L T C Z;Q
N A T V U | T N V A;U
V H F G B | V B H G;F
M U F K Q | M K F U;Q
M Z D B W | W D Z M;B
K H N B W | B K W N;H
Y O Z Q L | L Y O Z;Q
H B I M L | M B H L;I
X K V U J | V U K X;J
D K S M Y | D K S Y;M
A R Y C Z | Z C Y R;A
X B G Z L | G Z L B;X
N M L I O | I M O N;L
K R I E U | U I R K;E
H W D I F | I F H D;W
E W V O S | V O W S;E
N L S P H | P H L S;N
H M Z U F | F Z M U;H
R X A E S | S A E R;X
T X G M Q | Q T X M;G
B A V Q E | B E V Q;A
P U H K O | P U O H;K
A Y Z H X | A H Z X;Y
D M F C Z | D M C F;Z
F C L I J | I F J L;C
I H P C M | P M C I;H
J M O S X | S M O X;J
A O M Y N | Y N O A;M
E N D A I | A D I N;E
M E T G Y | G E T Y;M
C A Q Y Z | Z Y A Q;C
S I V G E | I E G V;S
M D J I E | E D M J;I
S H A F D | H S D A;F
I Z A X Y | Y Z A X;I
T G E Q Z | T Z G E;Q
W U R Z T | R W T U;Z
M T Q W U | W T U Q;M
J Z A D I | I D J A;Z
O F G D B | F B D O;G
O A Z K R | O K A Z;R
L W O R M | M L R O;W
F E V M X | E V M X;F
P C V U A | V A U P;C
V I Z H A | A I V Z;H
P B H S T | S H P B;T
O J F G V | G J O F;V
S H T U A | S A U T;H
N B H K U | U K N B;H
L Q D Z G | D G Z Q;L
H A O K C | C O H A;K
B S X N W | N B W S;X
L C N M G | N G C M;L
M U C I A | A I M U;C
E K X A J | A K J X;E
F Z E M G | F E Z G;M
S B F Y E | S Y B F;E
K V A B W | W B K V;A
A V S E W | V E A S;W
W Y U J Q | Y W J Q;U
L B O S I | L B O I;S
F R T O C | R C T F;O
P C G H R | R H G P;C
F W O R T | O F R T;W
J F U O L | O J F L;U
R E T S V | R E T V;S
L H I S D | L D S H;I
W Q I H L | H L Q I;W
Z Y F T A | F T Z A;Y
I P X M E | E X P M;I
K X M Z Q | K Q M Z;X
Z S W G E | S Z W E;G
X D R O P | R D O X;P
Z J G B M | J B G M;Z
Y A O F G | O Y G A;F
X P N D Q | D P X N;Q
M T B Z X | T B M Z;X
T D O Y N | N O T D;Y
H O E T W | E T W H;O
P K D U A | U P K A;D
Z L S E I | I S L Z;E
Q B A Y G | Y A B G;Q
O W K J G | K G O W;J
C F R T N | F C R N;T
P W K V F | K F P W;V
H Y D V G | Y D V G;H
Y A T L U | A L U T;Y
X G U R N | R U N G;X
D E L V W | W L D E;V
O D V G N | O V D G;N
S T N H Y | H T S N;Y
U A O M S | S U O A;M
B X H Q T | Q H X B;T
Z R F H C | R Z H F;C
C V E U A | C A E U;V
U R S Z V | V Z R S;U
I Q O N D | D N O I;Q
G B A S O | S A B O;G
I A O P C | P A C O;I
I K U Z X | X K U Z;I
F Q N O D | N F D Q;O
D C E U K | U D K C;E
E N X F M | M X N E;F
F J K T O | J T O K;F
D P Z X L | P D Z L;X
N J M Q P | P J M N;Q
A P X U F | U X A F;P
A B C U I | C I U A;B
C S X Q L | C Q S L;X
K F C H Y | C F Y K;H
X C R H E | X R E H;C
N M G E Q | G N M E;Q
J I S M Z | S J Z I;M
U A B T E | T U A B;E
Q Z D X R | Z X D R;Q
P F M J S | F P M S;J
X U N R Q | R X U N;Q
L J Q K G | K L Q J;G
K A I Z B | K B A I;Z
O S B C Q | B O C Q;S
F N Z W A | N F A Z;W
V Z D U C | Z D U V;C
T S E P O | E S P O;T
P O W X A | X P O A;W
C Z K Q W | K W C Z;Q
Y J G E X | E X Y G;J
N L S Y M | S N Y L;M
C L D N R | D L N R;C
X B G M C | X C B M;G
H S J A T | T H S A;J
Y Z B H K | B Y Z H;K
W R M H U | H U W M;R
Y X L D O | L X Y O;D
Y B M R E | Y E R M;B
C D U A V | U D V A;C
R O Q P X | O Q R X;P
H A U E Y | A Y E U;H
W Y O D N | N Y D W;O
X H Y V R | Y V R X;H
Z I V G D | G V D Z;I
Q Y D F C | D C Q Y;F
A Q D T X | D Q A T;X
X F V Y N | X V N F;Y
Y L F H C | L Y F C;H
Y L B I D | I L D B;Y
W K E J O | W E O J;K
I X Y E P | I E Y X;P
C J D Z S | C Z J D;S
W N H V O | O N V W;H
X H I F V | V H I F;X
A F O H N | O H F A;N
S L I J D | S L D J;I
A O Z J L | A J O L;Z
Z I D O Q | O Z I D;Q
T J E A V | T E A J;V
I Y G F V | G F I V;Y
D X L B W | X L D W;B
Q X Y S K | S X K Q;Y
T E L R M | M E T L;R
H I Z C M | I H M Z;C
K G O P J | O K P G;J
Z Y S K J | J Y Z S;K
J E N P Q | N Q J P;E
R I M X G | I X M G;R
G M B V I | B I V G;M
J E I Z C | Z E J I;C
N S R P C | P N R S;C
P A Y G F | P G Y A;F
I Q S D B | S D I Q;B
A J W C L | C W A J;L
W G K O Z | K W O Z;G
U M Y N Q | Y M U N;Q
L Z G C J | J L G C;Z
J L D X P | X P D J;L
D F A I E | I F E D;A
F C U P Z | C Z U F;P
G W A X J | J A G X;W
V L G M F | V L F M;G
N V C M S | C M N S;V
X V D Q T | D Q T X;V
C D A Q L | C A L D;Q
Y X Z B T | T X Z B;Y
K Z T D Y | D Y K Z;T
V X P Q L | X Q P V;L
R Q S E B | E B S Q;R
N Q R Z G | Q Z G N;R
R Q E A V | V E A Q;R
Z M W P A | P Z M W;A
Z Y M G F | M F Y Z;G
V Z L M S | V M L S;Z
Y L O K Z | K Z O L;Y
P Y U L D | U Y P L;D
A X D O Y | O D A X;Y
K W N Z H | N K W Z;H
N P C D O | C N O P;D
A C V M S | A S M C;V
W T L M A | A M W T;L
V T I W X | I X W T;V
T B N U Y | B N Y T;U
I D N A F | N I D A;F
V H Z W S | V S W Z;H
O A D H K | D K O H;A
N A Z V M | V M N A;Z
N V U F R | V N U R;F
Y Q J E H | Y H J E;Q
R O Z S B | B S R Z;O
A G M V I | M A I G;V
L R V Z U | V U L Z;R
I H C E K | H I K E;C
C O L T B | O C B T;L
G O V R Q | R O V G;Q
M J O X E | X M J O;E
S C X E I | E C X S;I
W X N L M | X M N W;L
Q K U G R | R K G U;Q
J A D H B | H J B D;A
Q F X R B | X Q B F;R
G R B I P | I P G B;R
X E I D K | E I X D;K
I S E X K | E K X I;S
T H Y F D | D H Y F;T
L W Y U J | Y U W L;J
D J Y B V | Y B D J;V
R M I D U | U M R I;D
N R Q A F | R Q F N;A
W V H G K | K V G H;W
A J F B U | F U A B;J
I R C N L | N L C I;R
W N R L I | I L N R;W
I L N Z Q | Q N Z I;L
D X H A L | X A H L;D
H N W E V | E V H N;W
C N F U G | N U F C;G
W X Y S U | X U S Y;W
S L C W G | S G L C;W
O S W V I | I S V O;W
C I H A B | C H A B;I
Z L B U D | Z U D B;L
Q F C Y R | Y Q C F;R
D G I X R | R I X G;D
A S C N H | A C S N;H
W K Q D X | W K X D;Q
Y S F E J | J F Y S;E
Q H V L B | B Q V L;H
Z U D E W | Z U E W;D
U V Z H O | U H O Z;V
J C D V A | C J A D;V
R T N J M | J R T M;N
U G Z A K | A K Z U;G
V W H K L | L V H K;W
V B N U P | B U P N;V
U W I P S | P I U S;W
R W I G E | W E I G;R
O W G X J | W J X G;O
L B H S E | E S H L;B
N Y K E D | D Y N E;K
C N G L R | L N R C;G
M U B E A | B M U A;E
J U T M E | U J M T;E
C W Z L T | W L C T;Z
H G F P E | E H P G;F
C S J F Z | F S C J;Z
P X Q C Z | X Z C P;Q
P X I C Y | X C Y I;P
T W O F L | W O F L;T
S H W O T | H S W T;O
D P W O F | F D O P;W
P B M V R | R V P M;B
M Z Y H R | R M Z Y;H
K F Q U S | F S U Q;K
F Q X V R | R V X F;Q
C L O R J | L O J C;R
V M R B H | H M V B;R
I W L N M | M L W I;N
F O W D G | O G W D;F
N I F A Y | A I Y F;N
C B F T D | C F T B;D
T P D K E | E D T K;P
L I B M N | B M L I;N
Z K A W S | S K Z A;W
Z N T G I | N I G T;Z
B R H S M | B H M S;R
N T A Y M | T Y A M;N
T Y R L D | L Y R T;D
N L H U I | U I L N;H
L Z E U H | Z E L U;H
N E R C P | R P C E;N
Z Y D B F | B D Y F;Z
W T D U S | D S U T;W
U T B F E | F B T U;E
B Y A D Z | Z A D B;Y
K O H A G | O K A H;G
O R G C H | C H G O;R
H V F A L | A F L H;V
E F H U P | P H E F;U
U M G E S | S E G U;M
M O N K T | M K N T;O
D V T M X | D T V X;M
S P A O H | H P S A;O
X V O U F | X U F V;O
O L E P I | O I P L;E
Y H O U C | H C U Y;O
W A X S K | A K W X;S
S V G J U | V G S J;U
O C N L E | L E O N;C
T O K S D | S O D T;K
R E T I Z | T E I Z;R
I R D M E | M E D R;I
C G D Y P | G D Y P;C
W H K R D | H W D R;K
U O D X W | D U W X;O
J U E O M | E M J O;U
N M H Z Y | Z N H M;Y
N P K D B | N K P D;B
P R F U O | P U F R;O
X I A V N | I A X N;V
P H W B O | H O P W;B
C T U E B | B E C U;T
J Y T I L | I J L Y;T
L A I T O | T L O A;I
H D T K E | K E T D;H
S E X A P | X E A P;S
I O Y N P | O Y N P;I
J P O X A | P O A X;J
B N L E F | E L N B;F
O D T F A | F A T O;D
X F Y V G | V F X Y;G
Z S G D F | D F Z G;S
C Q L B H | Q H C L;B
Q V P B E | B V E P;Q
F L N X O | L X F N;O
F C J K D | K D J C;F
T R E S K | R S E K;T
H D Y J B | J Y D B;H
M T Y P G | P M G Y;T
Q B H L N | Q H L N;B
Y H I Q K | Y K I H;Q
G X H C S | X H G C;S
Q D H V O | Q H D V;O
F A V O U | O F A V;U
Y P A I H | Y H A P;I
I L V E Q | I L Q V;E
N L Z W T | T Z W L;N
Z J T K G | Z G J T;K
Z K G U E | U G K E;Z
R F C Z Q | F C Z R;Q
S I C M F | M F S C;I
H C N K V | N K H V;C
U R T I K | I T U R;K
I J W K X | J W X I;K
E U K M Q | Q E M K;U
Z W B V D | B Z V D;W
D B N V C | C N B V;D
X A B G V | G V B X;A
O S N W G | S W N G;O
T D O R B | O B T D;R
