A D P N O | A N P O;D
O J X U E | X O J E;U
B C R A U | B U A C;R
D U M E O | U M O D;E
G X B R K | K B R G;X
O B G U Y | G Y O U;B
Z N B H M | N Z H B;M
F N Z B M | N M Z B;F
W K J X T | K T W X;J
N H W O C | C O H N;W
R I X P K | X K P R;I
Z T Y V X | V X Z Y;T
A T U S V | T S A V;U
W I F P E | E I P F;W
A V R X S | R S X A;V
T Y C N E | E T Y N;C
X H J G F | F J H G;X
Z P W I R | Z W I P;R
M Z U W H | H Z W U;M
V Y X Z K | K Y V Z;X
S D Y W A | D S A W;Y
K F O Q T | K T O Q;F
K F Q U D | D U F K;Q
H O V X Z | O V Z H;X
L C J M H | J H C L;M
O N R L I | R L O I;N
L Z B G I | G B L Z;I
C V P O W | C O P V;W
R S J X U | R X J U;S
D G B Z Y | Z D B Y;G
B E H V A | E A H B;V
E T O M K | M E K T;O
S K U X Z | K Z S X;U
U D K J L | L D U K;J
O Z T L K | L T O Z;K
Z T Q Y H | Q Y H T;Z
P N R Q I | I R P Q;N
Y R T G W | Y T G W;R
I B R Z G | Z G B R;I
E H D F U | H E D F;U
P K V Y C | K V Y C;P
G F U P L | U P L F;G
J R U S I | J U R S;I
E F G O A | E A G F;O
H X C Z O | Z X H O;C
N B D I W | N B D I;W
X R H G W | G R W X;H
E U M Q N | N Q E M;U
F I O S R | O R I S;F
W X A V P | W A V X;P
Q H W Y U | U W Y Q;H
U V X D T | T D V X;U
J L I M C | C I J L;M
E P J K V | E K P J;V
U I D C W | U C D I;W
T L G S P | L G P T;S
V D Q T E | D T V Q;E
Z P Y T L | Y L P T;Z
X J T F A | F T X J;A
S D E R W | W S D R;E
D O G Y I | O Y G D;I
W A R D K | A K R W;D
V D Q G F | V Q F D;G
P U O M F | P U M F;O
S P Z U Y | Z P Y U;S
P X O N L | N X L P;O
R A Z T U | T A R U;Z
B F U K G | K G B U;F
Y R G E A | E A Y R;G
N U K P Z | N Z K P;U
H X C Y P | H Y P X;C
B Q E P A | E P A Q;B
K Q M I D | K D Q M;I
Z K C E D | C Z E K;D
J C F X N | J X C N;F
T A S I W | A T W S;I
D Y R C Z | Y R D C;Z
H B G V I | V H G B;I
B A I L Q | B A I L;Q
W N O F L | F L O W;N
A P X C B | X B P A;C
P C Y N L | P N Y C;L
K N Z Y C | N Z Y C;K
G U R E N | U R G E;N
H F G Y L | F Y L G;H
M J A X E | J A E X;M
L A G Z Q | A Z L G;Q
L S K F E | S F L K;E
K E H Q N | Q N H K;E
S P G E M | E P M S;G
G N K A H | K H A G;N
V S I T U | I S V U;T
G M O I D | M G D I;O
B N F L S | B S L N;F
I B K W Z | W K B Z;I
C O R L N | C L R N;O
D B C S R | D C S R;B
I B S M Y | I Y S M;B
R Z Q D N | Q N Z R;D
P M G J V | P M V G;J
L Q J Y C | L J C Y;Q
X U B Q Z | X U Z Q;B
C A M I W | I C A W;M
R Z L O C | O R L C;Z
D G L Y J | L G D J;Y
C S U O J | U J O C;S
Q F A H Y | Y F H Q;A
Z X K S T | T X S Z;K
H S O X K | S O X K;H
W N F D Q | D N F W;Q
F V C S N | S F C N;V
H C Y P I | P Y H C;I
B M U Q H | M U B H;Q
B T Y Q O | O B T Y;Q
V F K Z M | K V M F;Z
L A D R T | D R T L;A
R H O A C | C O A R;H
J H T I U | H J T U;I
U R K H Z | K U Z H;R
G T U I V | V G I U;T
M F R O E | M O R E;F
A U I V L | L I V A;U
S R H J U | S J U H;R
P K R W X | R K W P;X
H C N B L | H C B N;L
K C D B R | D B K R;C
Q M P I Y | M I Q Y;P
J E O B G | B E J G;O
V K E X J | X K J E;V
F O E B A | F A B O;E
P K U H S | S H P K;U
O B M Y Q | B M Y O;Q
Q L B S O | L B O Q;S
I N D U O | D O I U;N
T M J W K | J M W T;K
G E I Z N | I G N Z;E
X O W S R | R W O X;S
D N I H A | I A H N;D
G P U D W | W P D U;G
S J K H U | U H K J;S
H O A J B | O B H J;A
X P A S U | S X A U;P
Q X Z H U | Q H X U;Z
Q I P D U | I D P U;Q
F K H C G | F H G K;C
Q L N E M | Q L M N;E
R U Z V A | A V Z U;R
S L R Y O | Y L R O;S
V C X A E | X A V E;C
K P F C B | C P F K;B
B X S C U | S U B C;X
R U W H Q | Q H R U;W
F H B Q E | H F E B;Q
U H I Z F | Z I H U;F
J H E M Z | M H J E;Z
P V O A G | V G A P;O
O K T R Z | T O K R;Z
C P I V T | I T V P;C
M F P X L | L F X P;M
R A N O W | R O A W;N
Q K T M N | N M K T;Q
L U Q R S | S U Q R;L
R D H B N | D B H N;R
T W F Z G | T Z W G;F
Y O D T V | D Y T O;V
O I F M V | M O I F;V
M Y Q U D | M D Q U;Y
H Y I Q T | T Y H Q;I
I X K D S | I D X S;K
B T R A Y | B Y T A;R
P G Y T K | G K Y P;T
S F E Z D | D Z E S;F
S J D Y W | D W Y S;J
V X U T D | X V T D;U
L T W U D | W D T L;U
E I W K P | K E P W;I
A Q U Z B | Q A U Z;B
R X E I M | M I R X;E
Z Q N T B | N B T Q;Z
F L K G O | O G K L;F
J E N M T | T M E N;J
R Y S K E | S K E Y;R
S J R N V | R S V J;N
W T E I H | H T E W;I
R I B D T | T B D R;I
F N S M C | C S N F;M
L B S P T | P S L B;T
X A I D G | I A X G;D
R C E F B | E R F C;B
M X V P N | M V P X;N
F J I O D | F O D J;I
K H Y J S | S H Y J;K
J E V S A | S E V A;J
J O A F I | F J A I;O
D H G P N | D N H G;P
Y O M H C | H O C M;Y
F L A D Q | Q A F L;D
U X E V H | U E H V;X
D L T X W | T W D X;L
F Z X N B | Z N F X;B
L T M W P | L T P W;M
I R T S Q | Q S I T;R
Q W U P O | O Q U P;W
O Q Y U D | D Y O U;Q
K R D A B | K A B D;R
T Y B J V | B V Y J;T
R T G B W | T W R B;G
I G N L B | N I G L;B
Z D F Y X | Z D F Y;X
O B W M A | B M A W;O
M I C Z P | M Z P I;C
N D T W U | T D W U;N
A X H M I | X H A M;I
C D P B N | N D C P;B
A M C K Z | C Z A M;K
Y M W N Z | M W N Y;Z
B V A G F | V B F A;G
L E F G W | L W G F;E
G R K W L | K G W R;L
P Y V T F | T Y V P;F
L S U W J | J U W S;L
X H V N O | X V H O;N
N F T W K | N K W T;F
A L Z B V | A B Z V;L
A S Z E Q | A E Q Z;S
A M Y I D | A M Y I;D
N S G A Y | S Y G A;N
Z C F G A | A F Z G;C
Z C U I X | Z C X I;U
G K V J R | R K V G;J
L M W P K | P L W M;K
O G H F P | G O P F;H
T C J N F | F N T C;J
W G I K N | N G W K;I
R D T V X | D X T V;R
A E I N G | E I N G;A
G N K Z L | L Z K G;N
Z V E H D | D H V E;Z
S P O L V | L S P O;V
X A Z D S | A S Z D;X
V E S Q U | E S Q U;V
Q C X B J | X Q C B;J
K O D P Q | P D K Q;O
L B U G O | L G O B;U
O X H M Q | H M O X;Q
F L S E V | F L S V;E
E L U T D | L U E T;D
R U A S X | X A R S;U
F W D C P | W P F C;D
P C E K D | P C D E;K
K W O F U | O U K F;W
J P X U Q | P Q X U;J
O C G D Y | D Y O C;G
L X J F V | F V J X;L
Z G W A J | Z G A W;J
Z H C W Q | W C H Q;Z
X P N K B | K N B X;P
C Y V K Z | Y V K Z;C
Q W E Z I | E Z I W;Q
V S N Z K | S K Z N;V
L T X O S | L S X T;O
G M Q U N | G N U Q;M
Y I G H U | G Y I U;H
V Q L D Y | Q Y V D;L
I G S H V | G S I V;H
C D Z P V | D C P Z;V
J D F T B | F D T J;B
A Z C D I | Z D I C;A
G I N D W | N G D I;W
X G W Z J | G Z J W;X
Z I Y G M | Y Z M I;G
Z P M D H | D Z P M;H
E D W P Y | P E D Y;W
V U A D Q | A Q D V;U
U Q Z O Y | Z U O Q;Y
N B V S I | I N S B;V
E D V X Y | Y E D X;V
L S I W Q | L Q W S;I
F T E W X | E X W T;F
O V W X Z | V X Z W;O
R G N D A | A N G R;D
Q Z D C V | V Q C D;Z
Z R W K X | X K W Z;R
P A M C H | P C M H;A
C Z A R S | A Z S C;R
U I P E W | I W P U;E
M D N G S | G S D N;M
R K E N Z | R Z E K;N
H J T Y X | H Y J T;X
S I X M R | M I X R;S
L G X B Y | Y L X G;B
X E T C Y | X E T C;Y
R C O N K | N R O K;C
J S D T C | J D T S;C
O U N L S | S U N L;O
B I E J Y | Y I J E;B
Q D H R E | Q D H R;E
A N G D F | N F G D;A
T F W C A | A C F T;W
Z K N B T | T Z N K;B
Z K G L J | K Z G L;J
E H F C V | E V C F;H
A I V S P | S I A P;V
Q Z U A D | D U Q A;Z
M O Z I L | O I Z M;L
A V L C U | L V A C;U
T Y K N X | X T K N;Y
Q K Y I G | Q G K I;Y
Z W B V F | B V Z F;W
X O R P S | O R X P;S
J M Z K O | M J O K;Z
F J B S V | S B J F;V
J N R G O | G O N R;J
T J P F L | J F L T;P
E L U F Q | F Q U E;L
D J S E I | J E S D;I
W K N H G | N H G W;K
A V J D N | V N A D;J
F Y P W O | F O W Y;P
J M E R Z | R E Z M;J
K Q D G T | T D Q K;G
D V B Q U | D B Q U;V
R H Y T U | T R Y U;H
N S L X I | X S I L;N
S V E F W | E F S W;V
J P K R S | S K J P;R
H M I K U | I K U M;H
W T E I L | E L W I;T
P N X L C | L P N C;X
Q I L H N | L I H N;Q
M S R Z Q | S M R Z;Q
Q V F M I | V F M Q;I
A I G K W | W K I G;A
J Y F D W | Y J F D;W
U H F A S | S U H F;A
G W B X M | M G B X;W
W F A B K | F B W A;K
O C X R Q | Q C R X;O
S M Z L N | N M S L;Z
U D H R P | U R P D;H
D X S K W | X K D S;W
X I B E F | I E X B;F
D J T U V | D J V T;U
E A Q D H | Q A D E;H
Q X I C W | X W I C;Q
Z L Q U N | L Q Z N;U
D E W V Y | Y D V E;W
T C P Q L | Q C T L;P
O B M H Z | B O Z H;M
D Z R Y E | Z Y D E;R
H Q U K T | T U H Q;K
R Y K F Z | Z R F Y;K
C H I A Q | C H A I;Q
Z F D E A | Z F D E;A
H P V F I | H F V I;P
K Q R E S | K S Q E;R
E M B J P | E P J M;B
K J V C R | R V C J;K
C J U M I | U J C I;M
E P O J U | O P U J;E
X P K V Q | X K P V;Q
W K G I A | A G I W;K
G V I C P | I P V G;C
A R W M T | T R M W;A
H K B F Y | F Y K B;H
N M V T F | F T V N;M
E J Y Q F | J F E Q;Y
P I U Z B | Z P U I;B
P R Y X Z | Z Y X R;P
N Z A V O | N A Z O;V
K D Z Y O | K Y O D;Z
H F C W D | F H D C;W
K D N P B | K B P D;N
C U R Y S | Y R S U;C
I M Z J Y | Y I M J;Z
I Q O T D | Q D T O;I
I G T Q A | Q G A I;T
W T O J I | W J I T;O
C Q A O T | A T Q C;O
Y V T C N | T Y V C;N
S B Z Y M | Z S Y B;M
M Z G R J | R G J M;Z
X P T N J | X P J T;N
K T I N L | T N L K;I
H T G K N | H T G K;N
V D N T L | L T N D;V
I S L U Y | L I Y U;S
G P U R O | O R U P;G
D F S N L | F D L N;S
T K G E Z | E G T Z;K
H E O I L | H O L E;I
M K B G T | B M G T;K
J G O T L | T L J O;G
F N O W V | V N W F;O
L K T S P | P S T K;L
S P C R G | C S R P;G
J P T F U | U F T P;J
G D N Z F | N Z F G;D
T Z W I O | I W T O;Z
I Q S X T | S Q X I;T
Z V X N C | N Z C V;X
X I E M Q | E I M Q;X
W B T X J | B T W J;X
R X I W K | R X I K;W
U T B K H | U K H T;B
J R H P D | R P H D;J
X U D P Z | P D U Z;X
B U T M S | T B M S;U
I K W P E | W P E K;I
F C Q K P | P Q F K;C
N E D H F | N E F D;H
E V J K C | V K J E;C
S V X A Q | X Q A S;V
K I B M T | K T I M;B
L R D Z O | L R D O;Z
W X V L C | L C X V;W
F O K C H | F O K C;H
H A I U Q | H A U I;Q
R B E X N | X B E R;N
D I X O H | D I X O;H
E P K I D | P D I K;E
I N D T V | T V N D;I
J O C E N | C N O E;J
B E L J K | K B J L;E
O L E X J | J E O L;X
V B Z O H | B H O Z;V
N K R M H | R N K M;H
M O N D B | D B M O;N
C T U F Y | U Y C T;F
U H A G Z | G A Z U;H
Q J W V U | U W J V;Q
Q T J I N | T Q I N;J
F D Y N Z | F Z N D;Y
R Z L B M | B Z M R;L
K D N J V | V K N J;D
Z O G E T | Z E O G;T
U R M B Q | U B M Q;R
R J L M K | L R J M;K
C X E J P | P X E J;C
T D V K R | V R T D;K
W K P U V | P W U V;K
L A G Q K | L A Q G;K
G X O V E | G O X E;V
Y K V C R | V K C Y;R
U E V M C | M C U V;E
Y T H W M | M H Y W;T
C W J T D | C J D W;T
N O A V Y | O V Y N;A
H A K D R | D R A H;K
D J R U A | J U D A;R
H G U W F | H F W U;G
Z L W G O | O L Z W;G
B N E O F | B E N O;F
A R G N Z | Z R N G;A
N O X W M | N X O M;W
S M V Q O | M Q S V;O
O S V K N | O K S V;N
Q M I S F | F M S Q;I
H G Z F L | L G Z H;F
M A I T E | E T A I;M
Z S D E O | Z S D E;O
B S Q J L | Q L S J;B
O C R M U | R M O U;C
K G B J X | B K G J;X
S Q W N I | N I W Q;S
M D Z A V | V A Z M;D
Q R C M K | M Q K C;R
E I D S C | E D C S;I
A Q E R I | R E A Q;I
G A Q H U | G A Q U;H
H S P J C | H J S P;C
O T X F Q | F X T Q;O
P I F Z E | E F Z I;P
G J X Q R | G J Q X;R
J N D O L | D N O L;J
W I O P D | P I W O;D
V U M A N | U M A N;V
I A D H V | V D A H;I
P M Y A H | P M H Y;A
D K B F O | K B O F;D
A Z I M H | A Z I M;H
F S H C I | I H S C;F
Q R Z A Y | R Y Z Q;A
H P I L B | L H B I;P
A K S T M | K S A T;M
Q E U Y K | K E Y U;Q
F E M K U | E M U F;K
C Y T W M | C T M W;Y
Y F Q N W | N F Y W;Q
V E Z N I | V I E Z;N
X Y U P T | T X Y U;P
L E D S Q | Q S D L;E
J W O I T | I J W T;O
T D H N V | H N V D;T
P O V C S | C V O S;P
W M S J P | W J P S;M
X Y H P G | Y G P H;X
Z B Q S M | S Z B Q;M
U B I J T | U T I B;J
M H S E I | E I H S;M
Y V U E Q | E V Y Q;U
I X F O W | O I W F;X
Z B F D T | T F Z D;B
V L M H J | J L M H;V
Z L W U X | U W Z X;L
E V C T G | T G C E;V
U P Z X B | B P U X;Z
W J M H Y | J Y H W;M
P I D G T | G T P D;I
S K W R A | R K W A;S
H Q Z Y S | Y Q H S;Z
P A G W O | P W G O;A
G I F D L | G F I D;L
W P S M X | S X M W;P
F T B U V | U B T V;F
X M R V I | I M R V;X
A P E J X | E J A P;X
J O R P N | P N O J;R
X E I D Q | X E Q D;I
C Z J M R | M C R J;Z
Z O P B G | O G B Z;P
Z X I P A | Z A P X;I
C D R F P | D P R C;F
Q M C X P | P Q X M;C
F Q U J X | X U J Q;F
U L J B E | U B J L;E
M U W X R | M U R X;W
X D U B R | U D X R;B
K P S C Z | P S K C;Z
X P R B S | P X B R;S
D K Y Z B | Y Z K D;B
C H N W K | H C W N;K
M G D F T | F G T D;M
Q J V G C | C V J Q;G
J B A U V | U B A V;J
E T D H B | T E H D;B
J H B C E | C B J E;H
A F U D K | U F A K;D
U I N X Z | Z X N I;U
K H C F I | H K I C;F
D J U W B | U J B W;D
Y M S A X | A S M X;Y
R E N O W | E R N O;W
U G H I Y | I Y H U;G
H Y Q O Z | Q H Y O;Z
I X E Y H | X Y E H;I
C V G Z A | C V A G;Z
F M R T O | F O M R;T
Y P A J C | J Y C A;P
G D L C H | D C L H;G
R N E B Z | Z N B E;R
Z R Y K A | Y Z R K;A
I L U Q M | U M I L;Q
M K G P I | P M K G;I
A M F P K | M P A K;F
L P A S E | A S P E;L
F G J I E | I J E F;G
S F T V A | T F S V;A
K Q Y J X | Y Q K X;J
U O C Z H | H Z O C;U
I V H C J | C V H J;I
S P Q T E | E T Q P;S
N V K L Z | Z L K N;V
X J E F B | B J E X;F
X W H Z K | Z K X W;H
S B U I X | X S U B;I
W P Y N F | N P W F;Y
I Y B U T | U Y T I;B
U J W C H | J C W U;H
W X T U V | T W U X;V
L R U H C | U H R C;L
K T J G Q | T Q J K;G
B H K O T | B T K H;O
Q V N R F | Q R N V;F
T W U G O | U W T O;G
V A Q J C | Q V C J;A
G F I S R | S R G F;I
E O K X G | X G O K;E
I L W Y V | W Y I L;V
I R C T K | C K I R;T
C T H O I | T C H O;I
L B V J W | B W L J;V
J G F V O | F G V J;O
J K O D Y | Y K D J;O
S B K X U | B S U X;K
F A I B Y | A Y B F;I
E Y M B K | M B Y E;K
E S I U P | U E P I;S
Y J P V S | V J Y S;P
C T L M H | M L C H;T
Y H V W O | W Y V H;O
D R Q O A | D R Q A;O
T V G N A | A V T G;N
R I B O G | R I O B;G
N M J K X | N M K J;X
L P A T N | T L P N;A
S B F T N | B S F T;N
E G Y R Q | E G Y R;Q
T X W L V | X W V T;L
C X J L Y | L Y J X;C
M F Z H N | Z N H M;F
V E Q R P | R P Q E;V
J I W Q U | Q W U I;J
J G L R U | U L R J;G
S V Q G R | R S V Q;G
N D O G F | D G F N;O
C V O J P | C O V J;P
K L W U Z | U W Z K;L
O D L V K | D V L K;O
N H I D R | N I R H;D
Z N W M P | M N Z W;P
B G C X O | B O G C;X
Y B M F H | M B F H;Y
F G N T R | R N F T;G
R K H F I | H K R I;F
J N P Z H | Z H J P;N
F K Q P T | P K T Q;F
W T S F D | T F W D;S
A Y J K L | Y J L A;K
O T D V C | D C T V;O
N X Q A J | Q J X N;A
Y W Q B P | W Q P Y;B
L A D Q H | L H D A;Q
L G B T R | G L T R;B
X N Z G T | T G Z X;N
B Z A F Y | B F Y A;Z
Q R P C S | Q R S P;C
K F G N W | G F N K;W
C O V F S | S V C F;O
H S L G E | G H L E;S
A V Y P Q | Q Y V A;P
O K C W L | L O C K;W
K T W D F | W K F D;T
A K I F T | F I T K;A
W H V S M | S W V H;M
N C M I G | I C N M;G
C U R T H | H C U R;T
I R W G Z | G R Z I;W
E B D I P | P I E B;D
C N J L X | X N L C;J
G M X L U | M X G U;L
Z I C S B | C I B S;Z
T L N J S | J T L S;N
T Z X E V | X V T E;Z
F W O P I | P O I W;F
C S V O E | E C V S;O
M J E Y R | M J E Y;R
E X B P C | X E P C;B
S B E K V | V K B S;E
P I Y Q K | P Y K Q;I
A J U T S | A U J S;T
G Q J H E | Q G J E;H
C H B W Z | W Z C B;H
N Y U L R | R Y N U;L
O A G J P | G J P A;O
M P I W G | P M I G;W
F S U O A | S F O A;U
L F B Z J | F L J Z;B
T Q C O H | C H T Q;O
T X U Q B | Q B T X;U
F L C E Q | C Q E L;F
C G V I T | I T G C;V
C Z X I H | H C Z X;I
N G L H W | N W H G;L
L K H Y D | K L H Y;D
N E G A V | V G A N;E
Q U P Z L | U P Z Q;L
A L X H C | H L C A;X
I L A C H | A C I H;L
L H F B V | H B V L;F
F U I W T | T W F I;U
O G B A N | B N G O;A
K D G X Z | Z X G K;D
W P E H U | E P H U;W
X P I C T | C I P T;X
Z P B S J | J B Z S;P
T A Y C G | A T G C;Y
Y T B P H | Y P T B;H
C Z V Y K | Y V K C;Z
Q Y N K J | J N Y Q;K
O L B M R | O M B R;L
M J I Q O | O M J I;Q
X W A N F | N A X W;F
A C O T K | A K T C;O
B Y C F J | B F C Y;J
T W V U R | U R V W;T
Z K L W P | W P Z K;L
K Z T Q X | Z K Q T;X
W K L Q U | L W Q K;U
F G Y A P | Y A G P;F
O D K X T | T O D K;X
C Z Q P M | P C M Z;Q
V J P H E | E H V P;J
I Y B E M | Y E M I;B
N P A G E | G E N A;P
M N F Z W | F Z W M;N
M Q I A X | M Q X A;I
I X W L O | W I L O;X
Y Z B D F | D F Z Y;B
I W O T H | I H W T;O
P Z F R K | F P Z K;R
S Z X N H | S X N H;Z
Y S J Z O | O Z J S;Y
N T V J G | V N G J;T
B O L Q X | X L B O;Q
B O Q Y I | I B O Q;Y
W D H S C | H C W S;D
S X A P F | X S P A;F
H L W B C | W L H C;B
J K Y C Q | K C J Y;Q
Y N T E U | Y T U E;N
Z M P H L | M P L Z;H
L Z F D H | H Z D L;F
F L C M Z | C F L M;Z
W T Z J B | J W T B;Z
Q A M O R | A O Q R;M
W K E C U | C K W E;U
S E D L X | X L D S;E
I A L J Z | A I J L;Z
V N C Y S | N V Y S;C
C M R D T | C M R T;D
I N W R Q | I Q W N;R
D C M O A | C A M O;D
O P G F V | V F P G;O
Y X L R A | X A Y R;L
S I J W D | S D W J;I
S T A P C | A T P C;S
E H C O V | V C H E;O
T X J M C | C X M J;T
X U D S L | L S U X;D
J X Q W K | K X W J;Q
B A U N C | C B U A;N
D L F Y R | F D L R;Y
P E C J Z | E C Z J;P
E V F U H | U H F E;V
Y O A E V | E A Y V;O
W F Y O D | D Y F W;O
D Q Y C N | N D Q C;Y
M V J P D | P M V J;D
S V I X C | C S I X;V
V F Y W E | E W Y F;V
Q Y M J O | J Q Y M;O
F J U M A | J A M F;U
F P L A O | A O L P;F
Q Z V L O | V O L Z;Q
C U G J R | G C U J;R
T D V O I | O I T V;D
N K J I C | J C N I;K
X Z J B W | W Z J B;X
G C M D R | M C R G;D
V G M I E | I G V E;M
V E Z S W | W E V Z;S
W J G C I | C J I W;G
L D V H N | D L N H;V
Y N C M D | N C D Y;M
T L Y K V | T K V Y;L
C Y W O A | Y A W C;O
B F K U L | K F L U;B
Q V K A I | A K V Q;I
H F O V Y | O F H Y;V
B H I J W | W H B J;I
H I Z R G | I H R G;Z
P U T I E | P T U E;I
A L Q T M | L T Q A;M
Q G Y M J | G Y M J;Q
I K A E M | M E K I;A
C U S V D | C D S U;V
S Z W A F | W F S A;Z
H K X E Z | E X Z K;H
V D E H A | D A V E;H
B U M G Y | B U Y M;G
B D K S P | B D K S;P
I X Z F J | I Z X J;F
P B H Y J | J P B Y;H
X H T D E | D E H X;T
Y R G L V | Y G L V;R
M T Y H A | A Y T M;H
U B E H M | U E H B;M
B L W G Z | B L G W;Z
G X U T I | I G X U;T
O B H Q E | B H E Q;O
L V X P B | V L B X;P
W U O P S | W P U O;S
K V G L F | V F G K;L
I Q V X M | I Q X V;M
W C F R T | R C F W;T
U A N S C | N S A C;U
T L R F W | F T L W;R
J D U T S | S T J U;D
P R B D O | P R D B;O
C X D M N | M X N D;C
I N B G O | G B I N;O
H J G R Q | G H J R;Q
H V R Y T | T Y V R;H
U L S K A | K S A L;U
J R O Q F | R J O Q;F
C A I O K | O C A I;K
W T F J P | T F W J;P
N I S F P | I P S N;F
S I Y V G | Y V I G;S
A F B Z C | B F A C;Z
Q Z G A O | A Q Z G;O
P I G L J | J I L P;G
X Q Y W J | J Q Y X;W
E W A P X | P W A E;X
Z S A U Q | Q S U Z;A
X E Z Q A | X Q E A;Z
V X J M I | M I X J;V
G D W V H | V H W D;G
J D N E X | J X N D;E
Y V G L J | J L V G;Y
W U F E X | F X E U;W
O H P U Y | H Y P U;O
G Y F U J | Y G J F;U
X W H D Z | D W X Z;H
R A F N W | R N F A;W
X P O A B | P X B A;O
Q D Z Y R | Y D Z Q;R
C F U T B | C U F B;T
K G O L H | O H K G;L
K W G C A | G W K C;A
N M I J H | M N H J;I
D I L Y Q | Y I D Q;L
E Z S U X | Z X E U;S
V Z U J L | Z J U V;L
I K J L N | I L J N;K
S N D U A | S A D N;U
U B F M K | K U F B;M
U S R X I | X I U R;S
T B S F X | X S F T;B
Q J A X C | Q C X J;A
C S E V I | V C S E;I
E R U N C | C U N E;R
C Z G F X | X G Z C;F
F E I A M | E M I F;A
K L G N D | K N G L;D
W S K E T | E T S W;K
W R P S G | P R S W;G
I G U M F | I F G M;U
P C X J Q | C Q J X;P
Y X W Z I | Z X W Y;I
N J E B L | J B L E;N
V L C Z B | C L V Z;B
C I U D T | I T C U;D
G Q P M L | M P G Q;L
K N Q F P | N Q P K;F
T Q B D O | O T Q B;D
W R X Y V | W R X Y;V
P B L D C | L C P B;D
U J E D S | J S E D;U
P C U N B | U C P N;B
V S Z M U | S M V U;Z
Y P S X L | L P Y S;X
Y M I W H | M W I H;Y
A N G W V | W N V A;G
B P D L V | D V B L;P
U L X N S | S X N L;U
S V C K D | K D C S;V
A V L O M | V L M A;O
A X E H Y | H E Y X;A
S W Q J P | J W P Q;S
W M J D H | W J H D;M
J H D U A | H J A U;D
V H X R A | X R V A;H
E C Q Z K | E C K Z;Q
Z Q N S T | Z T Q N;S
X I L Q R | L Q R X;I
P H W J G | P J W H;G
K S Q V W | V Q W S;K
I G Y M T | Y G I M;T
F P O W V | W O P F;V
M F K T B | M T B K;F
K U P W H | W P K H;U
L Y C E S | C E Y S;L
V C K Q G | K G C V;Q
E Q B T M | E M T B;Q
N V F B M | B M F N;V
C W J R L | R C J L;W
E F W Q O | W O Q E;F
I W Y Z H | I Z H Y;W
K C U R E | U R C E;K
E Y T D N | Y D N T;E
V X C F W | X V C W;F
S A Z U V | Z A S V;U
F U P W O | W F P O;U
H Z O L N | O H L N;Z
A X Y K E | K E X Y;A
U J N O D | O U D J;N
N T Y C E | C E T N;Y
M V G Q E | G V M Q;E
O Z R J C | Z J O C;R
M R O Y S | Y S R O;M
V E Z L X | X V E Z;L
R T G C E | E T G C;R
P W J B Q | W J B Q;P
O X P W R | P O W R;X
S W Q V Y | S W Y Q;V
G M R W X | M G W X;R
U Y T E J | Y U T J;E
N S I K X | S X K I;N
M L X S V | M X S V;L
F P R K H | R P H K;F
K L P F O | F K P L;O
I E Y P B | I Y P B;E
C L X I N | I X C N;L
S G X R I | X S I R;G
L J Q H C | Q J L H;C
X S W F U | X W U S;F
O G C I F | G F O C;I
V G A X H | H V X G;A
C B S K N | C K B S;N
E R N U Z | Z R U E;N
H A B J R | R J B H;A
T J U F H | F H J T;U
B H Q Y X | Y B Q X;H
M C E S R | M R E C;S
O K A Q T | T A Q K;O
G X U Z N | G U Z N;X
S Q U F A | A S F Q;U
B C U A R | A U R B;C
Q A I G Y | A Y Q G;I
S X C M W | M W X S;C
T P I H C | I P H T;C
O P Y Z T | O T P Y;Z
X A F Q K | Q K X F;A
K O Y E S | Y O K E;S
D I G H A | G I H D;A
I B Q Y U | Y B I U;Q
B E M A Q | M B Q A;E
C K W O A | A K C O;W
Y Z R T B | T R B Y;Z
V U L M Q | M U Q V;L
Z N H Q Y | H Q Y Z;N
A X F E N | X N F A;E
A Z L T F | Z T F A;L
M N F H O | F M N H;O
B Y U W J | Y W B J;U
Y K O D A | O K A Y;D
M B Z Q V | M B Q V;Z
B X C O V | V C O X;B
B S M K O | B M K O;S
P G L N E | E L G N;P
U Y W J R | R U J W;Y
L V O I P | I V O P;L
C D Z U E | D Z E C;U
Y Q N T H | Y H T N;Q
B U J N R | U R B J;N
E C R Y L | E R Y C;L
G O W K Q | Q G K W;O
S W O X G | W S O X;G
D Z F W H | D Z F H;W
Q A C N S | S C Q N;A
D N P H I | D H I N;P
A H X N J | X A H J;N
U R C Q Y | Q U R C;Y
C K D X V | V K C X;D
D A Q J E | A J D Q;E
C U E Z R | Z C R E;U
C S O A H | O H S C;A
Z Y B H V | V B Z Y;H
Z J H Q A | J Q A Z;H
O U P F T | P U T F;O
Z Y W M V | V M Y Z;W
D K A W B | D W A B;K
N K V R H | V N K R;H
Z M L W G | L Z M W;G
Z V D W M | V W Z M;D
J E V I P | P E V I;J
T B L I X | B X I T;L
A B M S Y | A M B S;Y
R B V D W | V R W D;B
R Z Y E M | R E Z Y;M
I G B Y N | G Y B N;I
W F H M P | P M W F;H
D H S T J | D T H J;S
A Z F C L | Z L A C;F
R N X Z Q | N R Q Z;X
O Q S D C | O C Q D;S
T I O X J | T X J I;O
J G I N X | J N G I;X
V D U Y L | V U L Y;D
L I A H K | I A H K;L
S F C H O | H S C O;F
C T U P W | C W P T;U
U X N Z T | N T Z U;X
L W R S Y | S W R L;Y
H G V B X | G B V X;H
O H X T S | S O T X;H
C A P B V | C V A B;P
J A M B K | M K J B;A
D G X H Z | D Z G H;X
K F L I Z | F L K I;Z
M P A H Z | H P M A;Z
L D K Y V | K D V L;Y
V R U K G | K G R V;U
P Z M S E | P M Z S;E
Q G N T B | N Q T B;G
H A Y X D | X Y D A;H
E W L M R | R E W L;M
B C V M N | N V B C;M
M A F T P | T F P A;M
I H M A F | M H I F;A
F B Z K I | I B K F;Z
K F M H T | T H F M;K
J P I L Y | J Y P L;I
U D C O F | F D O U;C
S Z K G A | K Z G S;A
R D U O H | R H U O;D
G T O P B | T G B P;O
K E L N M | L E M K;N
Z J H C V | J Z C H;V
Z M O Y E | Z O E Y;M
K T Q X P | K T X P;Q
E S H G A | A H G E;S
A I H J E | I E H A;J
O P T Q D | T Q O P;D
S A B O V | V A O B;S
J G Y E S | G J S E;Y
J S Y L P | P J L Y;S
R O B G V | V R O B;G
R J Q V U | J V R U;Q
O R Q T V | V T Q O;R
W H E A O | O W A H;E
S C B Z E | S C E B;Z
K M Z H Y | K Z H Y;M
V E X I M | M I E X;V
Z N Q A K | Q Z A N;K
K G S D J | D K J S;G
M R S A L | L R S M;A
U F L S I | L U S I;F
X J M R U | U R J X;M
X J U G I | I U J X;G
X A T V O | X A T O;V
M G E Y P | E Y G P;M
H J E M Q | Q H E J;M
Z E R K S | Z R K E;S
U O E L J | J L E O;U
W A H S I | I A S H;W
O J W M T | T O W J;M
L A W J B | J L B W;A
V W J F K | J V K W;F
U K M Q P | U Q P K;M
L U P Y V | Y U L V;P
V Q A U G | A U G Q;V
W I F X O | F O I W;X
P K H D Q | H D Q P;K
S G L V F | L F G V;S
Q P O Y X | X Q O Y;P
W C Q F H | C W Q H;F
B M J T C | T J M C;B
H F D U W | D F U H;W
S G I P L | L I P G;S
L N T H F | H N T F;L
H M K C G | C H M G;K
X I H J O | O H I J;X
X B P E V | B V E P;X
B V G D F | B D V F;G
E D N O Q | N E O Q;D
J X A F O | J A X O;F
A U I R C | C A R U;I
I A L D T | L T A D;I
N Z B W A | N B A Z;W
X U F Z N | U Z N X;F
F W D J T | W T D F;J
V F Z I W | V I W F;Z
Q M T G K | M K G Q;T
N O A V C | A C V N;O
H Q F Z K | H F K Z;Q
O A D C H | A O H C;D
L Q P Z B | B Q L P;Z
J Z P G H | H Z G J;P
W I F A G | F I W G;A
R P S H I | S H P I;R
Z W I V D | Z D I W;V
T I Q V N | I N Q V;T
J F X R B | R B J F;X
J C N Z Y | Y N C Z;J
H L Y G W | W L H Y;G
B I R P O | R B I O;P
D N K O E | D E N O;K
S A H Q R | R H A Q;S
A L W J F | W J L A;F
X S M A E | X A M E;S
X W A J B | J X W B;A
H N X D W | D X N W;H
R M W J G | G W M R;J
V U W T D | D U W T;V
I C S F X | F S I X;C
S A M B L | B S A L;M
Y K X P U | P X U K;Y
C V X W L | W L C V;X
E S M H T | M H S T;E
Y Z W U B | Y W U B;Z
Y D G X Z | X G D Z;Y
P W T D S | P T W S;D
S O P Z D | P S D O;Z
F H U K D | U K D F;H
S J Z W B | W J Z S;B
K W E A B | B A W E;K
K M B E P | K B P E;M
E O T K W | O W K E;T
M Y W Z D | Z W D M;Y
R Z P A L | R P A Z;L
U T L R G | T U R G;L
O D K Y Z | Y D O Z;K
J O T M H | T J M O;H
A X V F Q | A Q X F;V
O I H Y U | O H U Y;I
X I Z C Q | Q X Z I;C
A H C B D | C H D A;B
R V L S Y | R V Y S;L
Z O I N X | Z I O X;N
F O L M X | M O F X;L
Q C G P B | Q B C G;P
M R P D Y | M Y P D;R
B I O D L | O D B I;L
E F T M V | F V M E;T
D F R T A | R T A F;D
N R C K L | L N R C;K
B N C Y A | A N Y B;C
K D W O G | W O G K;D
O A Q L Y | L Y Q O;A
X D G N L | G D L N;X
Z R Y I L | Z L Y I;R
H Z P G R | Z H P R;G
M C L Z K | M Z C K;L
F G O W L | W F G O;L
T Q D Y Z | Q Y T D;Z
I N J H D | N D J H;I
R I A S Y | I S A R;Y
K Q E S X | K X S E;Q
O Q L V K | K O Q V;L
D A P Z M | D A P Z;M
D S E A X | D A X S;E
S F X W B | S F W X;B
I T B C R | T C R B;I
F L T U B | F L U B;T
Z W Q M S | Q Z M S;W
H G S D L | H G L S;D
D S G O Q | D O Q G;S
A C E H Q | H Q C E;A
U V X F Q | X V U F;Q
P V E L T | P E T V;L
K V A L M | L A V M;K
K C E J S | E K C J;S
Y S C U O | Y C U S;O
O M G Q E | M O E Q;G
T M O Z E | E Z M T;O
E Z X C G | X C Z G;E
T S V N M | N V M S;T
D A V Z S | V A D S;Z
T B C O G | O B C T;G
G T O H E | G O H T;E
C L B W U | U C B W;L
C H V A U | U V C H;A
A H N B M | N B A M;H
Q F Y G L | Y G L Q;F
T W R K V | V W R T;K
V N Z A G | N A Z G;V
G J V Q C | G J C Q;V
V U T P D | U P T V;D
L G P A X | A P L X;G
U M L V Q | M V U L;Q
T C N O J | J N C O;T
Q H R N B | Q N H B;R
T Q H N D | Q D T H;N
M P I L X | L I M X;P
P N Q K T | N P K T;Q
V I W N B | N V I W;B
O Z R P L | P L O Z;R
R C P S V | S V R P;C
R V Q E P | E P Q R;V
I K Y O N | Y K I O;N
A W F R X | R F A W;X
W Q I N F | I Q N F;W
C S L Z E | S L Z C;E
M Z A K Q | Q K M A;Z
C Y M Q S | S M Y Q;C
S I O C A | A O C I;S
J H X O F | F X O J;H
W B T L K | B T L K;W
D N B F L | L N B D;F
Q S U O K | S K O U;Q
H Q X Y K | K Y H Q;X
U V F G D | D U F V;G
W F A T B | A B W T;F
R Z D J B | R J D B;Z
B C Q M V | B Q M C;V
I N Y P Q | P I Q N;Y
P Y O X C | Y O X P;C
Y J M S A | Y M J S;A
T S P Y L | T P L Y;S
P V D Z K | K P D V;Z
J S N A R | N J A R;S
V B L Z I | B L Z V;I
I N K R G | N I R K;G
A D I M U | U I M A;D
I N A Z R | N Z R I;A
D M W O A | D M A W;O
V Y R M F | R Y M V;F
P M G Q F | Q G M P;F
U W H F X | H U W F;X
R E X G N | G R E N;X
Q P W X U | P W X U;Q
U X V Y H | H U Y V;X
Y E C N F | F N E C;Y
V D P I O | V P O I;D
O R L J P | J O R L;P
A V O D W | O D A V;W
N I F G V | I G V N;F
O U N C P | N O P C;U
L F Q B G | B G Q F;L
H I M A G | I H A M;G
R N G V T | G V T R;N
O I Q U Y | I U Y O;Q
M K T F B | F B T K;M
T S R V N | S T R N;V
X T L P G | X L G T;P
U Z R O Q | U R O Q;Z
H D G S E | S E H D;G
I C L J R | J R L I;C
A M P S I | S I M P;A
J M Z E I | J Z E M;I
Q L W O P | O Q W L;P
Z M B Q R | Z Q B R;M
U R Y V L | R U V Y;L
E J A W F | F E A J;W
L G T U P | P U G L;T
R Z C U F | C F U Z;R
J N X C B | J B C N;X
J G Y U C | G J Y U;C
K U B W O | W U K B;O
U G Y A M | U Y A M;G
J C N Z H | H Z N J;C
C I R L U | I R C L;U
K I U G H | K U H I;G
A U O J V | V A O U;J
H J K Y T | Y H K J;T
W T O S J | S J W T;O
F U C T E | E F C T;U
F M Z N W | W M F N;Z
A R C N K | N R C A;K
U Y K Q F | Y K Q U;F
X U Z K D | K Z U X;D
B P X N D | B P D X;N
S E P D T | T E D P;S
U R I M D | I U R M;D
L X D F P | X F P D;L
M I H Y T | I H T M;Y
Z U L Y T | Z Y L T;U
W O F Q B | W Q F O;B
B G O W S | S B O G;W
U K H W N | N H U K;W
I Y G K R | R K I Y;G
Y U H P M | H Y M U;P
I T N E O | T E I O;N
U D S N P | U S D P;N
I R N V X | X R N I;V
N Z V L M | N L Z M;V
T R K C I | I T C R;K
H F E Z V | Z H E F;V
H X S N J | H J N S;X
E T X J S | E X J T;S
A K O Z C | Z C K A;O
D T A P O | P A T D;O
J X S C Z | J C X S;Z
N L M I W | M N L I;W
W A P V J | P J A W;V
O R C V S | O C S R;V
D T G U B | U T D B;G
E D Z V H | Z E V H;D
M B V N R | N M R B;V
W K J M V | J K M V;W
O C L W E | O W E L;C
J E B L S | E L S B;J
O A V B H | H A O B;V
C H Y A K | K Y H A;C
F Z W T Q | Z Q W F;T
L N I S D | S L N D;I
U J P W A | U W J A;P
Q Y A F C | Y A Q F;C
L Z I O H | H Z O L;I
L V M Z C | L M V C;Z
O B P V F | O F B P;V
B L M C Y | C Y B L;M
D B M F Y | B D Y F;M
B H A D P | A H B P;D
B Y H F R | Y H F B;R
S H W U I | W S U I;H
S O D P Y | D P S Y;O
L H G B T | B G H T;L
L E A S G | E S A L;G
M P W U I | W M P I;U
O X S R T | X S T R;O
D U B S Z | D B S Z;U
R I K P H | R P I H;K
K V T I O | V T I O;K
T F L B Y | T L F B;Y
B X M Y H | X H M B;Y
Y Z E D O | D Y Z O;E
X O W V G | X G W O;V
B I U Y O | I U Y O;B
W C J I S | I J S C;W
G S W T C | C T G W;S
E B M Z Q | E M B Q;Z
A C E P I | C P I E;A
B E Y X M | M Y E B;X
R U K T X | T X R K;U
S H U V W | U V S W;H
A F X C U | U F A C;X
N E W A C | A N C W;E
G P Z A D | D Z P A;G
Z G W X C | G Z C X;W
G M S Z A | S Z G M;A
Y R P V M | P M V Y;R
Q R X A Z | X R Z Q;A
P K V S M | M S P V;K
I Q S C L | Q C I L;S
V G U Q E | G U V Q;E
A H G N B | N A B H;G
T Y Z C B | C B Z Y;T
V R K X L | R L K X;V
O T R Q X | T O X Q;R
P Z G U Q | Q Z U P;G
W R T P M | R T W M;P
J D L S Y | J S D Y;L
W Q G C H | H Q C G;W
C I R U G | I G C U;R
V J Q D N | V Q J D;N
F U B D Q | U F Q D;B
Z N V J E | N V E Z;J
A N L H S | L H S A;N
B M F E Y | M F Y E;B
Q R M L B | Q R M L;B
F K A L M | F A M K;L
L R F N E | E N F L;R
B J R F Y | B F Y J;R
Q N S H Z | H S N Q;Z
N G T F S | N F G T;S
E J U D B | E U B D;J
R N G A H | N H G R;A
K L I C S | K I S L;C
K L N W J | L N K J;W
T L Z E O | O L E T;Z
R P Q C Y | Y C Q P;R
X C H R F | C F H X;R
D G U B O | G U D O;B
T L W X B | W B L T;X
P M G S K | K S M G;P
K H I Y C | H I C K;Y
N M U I Y | N Y M U;I
N I G Q U | I Q N G;U
E H L W Z | E Z H W;L
I Q V J R | V I Q R;J
J H X F N | J X F N;H
A J B Q L | B Q L A;J
T O L K A | O T K A;L
O T J A Z | O J T Z;A
D S P K M | M K S P;D
G L M F J | J F M G;L
N T M K H | N T K M;H
B J X P Q | X Q B P;J
O G V S I | G O V S;I
X E S J M | M S E X;J
I Z P G T | Z G P T;I
W R P V O | W V R O;P
Y D F M N | M Y D F;N
C E Y M I | C E I Y;M
H S D G U | D S H U;G
G F K R X | X F K R;G
I V C S Q | C I S Q;V
A I B L E | B L I A;E
F R P C B | P B R F;C
L M G V H | G L H M;V
M A C B P | A P B M;C
F Q B N T | Q F T B;N
V A U W G | G A U V;W
V C A N M | C M A V;N
X N O L T | N O T X;L
B D P H V | B H D P;V
U Q M F E | U E Q F;M
E W A K B | B A E W;K
C Y Z Q F | C Q F Z;Y
W O M J V | W O V J;M
M G K D Q | K Q D M;G
J O H G X | J O H X;G
P G U Z E | Z E P G;U
M Y W Q P | M Y P Q;W
T H F J I | T H F I;J
D T N W Y | D Y N T;W
D C U K S | K S U D;C
P A H L C | A L C H;P
P Q K J G | J P Q G;K
I B U K Q | K U B Q;I
O R T B Q | T R Q O;B
P T I Z V | V Z T P;I
V K L U D | U L D V;K
J A V P N | V P A J;N
X G B J K | G J K X;B
L R C I H | R I H L;C
V L A Y N | N Y V A;L
N R I Z C | N C R I;Z
F Q W N U | N Q U W;F
N D H O A | A N D H;O
N W J L K | L W N K;J
R C V T H | T H V C;R
E T S O Q | S E O T;Q
Z J U B E | J U Z E;B
J C W P D | C D P W;J
J T G W Y | T G J W;Y
G E P D X | X P E D;G
Z R X Q I | X Z Q I;R
R Z C G T | R C G T;Z
L O R A H | H R A O;L
B W M N Z | N M Z B;W
E F A N Z | F E Z A;N
Z H O B E | E Z O H;B
F X A S Y | S Y F X;A
V I Q C M | C I V M;Q
Y P C E U | U C E Y;P
C Q M I R | M R I Q;C
U Q S R B | S Q R U;B
X V S I M | S X I V;M
O W Y E V | E Y W O;V
P I E X T | T P E X;I
W U L V E | U W E V;L
Q A G D L | G A D Q;L
K Q Y M U | Y K U M;Q
R Z D C P | Z D P C;R
T I A Q F | Q A F I;T
T Q O R B | T Q O B;R
G O W Y C | C O G Y;W
H F G D M | G M F D;H
A K M P R | P R A M;K
B P A D O | O A B D;P
X I N U W | W I U X;N
X Q F L R | X L Q F;R
X N R U L | L N U X;R
B U G H R | B H R U;G
K L D V N | L N K D;V
K B T D I | D K B I;T
R E P G A | G E R P;A
L C V W X | V L W X;C
O Q N U C | Q C N U;O
R S U Z O | O S U Z;R
K Y D Z B | Y Z K D;B
R C W L M | M C R W;L
U I A G P | U A G P;I
K F R G E | F G R E;K
Z R H E X | Z E H R;X
A P Z E X | P Z E A;X
I G M N H | I N H G;M
Z X D C R | D Z X C;R
O S Z E V | V S E Z;O
W R O H C | R W C H;O
H I N B R | H N I R;B
C G I Z N | G N Z C;I
X Y Q C P | X C P Y;Q
N C Z Y T | C Y T N;Z
W V S X Y | V W X Y;S
T S J U B | B U J T;S
L D O K Z | O K Z D;L
V X M G K | K V X G;M
E J C O D | O E J C;D
R F N P V | P F N R;V
P Q I Y H | P Q Y H;I
O C A D T | T C O A;D
O F Z U I | F Z U O;I
L J B M K | L J B M;K
M U O J C | M C U O;J
A Z Y R U | Z A U R;Y
D E K X G | K E D G;X
R E L K C | E R K L;C
P Q R I U | P I U Q;R
D V C A N | N V C A;D
I K S C Z | C K S Z;I
T G Q I N | N I T G;Q
T P R V M | M P R T;V
E I P A X | X A I E;P
J K Z Q D | J D Q K;Z
A J K O W | O W A J;K
Q D T A M | T M A Q;D
O P H X B | P H B X;O
I Y S L G | L G S Y;I
O U V T H | T O H V;U
E O B Y S | B S Y E;O
G N A P J | A G P N;J
T V B F C | F V B T;C
V W P C D | W P D C;V
X I U O H | U I O X;H
S P L M V | S M P V;L
Q I C E M | E C I M;Q
H L B O C | B L O H;C
R K Z D Q | R K Z Q;D
S E T Q U | T E Q S;U
Y Q P H N | Q H Y P;N
N Q O F A | N Q A F;O
W D M R Q | D R Q W;M
D C X U E | E C U D;X
V B C N P | N C V P;B
T N V H U | T N H V;U
K X F G R | R G F K;X
V Y A X R | V X R Y;A
V F M L D | F V D M;L
Z I S K G | S Z K I;G
M V U J H | J H V M;U
E P F Q N | F Q N E;P
F P R N Z | Z P N F;R
X Q T B H | H X B T;Q
O N K X Z | Z K O X;N
O W V G M | O G V M;W
C I V F K | K C V F;I
F E P G B | B P F E;G
U B I Q D | D B U I;Q
S J Y P N | S P N Y;J
R F H P X | F P R X;H
I M U H S | M U I H;S
L P Y W Z | Z Y P W;L
O T X C D | T D C O;X
A V M R B | R A B M;V
P R J Y S | Y J P S;R
B N T Q Y | B T Y N;Q
N G B K J | G N K J;B
K L S B M | B M S K;L
S T N X F | S N F X;T
Q W M E C | M E Q W;C
W L J X P | P J W L;X
D I N J A | J I N A;D
B Q J V C | J Q V C;B
Z J H V U | U H J Z;V
R O X V D | X O V R;D
D G Y V F | D V Y F;G
V O T I C | I C T V;O
K B H I C | K I C H;B
E H P T D | E T P D;H
S E B K H | H S K E;B
I S K W N | K I N W;S
G K W J D | D G W K;J
Q J S Y Z | Q S J Z;Y
M I J K D | I J K M;D
W J N O C | J N C W;O
V C L M Z | M V L Z;C
U E S K C | C K U S;E
A O V S K | A S V K;O
Q F Y V G | F G Q V;Y
F Z T L Q | Q F Z T;L
H X S K G | X G H S;K
N C Y O D | C D O Y;N
E X O L Q | L X E O;Q
N S G R F | S F G R;N
F H C J O | O H F J;C
L E I W H | E H I L;W
I H C N X | I H C N;X
E J Q B T | J B E T;Q
T C U M F | U F M C;T
V X Z T J | V T J Z;X
C Z I L R | R Z C I;L
A U Z S I | S U I A;Z
M X L E K | M E X K;L
T V K D G | D K V G;T
L D K Z A | K D A L;Z
S F E A J | J F S E;A
X P H M L | X M H L;P
H G K F N | G K N F;H
D W V H Q | D V Q H;W
S H N T L | S N H L;T
I H T P M | I M T H;P
G K M Q B | K B Q G;M
L Y R N T | L T N Y;R
K G T N D | G D T K;N
B F D E K | F K E B;D
U T S K D | K U D S;T
L F T N Q | T Q F L;N
L O E T C | E C O T;L
S N R L U | S L N U;R
I V O W L | V W L O;I
X E W P K | P K E X;W
P Q V X I | Q I V P;X
W L F I U | F U W I;L
I Q F P V | P Q V I;F
Y U X T E | T U E X;Y
G V Y Z C | C V Y G;Z
A O D R Z | O D A Z;R
C D T S J | D J T S;C
G I M F V | G F M V;I
T Z M V N | M T N V;Z
W Y Z R E | E Z W R;Y
B H J D X | B D H X;J
J A V R G | A G J R;V
O W H K D | O H D K;W
U N Z H V | V H Z U;N
C G P X M | G C M P;X
I K U F P | F U K P;I
K P C O E | O K E P;C
Z D P E Q | P E Q Z;D
D R Q L F | F Q D L;R
B D K O H | H D B O;K
Q T C M H | Q M T H;C
M O Y A S | A S M Y;O
Q G X Z H | H G X Q;Z
H Q C P F | P C H F;Q
T O N W H | N H W T;O
K U R T W | W U K T;R
N S F C A | F N C A;S
Y T U X A | U X T Y;A
E U W F Q | U W Q F;E
D Z S R G | R S D G;Z
Z O L E G | G L O E;Z
B F D Z P | B F Z D;P
F M B Q U | Q B U M;F
I P J K W | I W K P;J
S C D N Y | Y D N C;S
D B G P F | D F B P;G
J T A F R | J F R T;A
X P G R Y | Y R G X;P
B E O X T | T X E B;O
C P Y L M | M L Y P;C
I G L V P | I V G L;P
H L V M U | L U V M;H
J D E A B | E J A B;D
X A V F B | F X V A;B
Y A W J S | Y S A W;J
E J B N L | E N L J;B
A U V T X | V T X U;A
J D I O Z | J I O Z;D
G U C T Q | C T U Q;G
Z H P B X | H B P Z;X
Q X T Y G | T G Y X;Q
S I F U K | F K I U;S
K N W C Y | W Y N C;K
K F Y N E | F E N K;Y
Z B Y U X | Z U B Y;X
U T J X F | T F U J;X
Q R Z Y J | Q Y J Z;R
F W A G H | G H A W;F
V D G O J | G O D V;J
K B H E W | E K H B;W
X P U J V | U X J V;P
C N E F P | F P E N;C
E C Q Y S | E C Q S;Y
G L O P X | P G L O;X
W R G D N | G W D N;R
D G Z W N | W Z G N;D
X N H W C | N H C X;W
R E I W N | E W N R;I
R Z C T U | Z C R T;U
O Q S F J | J S Q O;F
E C Q F L | E C Q L;F
P X N R F | R N X F;P
O D N Z I | D N O I;Z
E N M B I | I M E B;N
X T I G A | I T G A;X
F R Y Z B | F B Z R;Y
H W P M Z | P H Z W;M
T X L A W | A X T L;W
O Z S A H | Z O A H;S
K R V A D | V A D K;R
V H J C G | J V C H;G
O A L C R | A O R C;L
H Q P M N | Q P M N;H
X Z S Q B | B X Z S;Q
S B I T Q | B T I S;Q
Z G U V S | Z G S V;U
Z N V A B | V N Z B;A
F I S U R | R F U I;S
E U C R H | E U H C;R
O A M X D | M O X D;A
Y I D N V | I N V D;Y
A M N S X | A N X S;M
F A S G C | S A C F;G
U D K E F | U D E K;F
O H T G D | O H G T;D
A X M K I | A I X K;M
Z G Y U O | O Z U G;Y
R M A W Q | R W Q M;A
C J N Z Q | Q N C J;Z
O W F P Q | O P F Q;W
D C T Y K | T C K D;Y
Q T C R L | T C L R;Q
U R H F E | H F R E;U
H J U F P | J P F H;U
D R F W Y | W D R F;Y
M O A B N | A O B M;N
S F R T Q | S R F T;Q
P T S D I | S D T P;I
N L X C J | L X J N;C
F O X N C | X F C N;O
X P E S M | M E X S;P
R Q K W A | K Q W R;A
K H I O R | H O I R;K
G E B K F | E B F K;G
Q A P V I | V I A Q;P
B Y X A I | X A Y I;B
P F O M R | R P F O;M
U L N A F | A L F U;N
Q B W X C | C Q X W;B
D G W Y R | G R D Y;W
M D F U I | I U D F;M
N Q C W D | N D Q C;W
K E O Y C | C E K Y;O
V D B X N | D N B X;V
T O P F L | T O L F;P
I A M G H | G A H M;I
T A W B Z | A T B W;Z
Z A P X O | A O Z P;X
V K F E S | V E F K;S
W E D X O | X W D O;E
Z W A B R | A B R Z;W
P L N A U | A L U N;P
G B A V C | V A B G;C
V E C Z T | T E V C;Z
H B D U C | D B C H;U
I Y Q P A | I Y A Q;P
V Z R N K | Z R V K;N
G D H Z L | H L D Z;G
V H G S E | G V E S;H
B T W E Z | B Z E W;T
W Q N A P | P N W A;Q
V X K B L | V B X K;L
Y A F J D | D A F J;Y
N M G V A | G N A M;V
M Q X H Y | Q M H Y;X
S H R J U | S H J R;U
B I P O K | P I B O;K
Q A T J W | W T A J;Q
F Z O J N | Z O J N;F
M X A L Z | Z M L X;A
B V H J U | H U J V;B
W K P L F | P W L K;F
A Z E U G | G Z E A;U
Y C H A D | H D A Y;C
Z H F V P | Z F H P;V
O U M Z T | T U M Z;O
R T V N X | T V R N;X
H N R E I | N I E R;H
A H C D O | O C D H;A
L M N A R | A L R N;M
G D L C B | L G B C;D
U P S J V | U P S J;V
O M C T B | T M B C;O
B F J Q D | D Q B J;F
B H R O W | H O B W;R
H S Z J M | M S H J;Z
Z L U Q K | Z K Q L;U
Q U T N O | O N T U;Q
N B O J Q | J Q B O;N
W H I U P | W U H P;I
O T X A L | T O X L;A
U E T X F | F U T E;X
I Z J Q W | Z W I Q;J
O V C J D | D V O C;J
G K C D J | K G C J;D
A R O L G | O R L G;A
Z D B U T | U Z B D;T
O K E N J | O J E N;K
I L V Z A | V A I Z;L
D V P O J | J O P V;D
Z D I R K | R D K I;Z
J E I W B | W I J B;E
B L V E H | V L E B;H
K M W L T | M L K T;W
O W M A E | E W M O;A
Y H C V K | V Y C K;H
K Y N H I | I N Y H;K
P K F N Q | Q P K N;F
C H F A J | H F A J;C
L H S Y P | P S H Y;L
S M G W L | S M L W;G
R I Q F D | R D F I;Q
E H Q P G | Q G E H;P
I V G K N | V K G N;I
P M T O A | P O A M;T
U W F H Y | W F U Y;H
Z V U G B | B U Z V;G
H E C I S | H E I C;S
R H K X P | P R K H;X
P Q K T S | T S K P;Q
G V P O R | O R G V;P
K T E X D | E X D T;K
I Y X H Q | Y H Q I;X
A W M O X | O A X M;W
S I Z F J | S Z F J;I
W K A F T | T A F K;W
O E Z I Q | O Z Q E;I
G O P W D | G P D W;O
Q A T X N | Q T X A;N
I D S K B | B I D K;S
V A T U Y | U Y T V;A
F Q G E O | F E O G;Q
K U G B J | K U G B;J
S H V O W | O S W H;V
P O W A G | A G O W;P
I T O D A | A O D T;I
L H O D M | L H O D;M
Z P E L Y | Y L P Z;E
Q J K S B | K B Q J;S
Q B D K I | K B Q D;I
X T I S Y | T I X Y;S
L I Q V D | D V I Q;L
E I Z T C | E C T I;Z
V E L H W | W V E H;L
M U Q F L | U L Q M;F
T R G C D | R C D T;G
Q M Y X N | X Q N Y;M
Y N M D Q | Y M N D;Q
G J F T D | D T G F;J
I X E F H | H E X F;I
X W N D Z | N Z W D;X
F Q H D J | Q H J D;F
I Q D B Y | D Q Y I;B
A T F J W | W J F A;T
Z D C B S | C Z S B;D
V C S B T | T S B C;V
D K L T Y | Y K D T;L
N F D J C | N D C F;J
F J Y K O | J K F O;Y
H D I T R | D T R H;I
M G Y I S | M I G S;Y
J N D L E | D J L E;N
M U H Q K | H U M K;Q
B M I Q L | M L I Q;B
H D W S Q | W D H Q;S
Q M N L C | M Q L C;N
N R Y I T | R Y N I;T
G V K J B | V J G K;B
Z P L E F | F Z E L;P
W Z N Y U | Y U W N;Z
Q W Z P K | W Z K P;Q
E B G W L | E W G L;B
N E Z L M | M L N E;Z
P I J E A | P A E J;I
X J Q W Y | X J Q Y;W
D M A K O | D M A K;O
G T U C Z | C G U Z;T
B L U V S | L V B U;S
Q Y P F Z | Z P F Y;Q
E W I P S | I E P W;S
F E S J N | S F N E;J
S X Q E C | S C X Q;E
R G I C U | C G U R;I
A B Z F C | A F B Z;C
J M F H L | L M J H;F
W A R I N | A W I N;R
B C S M Z | C Z B S;M
Q E A Z D | Z Q A D;E
K T I F W | K T F W;I
Q Y K N H | K Q N Y;H
I D A M S | S M D I;A
B W Q N T | W Q T N;B
E J T V G | G V J E;T
D C Y E M | Y C E M;D
D H B E X | D B X H;E
O V Q M B | M O Q V;B
W Z U X T | T X Z W;U
G I J L M | I G M J;L
R Z C O F | F C Z O;R
X H J L D | D H X J;L
I K S C Z | K Z I S;C
I B A W E | B W A I;E
R N A V C | C R V N;A
B W T R K | B K W T;R
J A T L P | J A P T;L
X C D R O | O D R X;C
W Z I B T | Z T B I;W
B F K U A | K U A B;F
E C I D V | V D E C;I
S B N L W | B L W S;N
P A B H N | P B N A;H
Y D J P O | P D J O;Y
U D H Q O | Q U O D;H
O W L F K | F L W K;O
P Q C D K | C K Q D;P
T A J N C | J A T N;C
W V X K O | O W V K;X
E V S R Q | S Q R V;E
P T G I M | M G T P;I
M E W X H | H E W M;X
X K C V O | K O C X;V
X C E F H | H C X E;F
P M X N I | P X N I;M
N H U R K | R N H U;K
I Y O T H | O T Y H;I
Q A Z C I | C I Z Q;A
H O L S M | O H S L;M
O G Q L H | Q G L O;H
J X Q O U | J O U X;Q
Z M H F S | H M S Z;F
Z V B N E | V B E Z;N
I Y W V N | V W Y N;I
Q F Y K G | Y F G Q;K
J Z K H R | R Z J H;K
C L W A O | A O L W;C
K F Y N G | K N G Y;F
X U T K B | T U B X;K
D Z R V W | V D W Z;R
E M O Y J | Y E O J;M
T S E N O | E O N T;S
M U J F E | U J F E;M
Z J F S I | S J Z F;I
X W Q C E | W C Q X;E
A Q C O E | C A E O;Q
V L R X Y | V Y L X;R
R S M E O | S R O M;E
Q V A N H | Q V N A;H
V E J Z Y | J Z Y E;V
M R D O V | M D V R;O
I Q M P N | P Q N M;I
U M N T C | C M N T;U
L P Z O G | P Z O G;L
Q S Z C P | S P Z Q;C
O P Y A F | Y F O A;P
Z I Q W S | Q Z I W;S
U X D W R | R W X U;D
M O D V H | V O H D;M
M J U F V | F J M V;U
J E K I F | I E F K;J
S A I Q V | V S I A;Q
F A Q C X | A X Q C;F
P A S T Y | S A Y P;T
P O H N X | P X N H;O
Q V F D S | Q D S V;F
D M Q E N | E D M N;Q
Y B M U H | U Y H M;B
R I K G L | K L R I;G
V F S X Z | F Z S X;V
U W R B T | B W T U;R
K N I Z O | N O K Z;I
N X D H T | H N D T;X
G W D Z R | W R D G;Z
S N V W F | W V S N;F
M D U B E | M B D E;U
C G Y O K | G K C Y;O
Y X Z I W | Y W Z X;I
Q N G T V | N Q V T;G
K I O M E | O I M E;K
K Q D S R | D Q S R;K
T W I H A | W H T A;I
R A F V J | F A R J;V
Q G O L A | O L G A;Q
H I Z W Q | Q Z W I;H
C M B Q T | M Q T B;C
T G Q V R | V T Q R;G
Y E S K G | G K Y S;E
J V D E M | J M E V;D
Z P S X I | Z I P X;S
E D O W X | E O D X;W
M A Z C R | M R C Z;A
W K M B C | C B M K;W
K Y M Q V | K V Y Q;M
J Z L B G | Z J G B;L
D C M A B | C A B M;D
W K B M P | K B M W;P
K F W O Q | O W K F;Q
K M B I H | I K H B;M
X V I L M | M X L V;I
L E J X R | E J X L;R
I Y D O R | I Y O R;D
R O A C I | O I A C;R
O P J E G | P O J E;G
W E R U L | W U R L;E
M L U K J | L J U K;M
P Z V Y W | P Y V W;Z
Y W A B L | A W L Y;B
V M H W S | S V M H;W
T H Y I S | I H S Y;T
L Y I Q C | Q Y L C;I
O Y Q X K | X Q K O;Y
T O D G F | D G T F;O
U F R N J | N J U F;R
J K M U G | U G M J;K
W Y Z I B | B I Y Z;W
B K Y H X | H X K Y;B
R P Q E O | Q R O P;E
Q J G U M | G M Q U;J
O W Z A H | Z W H A;O
U C J N F | F C N J;U
C Z J Y H | Y C H Z;J
U Z S B V | U V Z B;S
E Z V T A | Z T E A;V
X E O G A | X E G O;A
S D M V L | M V S D;L
Z R G J F | J G R F;Z
G M I L C | C G M L;I
I J Y L D | D L I J;Y
W J P E X | J P E W;X
I H O Z T | T Z O H;I
Q V L S H | L S V H;Q
Y H I C X | I H C Y;X
S M N K F | F S N K;M
K R E J G | R G K E;J
S B V U F | B S V F;U
J I W F T | W J T F;I
C A W N F | A C W N;F
X E S V P | E P V S;X
D F O V R | D V R F;O
I O D A P | D O A I;P
H Q F O W | Q O F W;H
I P E O F | F O P I;E
G T U A O | O G A T;U
Z F X S W | W F S X;Z
F G S O Z | S Z G F;O
L W C F K | W K F L;C
C S Z I A | C I S Z;A
Q K H S F | Q S K F;H
A G S N I | S A I N;G
R K N G X | R K N X;G
B F Q A S | B S A Q;F
B L R P D | R L P B;D
N M L Z Q | Z Q L N;M
D U B V H | D H B V;U
R P B O M | B M O P;R
X L I W B | W B L X;I
C E T D X | X D T C;E
L M C T H | L H M T;C
H Q N L I | Q L N H;I
X Y E J P | E J Y P;X
H U C M G | M G C U;H
N Y C I O | C O I Y;N
C H B W I | C H I W;B
Q H U J Z | U Q Z J;H
L W P H J | H W P J;L
B W Y U N | U N Y W;B
R O C L G | O L R G;C
P D C G Y | D C P G;Y
W V F J Z | F W Z J;V
V D R E W | V R D E;W
J P U R B | U B R J;P
T E G X S | X G T S;E
Q H U N D | H D U N;Q
N G Z T F | Z N F G;T
Q M R U E | E Q U R;M
A J W I R | J I R W;A
V P R I G | I V R P;G
I J Q C L | L J I Q;C
O C A H P | P C O A;H
V Z X B G | B Z V G;X
U D O I E | D O E I;U
H D Y U A | D U Y H;A
W B J I C | W B I C;J
G N I A K | I A K N;G
U K T W G | W T U G;K
R M E J Y | J Y M R;E
F W J V K | W V F K;J
U W P K R | R P W U;K
Y L X W D | Y W L D;X
R F H A E | A H E R;F
P B Y R E | E R Y P;B
D K B V T | V D B K;T
U B L O Y | O U Y B;L
Y L M Q F | L Y M F;Q
V O R B X | B O V R;X
D F T W H | D H T W;F
C K O G Z | G K Z O;C
K X I P G | I P G K;X
H S V G W | V S H W;G
P W Q Z A | W P Z Q;A
D G R Z P | D Z P G;R
J O B E M | E J M O;B
U H A E V | E V A U;H
A R N G Q | N R Q G;A
V E P A S | E V A S;P
K V M E T | M V K T;E
U C M B D | U C M B;D
S W R E K | E R S K;W
L C K Q E | E Q C K;L
G S V U A | A S U G;V
A Z H T X | Z X T A;H
A X Q T M | T M A Q;X
B F M V H | M H V F;B
D K S Y Z | S Y Z K;D
A F J K E | J E K A;F
D N M E A | E M N D;A
G M O E F | M O G E;F
Z C S X Y | Z S X C;Y
S O B M F | O F S M;B
W S B P H | P B S H;W
X J T M H | T X M J;H
E A J W H | A H J E;W
H A G X N | G H N A;X
P R V X Z | P X Z R;V
U A B X M | B X M U;A
N Y E K T | N T K E;Y
B V L A U | V B A U;L
F S W X H | W X F H;S
V L S C K | K L S V;C
C T P U R | U P C R;T
M L G H B | L H M B;G
K U L W N | N W K U;L
G N I F R | N F G I;R
D Z M P K | D Z K M;P
X W E V U | U W E X;V
B T Y F W | F B W T;Y
N Q J K R | K J R Q;N
A N J K I | J K I N;A
P W F A I | F P A I;W
U R K T Q | K T U Q;R
L V P O F | V P L F;O
B G T V R | G T V B;R
Z X E J U | U J X E;Z
C P D B N | N D B C;P
K H Y B W | B K W H;Y
Q K J A W | Q J W K;A
E O W K S | O E W S;K
N M F A E | F A N M;E
J F W O G | O W F J;G
F D K T C | T F D K;C
S P Z R N | Z S R N;P
H O I P T | T P I H;O
O S U R A | U A R S;O
Z H K U O | O H Z K;U
M E B K G | K M B G;E
K Z M I T | K T M I;Z
Q N K I V | N K I V;Q
D N Q B Y | B Q N Y;D
L I D F H | L I F D;H
M J K Y T | Y K J M;T
X J L B A | X B J L;A
V I G A L | L A G I;V
U B G D W | D G U W;B
J I G E L | J L E G;I
T N P B Z | B Z N P;T
A B P F Z | P A F B;Z
Q P T V R | T Q V R;P
M X S V A | A S V M;X
A R N E L | R N E A;L
B D V K R | D K R V;B
P G J X V | G J X P;V
N D C R H | D R C N;H
X G H C N | C N H X;G
V O R S X | V O R S;X
K F S H M | S M K F;H
L U Q P O | Q P L U;O
S U H L I | H L S I;U
P Q G M V | G P V M;Q
L U R V C | L R C U;V
U O B A G | U B A O;G
W T G N Q | T Q W N;G
T F X L M | X L M T;F
S G A Y O | S A G O;Y
M X Q G T | Q M G X;T
P Q K L S | K P L S;Q
Y M Q V J | J Q Y M;V
H Q J O T | J O T H;Q
D C A V J | A V J C;D
O U L X F | X F O U;L
U C S R Q | S C U R;Q
W K H P Z | P H K W;Z
D Q T H S | Q H S T;D
N F I W L | I W N L;F
Z I R Y Q | Q Y Z I;R
S A K Z J | Z K S A;J
H L T M B | T M L H;B
W X N C E | X E W C;N
N L V P Y | Y P V L;N
C X G I T | I T X C;G
U N F I J | U N I J;F
I S K Y O | I K Y S;O
Z I S O X | O X S Z;I
V U F S K | V F K U;S
D W A N S | S A D W;N
Y W M H B | H Y W B;M
T A I Y R | I A T R;Y
I B U G V | B U V I;G
N R M J C | R C M J;N
J Z D F A | A Z F J;D
O M T F C | T M F C;O
P V K C N | P V K N;C
V J S F N | F V S N;J
Z P E D U | E Z P U;D
Z Y J I R | I R Z J;Y
K F H G D | H K D F;G
A U E B J | A J B U;E
U W R O L | O U W R;L
O A W Z U | W O U Z;A
D Y I M B | M Y B D;I
Q M Z K H | Z K H Q;M
R C B I P | R C I P;B
U H Z V Q | U Z V H;Q
N V T S O | S V O T;N
X I J Y F | F I X Y;J
Y O I K E | E K I O;Y
K T U J B | J K B U;T
Z V N G Q | V G N Z;Q
Y J C F A | C A J Y;F
Z H W X B | X H B W;Z
Q A F B D | Q B F A;D
C L Y W K | Y C K L;W
T X G A D | X A G T;D
D E F R S | E F S R;D
B A J N E | J B E A;N
Q I C T E | T I E C;Q
K R Q N T | K R Q N;T
A C Y M R | A Y C R;M
A Y K X N | N X K Y;A
F M X Q T | T F X M;Q
C O J L P | C J P L;O
W I E T Q | Q E I W;T
C K V Q B | V Q B C;K
U N O Z G | O N Z G;U
U Q G E J | E G Q J;U
E Q W I H | H I E Q;W
H B O X A | X B H O;A
F Y V D Q | F Y Q D;V
Y T B U P | B T U Y;P
Z B P M G | P G M B;Z
E B G N H | E H N B;G
Y U F W J | Y U J W;F
C W H F E | F C W E;H
Z S U T H | H S Z U;T
V Z H Q T | V Z T H;Q
Z S I X C | X Z C S;I
A D R Z N | R A N Z;D
A K T Z H | H Z A K;T
B Z W V C | V C W Z;B
C U S F E | U S E C;F
M Y G I O | O G I M;Y
M A U Y C | C A U M;Y
Y M K Q J | Q Y M K;J
W V I B Z | B V Z I;W
O Q H F T | F Q H T;O
V A Y Q D | V D Y Q;A
H E O F I | F H O E;I
F D T E R | D T R F;E
T Q G V O | T O Q G;V
O G Y W A | O G A Y;W
L R K W N | R L N K;W
X V I W Y | W Y I V;X
Z D R I V | D I R V;Z
F Z V K I | V I K Z;F
G W D E P | W G P E;D
N F Y X M | Y M X N;F
B C E M Y | C Y B E;M
R W B L X | W R L B;X
Y Q P B H | H Y P Q;B
P O S Z A | P O A S;Z
A I P K W | K A W I;P
D F N C O | C D O N;F
A B T J L | J T L B;A
D Z I W K | I Z D K;W
Y R L C U | L C R U;Y
B W N O Q | B W N O;Q
N K T V B | K N B T;V
M G D W O | O M W D;G
X F L D T | D L X T;F
P V G W H | W V P H;G
Z K N X T | T N K Z;X
C A K X N | C X K N;A
P Y D H R | P D Y H;R
L C E N J | L N E C;J
X K W F C | K C X F;W
R K L U N | K N R L;U
Q F S J V | V F J Q;S
D G I U A | D I U A;G
M Z X R L | X Z L R;M
V A R O X | O R X V;A
Q Y B I P | P Q I Y;B
T B Z P C | B P C Z;T
C G K I O | C I O G;K
E C T B G | B E G T;C
H E B F Y | Y B H E;F
S X P I Z | I P S Z;X
S V A U H | V S A U;H
O D X W V | V D W O;X
X D K U V | D X K V;U
C L Z M E | E Z M C;L
I C O V U | C V I O;U
S E C T F | T E C F;S
K E J P D | P D E K;J
O D R F G | G F O D;R
D G V H X | H X D V;G
A D W Y C | A D C Y;W
Y M C H Q | C Q Y M;H
M H N W A | N A M W;H
S F Q N U | N U S Q;F
B C V S R | B R S V;C
H O Y Z B | B Z Y H;O
X H C S V | H V S C;X
C Q J I M | J M Q C;I
S K V Q I | V S I Q;K
I P L Q A | Q P I A;L
O Z J A Y | J Y O A;Z
A M X S L | X M L S;A
U I M N L | N M I U;L
M X Q V N | M V N Q;X
G F C Z T | G T Z F;C
A K D O C | K O D C;A
W M H Y T | M W T Y;H
H X I E S | E X S H;I
N I L H W | I H W L;N
I R P W Y | W Y I R;P
O N M L X | N M O X;L
I U A X O | X O I A;U
H M B F I | M H I F;B
S D O W M | W D O S;M
M W A N G | W A N G;M
S Y P K J | Y P S J;K
H Z O X U | O H U X;Z
X O S I N | N I O S;X
X V A C O | O C A X;V
A T J Q X | J A T Q;X
A S B W X | S X B W;A
J I Z M A | Z A J I;M
A O W J U | U W A J;O
E M G D B | D G M E;B
B W N I X | W N X B;I
V Z E B S | S B Z V;E
M E F R I | I E F M;R
D N W R X | D W N X;R
L U Z T H | H Z T U;L
M N D A K | A M D N;K
G B H J E | B G E H;J
K S N D M | K M D N;S
Q N C W V | W C Q N;V
L K R O T | R T O L;K
B O C U E | C O U E;B
O D E B G | B E G D;O
J R A O D | R A J O;D
S W L I E | S L E I;W
T A Y S J | A S T J;Y
X L J C P | L C J P;X
F W Q L R | Q W L R;F
N B R X G | N G X B;R
S U X E M | M U S X;E
M L J U T | M T J U;L
J T O F C | T J F O;C
F C A Z O | C Z F O;A
B L M Z Q | M Z B Q;L
R W V A B | W B A V;R
F Q S J W | Q J F W;S
Y O N C P | C Y N P;O
C R M G O | O R M G;C
G Y K V L | K L Y G;V
L H F B Z | B Z H F;L
H K Q X U | H Q U K;X
N M S V E | V E M N;S
D P Q E R | Q R E P;D
M P H C I | I P C H;M
R U X L Z | R X U L;Z
C D T K U | K T D U;C
F S Y W J | F Y S W;J
J G R H Z | J R H G;Z
P L N V J | L P N J;V
X T J F Z | J Z X F;T
E K D J C | K C E J;D
Y P T O C | O T P Y;C
U A V M E | U A V E;M
W Z J P R | J W P R;Z
M D S G O | D M G O;S
T R P X S | P R S X;T
N Y Q R S | Q Y S R;N
W X O M R | W X O R;M
P E D G N | P D N G;E
V P H U E | E V U P;H
D N S P X | X P S D;N
N Z E M D | Z N D M;E
W O B F H | O H B F;W
G E S F K | S K E F;G
Q A N G P | Q P G A;N
R O Q M X | Q O M R;X
N I L Y P | Y I L P;N
D R I L A | D R I L;A
A V S M K | K V A M;S
H V C Z F | Z H C V;F
P S F T D | F S P D;T
U E A I T | A E U I;T
U Z L Y P | P Y U Z;L
E F Y V A | A F E Y;V
G U W D A | U G D A;W
U H J Y P | Y H P U;J
A T R G Z | G Z T A;R
H Y P X W | P Y H X;W
Q V Z B I | Q B I Z;V
E Q A P U | Q E P U;A
A O Z W N | N O A Z;W
G Q I U D | D I G U;Q
F S V G U | G S F V;U
K T Z A D | Z K D A;T
L F W T N | L T F W;N
P Y G I N | Y I N G;P
Q L U R G | R U G Q;L
B F T A L | A L B T;F
S K O M F | O K M F;S
K Z D V Q | D K V Q;Z
A R Z U T | T U R Z;A
K C T L M | C M T K;L
Z B P S H | S H B P;Z
W X J M V | W J X M;V
A O C L B | L C B O;A
J B Z U M | B M U J;Z
I S J P V | J P V S;I
W P A I Y | I A P Y;W
N I D P S | D I S P;N
G J V M P | G V J M;P
V Q M T B | T M B V;Q
Q Z I W M | I Z Q W;M
Q I A P Z | P Z I Q;A
P M A K G | M K G P;A
X I U N A | I U X A;N
L Y H B O | L B H O;Y
L J P E X | E L P J;X
N C R X P | R C N X;P
C G R J N | J R C G;N
O N D I E | I N E D;O
H M K G U | H K U G;M
U J G C F | F C G U;J
V R D X H | D R H V;X
X W P T I | P X W I;T
I L O S W | O S I L;W
K Z Q J T | T K Z Q;J
V Y W F M | M F V Y;W
X O L P Q | Q O X P;L
O N H E K | K O H N;E
V D H P Q | V H P Q;D
K L D Y F | F D L Y;K
B U G O N | U N O B;G
J R E L H | R E J L;H
Y K R Q N | Q R K N;Y
U T N J I | T I J N;U
N L H A C | H A C L;N
D B P G W | P G W B;D
H M Y G K | M H G K;Y
P N E R G | G N P E;R
P E Y X N | X N E Y;P
I R A D B | R B A I;D
G S L Y C | Y S G C;L
Q T J I P | T Q J I;P
M P K G U | P U G M;K
C M V T Y | M Y V C;T
X L P O E | O E P L;X
B V X D H | H X V D;B
H L M B R | L B R H;M
H P C G S | C G P H;S
C B R V Y | V C Y B;R
F S K V L | L V K S;F
L S T P R | S P L R;T
Z C S Y P | Z Y C P;S
O I P K D | K O P I;D
O R E N T | T O N E;R
Y Z V R I | Y Z I R;V
C W O I F | F C W O;I
I Z L B G | G Z L I;B
W R X O A | O R X A;W
T Y K I M | T K I Y;M
J B N M D | J N M B;D
I X Q Z S | Q S Z I;X
J P B R U | J U R B;P
X J L S G | J L G S;X
E F D G R | R G E D;F
G B L Z Q | L B Z G;Q
X B C R Q | X R C B;Q
Z Q P R K | R Z Q P;K
Q J I G M | M Q G J;I
N U C R B | B C U N;R
I E M X C | M E X C;I
X F N J R | F X R J;N
N R S P Q | N S P R;Q
F C W J R | C F J W;R
B M U X Z | U X Z M;B
V O D W L | W D O V;L
X B V J D | D X V B;J
E A M B U | M B E U;A
M F P G K | M G K F;P
H D V F B | B V F H;D
I Y Z X C | C X I Z;Y
G M J B K | G J K B;M
K G Y D B | Y G B D;K
S Y R V U | Y U S V;R
P D F Y C | F C P Y;D
C W Y I H | H C W I;Y
I S R U Z | S I R U;Z
S V I P X | S V I X;P
X V W B I | B W V I;X
Y X B P M | X Y P M;B
D Q Z M O | M O Z D;Q
N G A R E | R A E N;G
N R K E B | E K B R;N
G M W S A | A W S G;M
X J Z Y N | Z Y J N;X
U P Q D J | Q J P D;U
S B R Z A | R S A B;Z
Q I O T K | Q T K I;O
U C M F G | M G C F;U
I Z J R Q | Z I J R;Q
P S Q E L | E P S L;Q
U J H Q R | J Q U H;R
A K U I T | K A U T;I
C P E H O | P O C E;H
D J U T F | J D T F;U
Y I R Q L | L Q I R;Y
U G J A Y | J U Y A;G
L F T E A | A L F T;E
E T X U P | U E T P;X
M C F N G | C F N G;M
Q G T F B | T G F B;Q
N J L R W | L W J R;N
E H Q S K | H S E Q;K
G Q D V X | Q G D V;X
S C N A W | S C N W;A
M H N X A | H A M X;N
J I X L W | L I W J;X
A I T P D | A T D I;P
U E P B X | X P E B;U
F X B E O | O X E F;B
P Y R A S | S A R P;Y
C D A O G | G O C A;D
I Y L F S | L I F S;Y
U O I W Q | O Q U I;W
U K Y Q P | P Y U Q;K
X J C I K | K C X I;J
N I Y F P | F I P N;Y
X B W S H | S B H X;W
Z H W R V | W R H V;Z
M P C A F | P C F A;M
G U J D S | J D G U;S
Q I V D P | D V Q P;I
G B N H S | S N G H;B
H Q Z S X | H X Q S;Z
U A F D S | F U S D;A
N B T X C | B C N T;X
Y S C P A | A S Y C;P
Y S T Q G | T G S Y;Q
D G R I O | I O D R;G
M A R K B | K M A B;R
Z D S G I | D I S Z;G
E D Q O K | K O Q D;E
D V Z N T | V T Z N;D
F Q B M W | M W F Q;B
D P T X J | D T P J;X
X E K A F | X F K E;A
F Z N E K | F K E N;Z
Q O J I P | O I Q J;P
S Z E G B | E B S Z;G
Z M V Y B | Y M Z V;B
R D U S B | S R D B;U
Y W L D Q | Y Q D W;L
X A G K F | X G K F;A
F E A Q U | F U A E;Q
I O C G P | G P C O;I
H P I R W | W R H P;I
J D M A C | M D J C;A
I Z Q T A | T Z I Q;A
R G D Q C | G D Q C;R
O Q C J B | O Q C J;B
H D W P R | H R P W;D
B F I L Y | B Y F I;L
G T J O I | G I O J;T
A G Q Y S | S Y Q A;G
R X W I E | W I R X;E
R Y F Z L | R L F Y;Z
R C Z D S | Z R S D;C
Z R D T O | T O Z R;D
Y B L E Z | E Z Y L;B
T V Q E C | C E V Q;T
W J G X Q | J G Q W;X
B J H I C | J B I H;C
O Q K V N | K Q N V;O
B F L Z A | Z L A F;B
G F M X V | V M G F;X
O I A F Y | O A Y I;F
C G P O L | G L O P;C
N W K M F | F M N K;W
N U K M A | N A K M;U
A W S M F | S W F A;M
Y V W P T | W Y P T;V
S W Q C V | Q C V S;W
X H V K P | V K P H;X
H F S D R | F H S D;R
F W D A T | T F W D;A
R Z G K Q | R G K Z;Q
M Y C A K | M Y A K;C
I O S V H | S V I H;O
U O F I V | O U F I;V
O G P R E | R G O P;E
X E D C P | D P X C;E
X R U M Z | R X M Z;U
C W U H K | U K W H;C
U D C A X | X C D A;U
S A E Z V | E S Z A;V
L D T Y B | D B L Y;T
X U H M B | X H M B;U
A M Z G D | M Z A D;G
N I L B Y | L Y N B;I
O F T Z L | F T O L;Z
Z C X I O | I O Z C;X
E R Y I J | E J Y I;R
M F B N L | L M N B;F
P S X N Q | S P X N;Q
Y H X C T | X Y T H;C
W U C T B | U W T B;C
B T Y K E | K Y T B;E
U O B D X | D B X O;U
T D S M F | F S D T;M
S N O V E | N V O E;S
D G T W U | G W D U;T
B O T Z M | M O B T;Z
I W G C Y | I G Y W;C
C M X U I | U I M C;X
A S J D R | D R A J;S
W G H D B | D G B H;W
Q Y L B I | L Q Y I;B
A L R C X | C A L X;R
X L Q K B | L X B Q;K
P T D X U | P D X T;U
O S U C P | U O S P;C
P D E Z X | D Z X E;P
H U C X W | X U H C;W
W Q O R L | Q O W L;R
Z I T H F | H I Z F;T
C I Z D P | D I C Z;P
Z Y S T W | S W Y Z;T
H G E T V | H T V E;G
A O H J R | A O J R;H
Z V I A J | Z J V A;I
U T W I N | U T W N;I
W J V O L | J L W V;O
B N T D A | D A B N;T
L B D Z O | B D L O;Z
M N T U A | M A U N;T
H F Q P X | P F H Q;X
C D S I H | H C D I;S
R K E Y H | K H E R;Y
W S G K L | W K L G;S
P G C J L | G J P C;L
V I F K T | T I F K;V
A T I Y U | A U Y I;T
M Y H C U | C H U M;Y
T O M E G | G E T O;M
T A I J V | T V A J;I
F V C I U | I U F C;V
W I A K N | I W K A;N
Q N Y V G | G V N Y;Q
Q W A Y T | Y T Q W;A
N U R S D | R N U D;S
D A X N W | D A N X;W
B T C W Z | W C T B;Z
C W T O A | T C W A;O
B V U R J | B U J R;V
M J T N O | O M N J;T
Q R N T J | N T Q R;J
X Y C N U | C X U Y;N
X D O B Q | D Q X B;O
T Q A P L | A P Q T;L
M C S H X | H S C X;M
Q T J X L | L T J Q;X
C V R T Z | T Z R C;V
X S Y M T | S M X Y;T
G W Y C Q | Y C Q G;W
V H Q X D | X H D Q;V
S B L Y W | L B W Y;S
C L O A H | L C H A;O
Q R L K O | R L K O;Q
M R D Q T | R D T Q;M
Y N I Z X | I X N Z;Y
V Q K U L | Q V K L;U
R K H P V | K P V R;H
I C K B V | K C I B;V
R J C H L | C R H J;L
C S R J P | S P C R;J
S J K G H | G K J H;S
M R O A D | A M O R;D
K N W E X | X N E K;W
J T Y L W | J T Y L;W
U R N G Y | N U R G;Y
A P B T U | U T A P;B
G M S A R | S R M G;A
T U X F M | F M U X;T
W L G Z F | G W F L;Z
T M K F A | K F M T;A
E R G H C | E R H G;C
G C Q E N | N Q G E;C
C I Q X J | C X J I;Q
N G X Y V | G V N X;Y
I J B E K | B I K J;E
C X M P Z | P C Z X;M
I V H F S | S I V F;H
K Z S T P | S K P Z;T
C Q U P E | Q E U C;P
V I K M Z | M Z I V;K
Y B U D M | D Y M U;B
B E J T P | J E T B;P
X W H N K | H N K X;W
H Z O N I | I N Z O;H
N X C D E | E N C D;X
K M H J W | W K H J;M
K L Q U J | L Q K J;U
G C O P F | O G F C;P
U S W L B | W L B U;S
H R F Z I | F I Z R;H
Z B G T S | S B G T;Z
P K Y J G | G Y P K;J
C D Z N G | C G Z D;N
T P Y S H | T Y S P;H
F Y C I S | Y F C S;I
A T U Z N | A Z T N;U
B S Q D W | B W D Q;S
R M V F K | R M F V;K
F E S R Z | S R E Z;F
L I D Q G | L Q D I;G
T Y J H L | Y T J L;H
P N L V Y | L P N V;Y
C V A I R | A R V I;C
T E B D K | D B T K;E
K P F S Y | F K Y S;P
G S X N T | S X N T;G
R W D M V | D W M V;R
A T V F D | V F A D;T
P T C K Z | K T P C;Z
X J N D L | J X N D;L
Q H D O K | H O Q D;K
P G H K V | G P H K;V
H W G M L | L M W H;G
C L P E T | C L P E;T
M C V D K | K D C M;V
E S I C P | S P C E;I
Y C F R Q | C F R Q;Y
R Y M J G | G Y R M;J
X U S J G | S X G J;U
Q T Y X V | Y V T Q;X
L R E G J | G R J E;L
R F C M O | C M R O;F
Y G U F M | F G M Y;U
U V N K Y | Y K V U;N
D K F V G | G K D F;V
D Q A P Z | Q P Z D;A
D X K C T | K C D X;T
Q L S V Z | S L V Z;Q
V K G A M | M A V K;G
M Y R J A | Y R J A;M
W U L P J | L J U P;W
Z M F I V | Z V I F;M
D W Y O J | Y J D W;O
T D E K H | T K D E;H
Y Q V G T | V G T Y;Q
A E F Z R | Z E R F;A
J Q Z X H | Z Q J H;X
P G R W B | W P B R;G
M C P E V | P M C E;V
C P I V U | C I P U;V
Z X N K O | O Z X K;N
H V W R D | V D R W;H
N G L B Q | G Q N B;L
U L P D O | D O U P;L
O Y Q H R | Y R H O;Q
Z D H C N | Z N H C;D
Q O T P K | K O T P;Q
Y Q G B O | Q G Y B;O
R A W Y J | J A Y R;W
X G C R D | G X C D;R
I U M V A | I M A U;V
G E D F N | E F G D;N
G N Q R B | Q R N B;G
D N V U M | D N U M;V
P O N F Q | P F N Q;O
X V K C Y | V Y X K;C
U J X F D | D U F X;J
I D T P F | F I T P;D
X U M E V | V U X E;M
S B P W N | B S P W;N
F O D C V | D C O V;F
D X S Z V | D X Z S;V
Y S T B V | V Y B T;S
N S T P J | S P T N;J
J S W L O | O J W L;S
G K V W A | V A G K;W
F U L N P | F P U N;L
Q C R D H | R C H D;Q
J A Y K G | A G Y K;J
F B P V K | V B P F;K
C N G D A | D A G C;N
W Z Y U V | Z W Y U;V
C J H I N | H N C I;J
S R H W B | B H R W;S
F V Z I C | C V F I;Z
X O Z B I | Z B O X;I
P V F C L | L P V F;C
U K N J G | N K U G;J
L E R D H | L D E H;R
O W J N Y | Y O J W;N
K H Q N F | F H Q N;K
P C Z K R | R K P C;Z
R H K D Z | R D Z H;K
Z F N K V | F N V K;Z
M J R Y T | R J Y T;M
U O J Q D | Q J U D;O
O C M D R | O C R D;M
E N W X D | E X W N;D
E F J X P | J E F X;P
O N E W X | N E X W;O
E B G T J | G B E J;T
Z G D Y X | Z X Y D;G
O Z X W K | X Z W K;O
E J P X O | J X E O;P
B V U T M | U T M B;V
Y F U E I | Y I E U;F
Q T A H Y | Y Q H A;T
K Y W R X | Y K R W;X
R W D G P | D W R G;P
H U V O G | V G H U;O
S X A R L | X S L A;R
I N L U R | L U I N;R
O Y C Z H | C Y O H;Z
F D C U W | F D W C;U
F J S X L | F X S L;J
K H F V N | K F H V;N
R S E A Z | A E Z S;R
B D J T C | D J T C;B
T V Z Y C | Z Y V T;C
U F S O I | O U I S;F
W N D X O | N O D X;W
L U T X Q | X T L U;Q
Z O M P K | O M P K;Z
S D B W G | W G D B;S
E I H T N | N T H I;E
S N F R P | F R P S;N
T X W E P | E P T W;X
D M R X F | F D M R;X
H P W L Q | P Q H W;L
J T K E H | J T H K;E
Z R D N J | J D Z R;N
J A X P Y | X A P J;Y
S J U R G | S U R J;G
W V B G F | F W B G;V
G Z B P K | B G Z P;K
C A Y I D | A Y C D;I
K U P J E | E K P J;U
J H Q L C | J L C Q;H
C A K T V | C K A T;V
B T M O N | N M B T;O
B C E G M | C M B G;E
G V O T S | V T G S;O
X L I T M | T M X L;I
Z O H S A | S H Z O;A
W K J S F | F K J S;W
N M G B U | U G N M;B
F I A C R | A I C R;F
A V R L P | V A L R;P
W F D H J | H J F D;W
O D H K A | K H A O;D
Q U A E R | U E R A;Q
X I T S G | G I T X;S
N R H S V | R V H N;S
R P W U B | B P U R;W
F L S U X | F X U S;L
K W D O B | B O D W;K
U V H E C | V C E H;U
J Y D B H | H J Y D;B
Q R Y N F | F R Q Y;N
F N Q W S | F N W Q;S
T E Y A Q | Q E A T;Y
G I C X J | G J C X;I
K N R B D | B K D R;N
P O L T H | P O H T;L
C Y N F U | F Y U N;C
G R U W C | W C G U;R
Y K H M A | M K Y H;A
C B R D O | O R B D;C
M K Q I V | I V M K;Q
W F S Y P | P S F W;Y
N X D K Y | K Y N D;X
W G Y J S | G W Y S;J
Q O N P A | A N P O;Q
M Z Q G L | Z L Q M;G
C A G V U | A U G C;V
W X Z R B | R B X Z;W
K S R B G | B R K G;S
V B J S U | S U B V;J
V I C U Q | V C I U;Q
E P Z A J | P A E Z;J
N I V Y A | Y N A I;V
V X Y K L | V L X K;Y
Y N K M G | N G M Y;K
D T I Y V | T V I D;Y
F Q P K N | Q K N P;F
V G X K H | G H V X;K
S B K P U | U B P K;S
C Q U E P | E Q U C;P
R L J M S | M S R J;L
M W I D T | I D T W;M
F P O M R | P R F M;O
E K J R C | E R K J;C
Z N M T C | Z M C T;N
R U J T C | J T R U;C
T V X U W | U X T W;V
Y X R B K | B Y X K;R
M O Z W X | X Z M O;W
R Z Y T J | R J T Y;Z
Q O T C H | H Q O T;C
R S H T Z | Z H S R;T
T K H O F | F H O K;T
H U O W I | U O W H;I
V N Z E S | S N E Z;V
A Y U W K | Y U K A;W
K B J Z G | J K Z G;B
M F J B T | J M T F;B
T J Z Q R | Z T R J;Q
Z T Q S F | S Z T Q;F
N F B L C | C L B F;N
P U G I N | N I U P;G
P Y X W S | P S Y W;X
B P T R L | P T L B;R
D P I B G | B I G P;D
O T I H S | H S I O;T
Q U E A N | Q N U E;A
Z L H M R | M L H R;Z
A N K Z W | W K Z A;N
O M K C U | C K U O;M
P R Y F W | P R F Y;W
O G S V L | L O S V;G
S T M P U | M S P U;T
D S W A V | S V W A;D
Y W E O P | P E W O;Y
U Z J A C | J C U A;Z
U E O Z K | U E Z O;K
W R Z U F | Z U W R;F
U I R N T | U T N R;I
Y B F H C | C H F B;Y
K O I T D | T O I D;K
Z Q S C P | Z C Q S;P
J B E D T | J D E B;T
M Y A N Q | M A Y Q;N
F E C M X | C F M E;X
S H I J C | S C H I;J
T P E N I | N T P E;I
L N M Z K | K M L N;Z
T E G M S | T M G E;S
R M B C L | B C R L;M
A F W S N | A S N F;W
D Y A J X | J D A Y;X
S O N R H | O R S N;H
R E T Q K | Q E R T;K
F T A R D | A T D R;F
U T J Y L | J L Y T;U
Q D I T M | D M T Q;I
K F O U W | U W K F;O
I U H W D | W H D U;I
X L Q T U | Q T U L;X
Z Y H I G | I G Y Z;H
U O L X P | X O P U;L
J D N X K | D K J N;X
X Q W B Y | X Q W B;Y
I Z X Q K | I X K Z;Q
H U N A J | N A H U;J
A E O D W | A O D W;E
H U Y E P | U H P Y;E
K W E J P | J W E P;K
V G H T R | V T H G;R
R G J K I | J I K G;R
W Z B X K | K Z X B;W
X T Q B Y | X B Q T;Y
O Y H G B | G B H Y;O
B L U G V | V U L B;G
O K F C U | O F C U;K
O P Y X C | O Y P X;C
J C B A H | J B H A;C
N K Q O M | O N K Q;M
Y D V G T | V G T Y;D
L M Q W E | M W L Q;E
G U C M F | M F C G;U
T D H A N | H D N A;T
F T X C G | C F G T;X
Q I M E H | E Q H M;I
A H J G Y | H Y A J;G
X H M L Y | Y M H L;X
M E O K S | S M E K;O
C U Z I T | Z C T I;U
T R V C D | T C R D;V
M O A P Y | O Y P M;A
V I S Q L | S Q L V;I
H T Z W M | M Z H W;T
X S B Y K | B S Y X;K
F J P C A | F J A C;P
M Y I W H | H W I M;Y
Y O I V K | K I Y V;O
A L J W Y | J W Y L;A
J A C B Y | C B J A;Y
Z S X N V | N X Z V;S
N C S U A | C N U S;A
D X P E M | M E P X;D
T V P L K | L P K T;V
S D R U N | N U D S;R
A H R Y W | A H R W;Y
A O F Q I | A I O Q;F
D E V J I | V J I D;E
M B S K A | K B M S;A
T N Z H V | H V T N;Z
Q L C O K | C O K L;Q
C F A S W | W S C A;F
F K I G X | I X F K;G
J Z N K A | N J A Z;K
E U I T M | E M I T;U
E W Q R X | E X Q W;R
A L Q B X | X B Q L;A
Q C B Y F | C Q B F;Y
Z P T E F | E T F P;Z
K V F Q A | Q A F V;K
P J K E R | E P J K;R
Q Z G F K | G K Z F;Q
A U M J C | U J C A;M
Y E D S K | Y E S D;K
D Z A S G | A D Z G;S
Y K X J T | K T X J;Y
J S Q F U | J S F Q;U
O E R K A | E K O A;R
X I J Z L | L X J I;Z
U I T S H | H U S T;I
M V B E N | V B N E;M
G X H M L | X M L G;H
I H T Q Z | Z I H T;Q
A S K D W | S K W D;A
J E H N X | E N J X;H
D N I G X | X I D N;G
M B V R F | V F M R;B
J X V M A | X M A V;J
X T Y Z S | T Z Y X;S
K O S A U | A K S O;U
O L I U M | L M O U;I
U X F P N | P F N U;X
I R Q S K | Q I R K;S
Z U B M X | U M B X;Z
P R Z K B | Z R P K;B
N I F A R | I N R A;F
S P U Z F | F P S Z;U
W K R X N | K X R N;W
Q L D F O | D F L O;Q
F N S G U | F G N S;U
I Z E N U | E N I Z;U
X T G P R | G P T X;R
C F L E K | F E K C;L
W V P A C | A W V P;C
F M A I Q | Q I F A;M
E W X L O | W X L E;O
Y L E M A | M L E Y;A
P L A U K | K U P A;L
P Y S L F | L S P Y;F
E W P K A | W E A P;K
Y J X W L | J L W X;Y
O X W A F | O A F X;W
M Q D H F | H Q M D;F
M E J L W | E W J L;M
V G Q U L | U L G V;Q
H U Q J A | J H A Q;U
Y J W L A | W J A L;Y
Q A G J E | G E Q J;A
G C Y R T | Y G T R;C
D I C R Q | D I R C;Q
D T Q A V | V D Q T;A
C U H P Q | P C U Q;H
E L R F N | F E R N;L
Q D S O K | K S Q O;D
O U W E H | E W H O;U
O G Z W F | F G W Z;O
D V J G X | J V X D;G
E C S N L | S C L N;E
K R V S J | J R V S;K
V U O L X | O U L V;X
U D A I M | I U M D;A
U W L Y S | W Y S U;L
H U M Q C | U Q H C;M
I X C U Q | Q C X U;I
H D K N Z | K D N Z;H
O K V G X | K X V G;O
T Z V H M | Z T M H;V
R K V P I | P I R K;V
H K A T O | K A H O;T
Q F T C U | Q U F C;T
P I K U R | U P I R;K
R I Q A S | I S A R;Q
S F Y M I | S I M F;Y
Q V G O M | M O Q V;G
N R V C E | C E V R;N
T E W Z Y | Z W T E;Y
E I W O S | E O S I;W
E D P J S | D S J E;P
Z O A U B | A U Z B;O
T V Y M U | T Y U V;M
A K G E U | U G K E;A
S N L D Q | Q D N L;S
L P O B X | O L P X;B
A W O N B | O B N W;A
Z K G Q T | G Q T K;Z
F N H S L | S N H F;L
G C R F B | G R F B;C
P O L J S | P S L O;J
S D I B C | S B C D;I
F K E B P | E K F B;P
V Z X O E | Z X E V;O
O B U D S | S D B U;O
I E Y T U | U I E T;Y
N I B R A | N I A B;R
Q F E J X | E X Q J;F
S U Z Q F | U F Z S;Q
W Z H E S | H Z E S;W
K A W D R | D K R A;W
M S Q I G | S Q G M;I
U Q D C Z | C Z U Q;D
E O U S A | U E A O;S
X B I Q G | G Q I X;B
R C T F U | R U F T;C
C X K T F | X T F K;C
P M C T D | C M P D;T
F Q C V E | F C V Q;E
Y F P E M | F Y P E;M
F R W D J | J R F W;D
G N Y K W | W K Y N;G
K Y N O A | N A Y K;O
D M Z U K | Z K M D;U
S P A D B | D A S B;P
E B K Q F | E B Q K;F
Q V K A P | A V Q K;P
D B J R X | X B J R;D
G T L M H | L H M G;T
M Y O U R | M O Y R;U
Z R I G U | U R Z I;G
Z G L C F | C Z F G;L
Q D R F S | D F Q R;S
E M T J D | J D M T;E
Y X M T F | F M Y T;X
X W J E I | E W J X;I
K Q X J D | X Q K J;D
E D M Y L | Y L M D;E
L J D F N | L F J N;D
G Y N X W | X G N Y;W
K S L U H | S K H L;U
L O H A T | A H O T;L
X S C F O | X S C F;O
C N R L A | R L N A;C
E A G Z R | E R Z A;G
Q W Y R H | W R H Q;Y
A N I E Q | N I Q E;A
M E R J Q | R M E Q;J
S V X E W | V X W E;S
I M Y E A | I A M E;Y
C W B S N | S W C B;N
H Q N M P | Q P H M;N
V R D A B | V A D B;R
Y Z M O L | Y O L M;Z
P K H E T | H P E K;T
Y Z G D T | Z D G T;Y
S P O X T | O P S X;T
L M C U X | C L U M;X
L Z D I V | V Z I D;L
U E J D H | E D H U;J
F K V T U | F K V U;T
Y G L Z B | B Z L G;Y
L G B Z J | Z B J G;L
J Q A B E | Q E A J;B
L H Z J E | E L Z J;H
D U V Y J | Y V J U;D
U M I W D | W M I D;U
D C Q X U | Q C D X;U
P R W I U | W I R U;P
A Y F S Q | F Y A Q;S
R A L X C | L R C A;X
J L P G S | L J G S;P
U J D A C | D C A U;J
A I B X O | I X O B;A
R S H G I | S R H I;G
U R Z Y X | Z Y X R;U
O H E T X | O E H X;T
S W H Z K | W Z S H;K
K T Q Y C | K C T Y;Q
C T D V S | S C V D;T
D H Z R A | R Z A H;D
U M K I A | A M K I;U
B X G P C | P C X B;G
Y N O D I | Y O D N;I
J G K Q Y | Q K Y G;J
Y F O C A | O C A Y;F
G W Z X N | Z N G W;X
O V H Y D | V O D Y;H
E A Y S C | C E Y S;A
M V L K Q | Q L K M;V
G W I U R | U W I R;G
E L Q D P | E L P Q;D
P L F X J | X P L F;J
N L J Q T | T N J L;Q
W D C J O | D C W O;J
X K A V N | A K N V;X
N Z D B V | B Z V D;N
C P E L I | E L I P;C
D C Q G N | N D Q G;C
W I A O K | A K W O;I
B N Z X E | B N E Z;X
F Z N P U | P Z F N;U
A C K B Y | A C B K;Y
D C B X Y | X B D Y;C
Q Y Z T V | Z Y Q V;T
Z U L X B | X Z B U;L
H U R X K | K H R U;X
Y P U B A | Y P A B;U
C F A G D | D G F C;A
D V N F T | F D V T;N
P F K X S | X S F P;K
A B N P L | N A P L;B
J X H R Y | H R X Y;J
R K U N V | K V R U;N
J C Z U K | J Z C U;K
B Y T D N | B T D Y;N
M W X G H | X G H W;M
G S C F Y | G F C S;Y
W X C L P | L C X P;W
L T W A U | T L A U;W
S J R W P | S W P J;R
B N J V X | N J X B;V
K O Q F N | Q O F K;N
G Y J A C | C Y J A;G
G V E M A | E V A M;G
U J V Z S | U J Z S;V
N Q G O F | N F G Q;O
M T Y W S | T Y M S;W
U S M K Y | U M K S;Y
L J M G Y | G L M J;Y
Z S P W E | P E W S;Z
J T C X B | B C T J;X
H T K Q Y | K Y Q H;T
B D V W P | V P D B;W
H X U M C | X U C H;M
R K Z C F | C R F K;Z
J G Q I C | Q J G I;C
E K I O T | O I E T;K
L D G P F | L P G D;F
C O R E Z | E Z R O;C
B M H I X | X I M H;B
T E G F B | T F G B;E
F E T X H | F X H T;E
R X T H D | R T X H;D
R V N D M | R D M V;N
M S H I D | D H I M;S
W V S E Z | S W V Z;E
T B V R U | B T V R;U
Z O F Y U | Y U Z O;F
X I W Q D | D X W Q;I
L D N A B | D A B L;N
Z S T O W | S T Z W;O
F N W L X | F W L X;N
L N B Z W | L B Z W;N
A J N Z I | I N J A;Z
A L T U S | A L U S;T
I D F O Y | I Y F D;O
F Q I L W | W F Q I;L
Q G Z M F | Z M F Q;G
U K N G D | K D G U;N
J M U T E | T U E J;M
T P W C H | H W T P;C
Z P B T U | B U P Z;T
O N A Y P | O A Y P;N
S X Y R F | Y F R S;X
H K E I S | S H I E;K
D A O P H | P D H O;A
D P Z H M | Z P M D;H
Y I Z B R | Z Y I B;R
K N W X E | N W E X;K
D A H R K | H A R D;K
H Y I A L | L H I Y;A
O P G H E | H G O P;E
L I K Z M | K M Z I;L
K G X W P | X P W K;G
Z C T O R | C Z R O;T
B R I Y W | Y R B W;I
H A R S V | H R S A;V
Y J A L E | A E Y J;L
Z G X V S | G X S Z;V
J Z S Q R | R S Z J;Q
V T P X N | N T V X;P
K Y R F P | F K R Y;P
L H Y G W | Y W G L;H
P W H A J | A H W J;P
J E Q U V | E J Q U;V
S B U Q G | U G Q B;S
V P H J O | P V H O;J
B D C U Y | C U Y D;B
L R I N B | L R N I;B
O M E Z J | M Z O J;E
L K R H F | F L K H;R
G N U Z C | G C U Z;N
Q H F T X | F T H Q;X
P J O B R | B R P J;O
V Y D E I | D E V Y;I
A X C F B | X C F A;B
D J T O X | O X J T;D
O V Q R J | Q V O R;J
E X K R G | K R E G;X
H I T Q P | H T P Q;I
E K V J X | V K X E;J
U X D R C | R C D U;X
N I D M Z | I Z N D;M
F H P Z I | F I H P;Z
U X V I G | G X U V;I
T M G N E | T E G N;M
L X I J F | J F I L;X
H E Y G B | H B E G;Y
H D V F A | D A V H;F
W Q F O U | Q O F U;W
D O T B H | O B H D;T
B G P D V | G B V D;P
Y R S W I | S R W I;Y
L B R S P | B R P L;S
Q O B D I | O B Q I;D
M Z O G F | M G O Z;F
B V H M K | H K M B;V
C V J Z G | C Z V J;G
D J M U E | J U E M;D
A S K J H | H A K J;S
T O Z V G | T O V Z;G
E X K Q Z | Q E Z K;X
O G N D Y | Y N G O;D
Q Z N R X | Z X N Q;R
N R D Q C | D C N Q;R
E D I V S | I S E D;V
M A D Y V | M Y V A;D
V X L R E | L X V R;E
P I X B U | B I P X;U
Y E S N T | E N Y T;S
N W E V A | V N E W;A
H V I Q O | Q H I V;O
U I Y G X | X G U Y;I
X S V C E | V S E C;X
I U Q L X | U Q I L;X
X I T N U | U X I T;N
O P K N G | O N G K;P
T E R P L | T R E P;L
F J C G E | F G J C;E
K R G C O | C K R O;G
F U M C G | C G F U;M
C Z X W K | Z C W K;X
K Q O N D | K Q D O;N
X H Y A G | G H A X;Y
D W B K I | I W K D;B
A H I D T | A T I H;D
Z E M F S | M E S Z;F
G T U S C | S G T U;C
E Q S O L | E O Q S;L
S E N V J | J S N V;E
N B J E W | E B W J;N
Q U Y R P | P Q Y R;U
W P N X Y | W P X Y;N
G W F X D | D W X F;G
E R W B N | E R W B;N
J Z G F L | F L Z G;J
H Q D Z W | Z Q H W;D
V R Y P H | Y V P H;R
N V Z I S | I Z V S;N
M S X H I | X M S I;H
G J U P H | U P G H;J
F W S X O | O X S W;F
X B Z D E | X B D E;Z
H O T W P | W P T O;H
U N R Q P | P R N Q;U
D Y L X B | X B L D;Y
J A X T F | A X F J;T
U G E L V | G U E V;L
C Y P Q V | V P C Y;Q
C V O M N | N M O V;C
C T E M F | M C F T;E
U G B E V | V U B E;G
B V Z F Q | B F V Q;Z
Z U X I L | U X Z L;I
V F O T B | B T F O;V
G Z N D V | G Z V N;D
Q D I X K | X D Q K;I
U S K O C | C U O S;K
C O M Y F | O M F Y;C
B P I R W | B I P R;W
K I G R L | L R I K;G
E S Z R D | D S E R;Z
G R T W N | N T R G;W
A G N U V | N V A G;U
N S X R A | S X N A;R
W V D F B | B D W F;V
N U J I A | A N U J;I
N G I F Z | N I Z G;F
X M A F Z | F M A Z;X
H I E D L | D E L H;I
L Y B P A | B L Y A;P
P Z I S B | Z I S P;B
A I D M W | W M A I;D
O T W K P | T W O K;P
B V M L H | M V L H;B
L Q Z S O | S Q O Z;L
I K R Z F | I F R K;Z
C B P H S | P S C H;B
W X M D I | I M W D;X
V P W K S | S K W V;P
U J E T I | I T U J;E
I D V A R | V A D I;R
E Q F O Y | O Q F Y;E
G L J I C | I G L C;J
R M G N D | R N D G;M
D A N L V | N L D V;A
O F R B E | O R F B;E
Q K L V S | V K S L;Q
H V M Z W | W V M Z;H
Y G I Q X | Y G Q X;I
D H F W E | E D F W;H
Z I G N M | G Z I M;N
S Z K D V | Z K V S;D
C X Z J I | C J I X;Z
R Y J O X | J O R Y;X
V U N A T | A V N U;T
P Y V M X | M Y V P;X
H Z O B S | Z H S O;B
J D O Q H | D O H Q;J
M G A T Z | Z A M T;G
A K X S J | J A K S;X
R V I L K | V L I K;R
E Q V F P | E P Q V;F
V B I Z S | Z I B S;V
M P V D J | P D M V;J
N F V Y Z | F Y V N;Z
R B N C L | C L B N;R
A H C N I | N A H C;I
O W U C L | O C U W;L
Q M R K D | K Q D R;M
V L R J C | J C L R;V
V Y S U Q | U V Q S;Y
V E R S J | E V S R;J
L Q A F K | Q K F A;L
G O C Q N | G O N Q;C
K X P I T | P X I T;K
G S K M D | K D S M;G
R N A H V | V N A H;R
S U Q T H | H S Q U;T
C J A V D | A J V C;D
F E S D N | S N F D;E
B M L X S | X M S B;L
W Q K N G | W G Q N;K
S H T J B | H J S T;B
R S W V J | J V S W;R
G B K R T | R B T G;K
J M O C S | O S C M;J
G C S L E | C G S E;L
D H P I R | R P D H;I
F T C B Y | B C F T;Y
X D Y A N | A Y N D;X
R K D E V | K D E V;R
G D Z I S | G I D Z;S
G F D K B | K D F G;B
F R Q K P | R F P Q;K
Y T I N Q | T I N Q;Y
X F P V Y | P V F Y;X
J L Y P S | P S L Y;J
K B N V T | N K B V;T
M K B L I | M K I L;B
O U X P Q | Q P X O;U
Y J B R P | J P R B;Y
X Y I Q O | Y O X I;Q
J E K H X | E X J K;H
K W E X J | E W X J;K
P S W A V | V P A W;S
U D G B K | B U K D;G
U L V F R | U L R F;V
H I N S P | H I N S;P
J I O B H | B H O J;I
Q M K P J | M K P J;Q
A X I Q S | A X Q S;I
P W Y G D | D Y P W;G
J A L B F | J F L B;A
K Q R P H | R Q H P;K
C W Q I V | W I Q C;V
X J F U Q | X F J U;Q
B V R G F | V F R G;B
R I A Z C | Z C I R;A
R U A D V | U R D V;A
C Z L K D | Z L C D;K
B M J C N | N C B J;M
S L P X B | B X P L;S
E I C Z Q | I E Q C;Z
L V T C U | V C T L;U
Q V T L Z | V L Z T;Q
U D P R W | R U W D;P
S N X V R | S V R N;X
Q B L M H | B L M Q;H
X W C Q H | C W H Q;X
I P G R S | S R P G;I
I Y O Q F | I Q O Y;F
V F O L K | V F K L;O
A K I J N | K J N A;I
U F M V R | R M V U;F
Z V E X H | H E Z V;X
W N L F E | N E F L;W
L O G I U | O I U L;G
I Y X C L | C X I L;Y
B P K O X | X K B O;P
O N E Y S | O S N Y;E
F Q A E X | Q A F X;E
Z B Q A K | Q A K Z;B
B N X J S | B J S N;X
Y S L G H | G S L H;Y
Q J Y H I | J I Q Y;H
D Y S P X | Y X P S;D
U R H F M | R H F M;U
Z L J H A | A J L Z;H
H R N X T | T R X N;H
H E T X O | X O T H;E
K P Q A H | K Q H A;P
F O R Z L | L Z O R;F
R N Z D L | Z N L R;D
Y T U R J | Y T U R;J
C X Q B J | X Q B C;J
O B I X E | E O X I;B
U E A Z T | A T U Z;E
L N U B T | L T B U;N
Y I Q E O | Y O I Q;E
L O R Z V | O L R V;Z
F S O Q R | O Q F S;R
K Q T U R | K U R Q;T
M O X A C | C O A X;M
B A M G C | B C G M;A
B X C T E | X B T E;C
N E B Y G | E G B N;Y
O W H Z F | W H Z F;O
Y F D P N | D Y F N;P
L J H F P | H J F P;L
F C V Q S | C S Q F;V
Z K I O X | K X O Z;I
B H X U Y | U X B Y;H
E F B C J | C J F E;B
U O J L V | O U L J;V
R M O Y S | M Y S O;R
B P S I Y | P B Y S;I
U C W B L | U L B C;W
C E P G M | P M C E;G
F N I A C | F I C N;A
Z L Q K Y | K Z L Q;Y
K P A L U | P L U A;K
U Z Q Y M | Y Q U M;Z
U I G S R | S R I U;G
D M J A X | J X M A;D
C K J N Y | K J N Y;C
Z E M U N | N Z E M;U
Y T S N W | W Y T S;N
A C G I P | A C G P;I
X R G L D | R X D G;L
C P F K U | C F U K;P
I Q F M E | M I Q F;E
J O R K G | R G K O;J
Y X E L M | X Y L M;E
I R O M F | R M F O;I
T H O P Z | P Z T O;H
C O J U F | J C O U;F
P C H D M | P M C H;D
Y U J O Z | U J Y O;Z
X E B G T | E T X B;G
R G D S V | D G S V;R
V M S W Y | W S Y V;M
T D J K Z | Z J D T;K
Y S U T X | U T X S;Y
I L E K G | I L K E;G
U A W S M | S M U A;W
Q U F K Z | Z U K F;Q
G N E F A | A F N G;E
B J R E F | R B E F;J
G N R U Q | U Q N G;R
P A Y H O | H P O Y;A
H T Q N I | N T Q I;H
Y A T V Q | Q Y T A;V
Y R I N U | Y R U I;N
L Q J U R | R U Q L;J
B A F Z T | A F T B;Z
K L T S I | S L T I;K
W I S V E | S E W V;I
F L X U W | X U L F;W
F C Q T L | T L C Q;F
J L S T O | O L S J;T
E W M S V | V M E W;S
V Z Q U T | Q T V Z;U
D Q T A C | T C D A;Q
S T B A C | S B C A;T
U Z L P T | T Z U L;P
J B O D H | J D B H;O
L Q C J Y | Y C L Q;J
N L K X Y | L Y X N;K
E G L R Y | Y E R L;G
X H I E M | E M I X;H
O M V B K | M K O V;B
P Y M S D | S P M D;Y
E G L A S | E A L G;S
H L Y B Q | Q L Y B;H
S B F T V | V F B S;T
V B M T G | M G B T;V
X Y U A V | X U A Y;V
J W A E X | J A E X;W
B K H Q Y | B Y H K;Q
X C W D T | C T X D;W
C L N U R | R C N L;U
J O H S K | H O S K;J
J P Q B C | J Q C B;P
G S F Q H | F G S Q;H
B E N C D | E N D C;B
T I E M A | T A M E;I
M N P A L | M P N A;L
U G Z K R | G U Z R;K
Z U V S I | S V U I;Z
W H F G E | H F W E;G
C R L G E | L E R C;G
L F U N R | N U L R;F
O U P J H | H P U O;J
F U Z K G | Z G F U;K
U W T J Y | J T W Y;U
I G N Q Z | G Q Z N;I
F K H Y O | O H K F;Y
N M E H Z | E M N H;Z
M N E B K | M E N K;B
I Y U B P | I B U P;Y
T Y G C D | Y T G C;D
X C F Q R | R C Q F;X
B G Q L J | J B L Q;G
Z F C N G | G F C N;Z
Z Q D U G | Z U G D;Q
R X H Y D | R X D H;Y
N T A U Q | N T Q U;A
G A O R H | H R O A;G
K J R Y E | E R Y K;J
J F K Z G | J G K F;Z
P O X Z L | L X P Z;O
N R A Z I | A I R Z;N
I Y T P U | T Y I U;P
I L N U Z | Z U L I;N
I B T D K | I D K T;B
E J H R Q | Q H E J;R
G N S Z I | I S Z N;G
K T Q J F | F J T Q;K
U X I Y Z | U Z X Y;I
K S P E U | U E S P;K
E J X S A | S X E J;A
J T C G M | M J T C;G
O C L U Y | Y L O C;U
U Y Z A W | Y U Z A;W
X U Y Q M | X Y U Q;M
D F R I S | D I S R;F
K A F J G | J K F G;A
S H D J C | S H J C;D
U N I F L | F I L U;N
Y S I D X | S D I X;Y
A P Y G H | G H A P;Y
D N W F B | N W D B;F
R Y O B U | R B Y O;U
J H K E P | H J E P;K
X O Y B M | B O X M;Y
G J W B C | J G C B;W
R H K X D | K R X D;H
Q A N K D | D N A K;Q
S O T Q U | O T U Q;S
B R V K P | B K R V;P
P N A J I | I A J N;P
R Y P S Q | P R S Q;Y
J I L R S | J I L S;R
K I V D X | K V I D;X
O L P S U | S U L P;O
P U F X Y | U X F P;Y
G Q C U X | Q X C U;G
L Y Q U B | L Y U B;Q
T R S A W | W T R A;S
N K M F U | U F N K;M
C S V Q I | S Q C I;V
M T F J D | T M F J;D
D F H V J | J V D F;H
S W P Y N | W P N Y;S
L Y M U O | U Y L M;O
P H O Z W | W Z O P;H
K W T G P | P K T G;W
G T V A Q | A V Q T;G
W Y C H K | H C W K;Y
K U W O E | E U O W;K
F V T W B | F W V B;T
T I S U C | S U T I;C
L P W Y X | L Y W X;P
G N F D S | S D F G;N
X Y R F D | X R Y D;F
J T P Y V | J T V Y;P
P Q G A B | Q P G B;A
K B O M D | K M O D;B
C M B Z U | C B Z U;M
D E N G I | G D I N;E
F E T K M | M F K E;T
E Q M K W | Q E M K;W
C P O N A | C N P O;A
A E B M S | A M S B;E
R O C Q D | O C Q D;R
Y Z V A L | Z A V Y;L
D L H U Q | H L D Q;U
I K O E S | I S O K;E
Y C V X N | X Y N C;V
D I B V N | I D B V;N
W N V T O | V N T W;O
U Z C Q Y | U C Z Y;Q
B L Q A G | Q B A G;L
O N H E T | N H E T;O
O I G J S | G I S O;J
M C Q F V | V C F M;Q
Z S F Y T | T S Z Y;F
X O V U T | V O X T;U
R E L Q O | L R Q O;E
W I F L Z | W L I Z;F
N A X W C | A N X W;C
H U G B O | B G H O;U
E F K U H | F E U H;K
X R C N K | X N K C;R
L S V A O | O V L A;S
D X I S G | G D I X;S
O W N D A | W D O A;N
I C K U J | K J C I;U
B H Y V A | B V A H;Y
I U N Z Q | I N Z Q;U
S N J Q P | S N P J;Q
N O Y E H | E H O Y;N
V U I S Y | Y S U I;V
Q X B K U | X Q U K;B
I E L W G | W I L G;E
V O X G M | G X M V;O
L W U O C | U W L O;C
K O D C B | K D B C;O
P I Q A G | A Q I P;G
C F G X M | C M X F;G
F I A S E | A I E F;S
C E N P G | G E C P;N
T Y N S E | S E T N;Y
C O Q I B | I Q B O;C
U G P Z I | I Z P U;G
O R T Z M | O Z T R;M
M V Q G S | M Q V S;G
T O M A G | M G T A;O
U T Q P X | T X U Q;P
D I U K S | D K S I;U
E O V W N | O W N V;E
Z M B C D | M C B Z;D
T Q V J N | T V J N;Q
C F N B K | N B K C;F
M N D E W | W E M N;D
R J Z O I | Z R I O;J
O A B H F | O H B F;A
A T C M N | C M A N;T
F Y W V O | F Y O W;V
X O S M F | S X M O;F
S B L H T | S T B L;H
B M C Q K | M C B K;Q
U M P V B | P M U V;B
H X Q U V | V H U X;Q
Z W R J S | R J S Z;W
V M P S Z | V M P Z;S
C U Z W F | U W Z F;C
Y H G I W | I Y H G;W
X R K I Y | K I R X;Y
M Z Q T I | Q T M Z;I
E V G S L | L G S E;V
O F X R P | O F R P;X
T F W A V | A V W F;T
U X Z J V | J U Z V;X
W Q U J B | W Q J U;B
Z T G C I | C Z I T;G
D K U O F | F O K U;D
D E O K Q | K O D Q;E
L F P W D | L W D F;P
N I F V Q | N F Q V;I
E O C M H | E M H O;C
Y G J P K | Y G K P;J
C F X H K | X F K H;C
C A M H K | K C H M;A
F X J U P | J U X P;F
C U O R G | C O G U;R
S W X K Y | Y S X W;K
M A P I Y | Y M I P;A
F E Y Z R | E Y Z R;F
Z P Y V R | Y V R Z;P
N L K S B | L S K B;N
B U L P A | L U A B;P
X B V C N | C V X N;B
U H Y S Z | H Z Y U;S
J T V A Y | T J Y A;V
J C N I V | J N V I;C
K H P N G | K H G N;P
W Y L A K | W L K Y;A
N Y A X E | E X N Y;A
E I H Z O | I E O Z;H
D C X O G | C G D O;X
Q X V L B | V L Q B;X
M X S T H | H X S T;M
R V G T W | G T V W;R
O S J H D | J H D S;O
J M G D L | M D L G;J
D J H L I | H D I J;L
X S Q F J | F S Q J;X
Y T W V R | V R Y T;W
Y J Q D F | D Q F Y;J
R Y M O X | R Y O M;X
U B M S L | B S U L;M
T R M S V | V M R T;S
X C Z F U | Z X C F;U
O D L U T | L U D O;T
P H S K B | K B S H;P
Q R F X N | X Q F N;R
V R X I K | X I K V;R
E N X O B | B E X O;N
H L F I A | H I F A;L
S H Y N U | N U Y S;H
Z E O R W | O E W R;Z
X P N F U | X U N F;P
K C H F D | K D H C;F
T R S Y O | T Y S R;O
M E S A C | C S E M;A
T A B W R | R W A B;T
E F W G S | S F W G;E
Z B A Y M | Y Z B A;M
B T L I W | T L W B;I
T G S W D | G D W S;T
I G X W H | G W I X;H
V B D H Q | V B D Q;H
K T C Z G | Z T G K;C
H J K R B | H J K R;B
H G J Q F | G Q H F;J
G F P E B | G F P E;B
L G C T Z | G T C Z;L
F W M L C | F L W M;C
Y D V T G | V D Y G;T
R G O T J | J G T O;R
X L N P R | L X N P;R
F L Q A T | F L Q T;A
L C U D Z | Z U L C;D
N T S C O | T S N C;O
V D M O H | M H D O;V
H A F S T | A H S T;F
H K C S U | K U H S;C
D G B S J | B G D S;J
P Q F K D | D F K P;Q
R Y T J M | M R Y T;J
U D G R X | D X G U;R
B D V A Q | Q D V B;A
M K P O T | O K M P;T
B Q W Z X | X Z Q W;B
A V W L X | A V X L;W
F K Y V M | V M F K;Y
N Q C A D | C A D Q;N
Y N D Z L | Y L D N;Z
U J K P L | U K J L;P
Y G W B J | Y W G B;J
V S J F N | S N J F;V
E Y R D Q | Y Q D E;R
J Y W T K | W T J Y;K
B W H A R | B H W R;A
V P T Q L | V P T L;Q
X J V Y T | Y X V J;T
S U I W B | U S I B;W
Y U T K X | K U X Y;T
D Q U N X | X D U N;Q
W X R E Z | E W R X;Z
M G O H S | H S G O;M
F C Z M P | P C Z M;F
G R H B O | O B H G;R
W O T J U | U O T J;W
H K B G J | K G J H;B
B M X G L | X B L G;M
K M R A Z | A M Z K;R
T F A B V | V F A B;T
I O X D K | D X K O;I
Z H E Q F | Q E H F;Z
G M J S I | J I S G;M
V B R F C | C R F V;B
R N V J I | V R N J;I
P M I S U | M U I P;S
Z C V A X | C A Z V;X
C Y J P V | P J V C;Y
L B S H Q | S Q L H;B
E W F D G | W D F G;E
Z Q B T Y | Z T Q B;Y
V K J M O | V K J M;O
P Z X G C | X P Z G;C
M H L F D | L M D H;F
L S U B G | G L S B;U
B C K U S | K S C B;U
C G S Z L | Z C L G;S
V G D T Z | Z V G T;D
G Z Q O R | Q Z R O;G
A U S G R | A R U G;S
G P B Y V | V B Y P;G
I Q N L R | N Q L R;I
L F K P U | F P K L;U
D S G U R | G D R U;S
A V W E O | V O W A;E
M E A P H | M P A H;E
L I M D B | I L D M;B
M G H D K | D H G K;M
Q W M G P | P M W Q;G
Z E D M O | O Z D M;E
T X W H C | H W X T;C
K Z H J F | K H J Z;F
H J T C A | H A T C;J
H F I A E | I A H F;E
M B E R A | A E M R;B
Y R J C M | M C Y J;R
T R W H S | S H T W;R
Y J H T L | Y T H L;J
Z F C O A | F O A Z;C
O L U I E | I O L U;E
A E D M G | M A D E;G
J H P M L | L P M J;H
X O I K A | O A K I;X
G N U E F | F U N G;E
E J Z U Y | J E Z U;Y
K S M G D | M K D G;S
K D C Q J | Q K C J;D
K W X C Y | K C W X;Y
Q C M Y I | M C Y I;Q
U F R Q K | U R K Q;F
I H A S W | W H I S;A
R X D F V | D V X R;F
H D S W K | D H S W;K
N L V Y M | Y N V L;M
H I J X M | X H I M;J
Q H N K T | K T Q H;N
L M Z B W | B M W Z;L
O X L N B | O N L B;X
U B Z L N | L U N B;Z
R V G E Z | V G R Z;E
U I P X R | I U P X;R
T V N X K | N X V K;T
Y G K D C | C K Y D;G
W V C H Z | H V W Z;C
P I F D X | D X F I;P
C L F T Y | F Y T C;L
I L X D Y | L X I Y;D
C E U Y I | Y U C I;E
Z C X F Y | Y X F C;Z
Q S Z L Y | Y Z Q S;L
C V I G S | V C I G;S
G I V K N | N V I G;K
V J S T C | S C J V;T
H D K M A | K D H A;M
X Y M G Z | Y X M Z;G
Z U E B J | U Z J E;B
I B G Z C | C I G Z;B
N U B T Q | T U B N;Q
E Z Q C R | C R E Q;Z
J P U L S | L J U S;P
W G H T Q | W Q T G;H
Z C E B W | W Z C B;E
V M E H U | E V H U;M
C G M J T | C M G J;T
Y P G B H | P B Y H;G
F V K N E | F E K V;N
M E V C R | E R V C;M
E S B O M | B E O S;M
L K F U Z | Z L K U;F
Y C E V P | E P Y C;V
A E U K J | E U J A;K
M C U H F | M U F C;H
F B H U W | B F U W;H
O N W Q Y | O W Q N;Y
C E P R K | K R C E;P
C Y S D N | N S Y D;C
V H Y G L | L Y V G;H
R O T M Z | R O M T;Z
N Z O T A | O Z A N;T
G H B R O | H R O B;G
U E H M L | M E U H;L
G V L N K | K V N L;G
G X I Z E | I E Z X;G
B F L J D | L D J B;F
U K Q V Y | U V Q K;Y
R H T Q E | Q R E H;T
D V J S U | U D V J;S
D Q H U C | Q U H C;D
G C W F U | W F C G;U
N H Y S I | I Y S H;N
R G N C O | R O N C;G
N G B A K | N B A K;G
B O A S I | B S A O;I
O B H L K | O H K B;L
G F I J R | F R J G;I
L T S X A | X S L A;T
D Q L X W | L Q W D;X
K L H Z O | Z H L O;K
G T M N Y | M T Y G;N
E K A L D | K A L E;D
K Z M X N | K X Z M;N
U Z Q D B | D Z Q B;U
T A Y Z L | Y Z A T;L
R S T J W | T W S J;R
A U J R C | C J R U;A
M D Z A B | A Z B M;D
G F M P V | V M P G;F
Q H C B E | Q B H E;C
A F Z G R | Z A F R;G
B H J Q A | A H Q J;B
B H C M X | B M X C;H
S W L O D | D L O S;W
N C A E P | N A E C;P
H D M R X | M H R D;X
P E O Q R | R E Q P;O
H Z P A M | M A H P;Z
L U A Y P | U Y L A;P
U V O Q R | V Q U R;O
A P B X O | A P X O;B
N T K B C | K C T B;N
U W T V Z | V U T W;Z
S H E W O | W H S O;E
W Y S V J | V W J Y;S
S W L H R | W S L R;H
Y X W H T | H Y X T;W
H G Z P C | Z C P G;H
G M D R C | D R G M;C
P Q E V G | V G E Q;P
V Y H A P | P A Y V;H
I N T D K | N K T D;I
R T J X U | R T U J;X
N J H S I | I N J H;S
O V U H Z | Z U V O;H
H Z Y G C | Z Y H C;G
Z Y G W V | W G Y V;Z
H M C R J | C R J M;H
Q S U A N | S U A Q;N
D U W X A | D X A U;W
K L T S H | S H L K;T
A E C D K | C E K A;D
X S J F Q | X F Q J;S
K V G W P | G K V P;W
U K A V L | K V U L;A
K W P C Z | K Z C W;P
A H G W J | H J G W;A
V R Y U K | U K Y V;R
S M H A T | S H A M;T
C S X H E | S C E H;X
J U P X B | X B P U;J
H J V U I | I J H V;U
C M Q J N | J C M N;Q
G N T Z Q | G N Q Z;T
B I P R M | I B P R;M
W C B K T | T C K B;W
B M E G J | M J E B;G
H I T B Y | I H Y B;T
H B X V J | J X B V;H
R S V M Y | S Y R M;V
J P B U S | P S J B;U
T I R C Z | Z C R T;I
M D N F K | D K N M;F
B C G H Q | Q B H G;C
D H Y J X | Y X J D;H
X M O Y B | M Y X O;B
Z D W H G | D H G Z;W
U Q I R F | Q I R F;U
W K L M C | M K W C;L
K F T J S | T J F S;K
R Z N M L | R M Z L;N
A P D T I | A P D I;T
E Y Z O R | O Y R Z;E
K N R B M | M R B K;N
K V C Y Q | V K C Y;Q
E P F V B | E P V F;B
Z A N I P | P I N A;Z
V M S Q T | S M V T;Q
E R T C A | R T A E;C
N F M S E | S F M E;N
P Y V Q I | I Y P V;Q
R B S A X | S X B A;R
T E G V Y | T V G E;Y
L A Y I T | T Y A I;L
U A N T J | N J T A;U
R X W V K | R V K W;X
F C W M U | M C U F;W
H M E P A | M P H E;A
Y L D W C | L D W C;Y
F C K B X | K X B C;F
Z X J N O | Z N O J;X
T M F Z Q | Z T F M;Q
C N K A M | M K A N;C
D V U S R | V U R S;D
F H N W Q | N W Q F;H
D U S C J | J S C U;D
V O H C S | O V C H;S
F G K E J | E G F K;J
Y B H C D | C H Y D;B
R D T U E | R E U T;D
L S N Y G | N S Y L;G
N O Q J B | Q J O B;N
H Q U M O | H Q M O;U
Q J X E W | E W Q X;J
J Y R K E | R K J E;Y
G O W I D | G O I D;W
A G J Z E | A E G J;Z
Z W P K F | W F K P;Z
R D K S Y | D R K Y;S
H K V I N | V K N H;I
X U W P G | U G P W;X
O C I W V | O C V I;W
U A O K M | A K M U;O
L R V B P | V B R P;L
N I U O L | N L U I;O
A B F W M | F W B M;A
Y Z H L P | H Z P Y;L
T V J P X | V J X T;P
H U K B X | X K B U;H
W H Z I Y | Y H I W;Z
G U E S O | U E O S;G
J Y R F Z | F R Z J;Y
M S B E N | B E M N;S
F R W K B | W F K R;B
R B T Y E | Y T B R;E
P W D V T | D V T W;P
N J A O G | G O N A;J
T C A S F | F T S C;A
O L Y R V | L Y R V;O
D I O B J | I O J B;D
M V A T E | A M E T;V
I W C Q Y | W Q C I;Y
J U R V F | F J R V;U
K P B A V | K V P A;B
H A Y L B | H B A Y;L
L G J Y Z | Y G J Z;L
U M L B A | L U A M;B
H P M E I | E M I H;P
D H O J A | D H A O;J
X Y S M H | S Y X M;H
H T X A C | A H X C;T
K V D H P | K P V H;D
K G J Y E | J Y G K;E
A R E Z I | A Z R I;E
A W C O L | W C O A;L
W G N Y Z | N W G Z;Y
G L Q J B | B L J G;Q
C V T F B | C F B T;V
Z J K L F | K L Z F;J
E Z M L B | M B Z E;L
S U P V G | G S P V;U
I L U D E | L E D U;I
J Z X A F | F J Z A;X
O E S B P | S B O E;P
W X T A K | T W K A;X
E V I D Y | E I V D;Y
Z P J M F | F Z J P;M
D A F H U | U F H D;A
I D T Y A | I D A T;Y
N Z J A U | J A N Z;U
L O Q Y C | O L Y Q;C
Y M E R H | R M Y H;E
Q D W L V | D Q L W;V
R S G Z M | Z S R G;M
G X I H C | H G C I;X
D J Q Y K | Y D J Q;K
Z T G J S | G T J S;Z
I C Z V B | C Z I V;B
S D C B O | B O D S;C
J K W I P | P I W K;J
W B A G O | A B G W;O
M B F Y T | B M T Y;F
U F K J B | J U B K;F
F W R A H | A H F W;R
B J Z P K | K B P J;Z
O I E V M | I M O E;V
J E W U K | U K E J;W
V Q A P F | V F A Q;P
K C W R N | W K N C;R
X Y I P U | I U P X;Y
V A P K U | A P U K;V
Q B G L D | Q B D L;G
T B G V K | T G B V;K
B V O L C | V L O B;C
P H Q K G | Q G K P;H
T L P N C | P T N L;C
U Z W D Y | W Z Y U;D
F P Q V O | V O P F;Q
A R O S G | S G R A;O
U O W K M | U M K O;W
H D F J B | H J D B;F
B T W I V | B T V I;W
V T B R L | V T B R;L
Z D Y A R | R A Y Z;D
V F Q K P | V K F Q;P
A W Z B M | Z B W A;M
S V C G W | C S W G;V
G M L C W | G L W M;C
P I W M B | B W I M;P
E T F V I | F T I V;E
O H X I R | X O H I;R
N T Z F D | D Z T F;N
P B U G X | X B U G;P
V X U E L | V U E L;X
P Z L R C | Z L P R;C
L T X R U | U T X L;R
I O P Q K | O K P Q;I
M A Z P F | F A P M;Z
P D G R Y | G D Y R;P
F D I K E | D E K I;F
D H T V G | D G H V;T
K P E U I | P I U E;K
K H E R W | R W H K;E
U C Z L P | L Z C P;U
F E R I O | E I F R;O
H I G S K | I H G K;S
J M Y C P | Y J C P;M
V F S I L | I L S V;F
R O F C H | O R H C;F
V U D B T | V D B T;U
U K R A D | A U D R;K
I K E B J | E B J K;I
Z F Q E U | Z U F Q;E
C M R X F | F R X C;M
I G Z C T | Z G T C;I
B P W F H | B P H F;W
Q A H I F | Q H I F;A
W Z A R U | W A U Z;R
N E R H K | R H K E;N
C O E A Q | E A Q C;O
P S A T L | L S T A;P
K H E X J | K J E X;H
W P A H B | H A W P;B
N H Y U P | P Y N H;U
Y D Q O G | G Y O Q;D
X H G E U | H U X G;E
U N Z J W | U N Z W;J
Q F P J N | J F N Q;P
J S T R G | J T G R;S
X U L Q Y | Y U X Q;L
U B I S E | I E S B;U
I K M G Q | G I K M;Q
X U Z G K | K X Z G;U
R Y M Z N | M Z N R;Y
E C U I B | I B U E;C
Y W S K G | K Y W G;S
D O R F M | R F O D;M
O S M W A | A M S O;W
R L H I J | I L J H;R
Q D E K O | E D O K;Q
F Z B S A | B Z A S;F
G E Z F Q | Z Q G E;F
Y X C K V | V C Y K;X
I V Q B G | Q V I G;B
X N Y U P | N X P U;Y
S O W C T | W S T C;O
P R I U T | P I R U;T
U V X B N | U V N X;B
C E N S V | C S E V;N
C P J Z Y | C Y J Z;P
S K F X J | F S J X;K
S Y U H Z | H U S Z;Y
Y E Z S P | S P E Y;Z
P I R U Q | I Q U R;P
S N A H F | S N A H;F
R Q G A M | R A G M;Q
F G D R Z | Z G R D;F
L J N S D | D N S L;J
P Z A R Q | Z R P A;Q
E J X P S | X E S P;J
T W S J I | S T W J;I
V O B K E | K E B V;O
J T Y P X | Y J P X;T
P S Q H V | H P S V;Q
M C N Z D | N D C Z;M
S J C D R | D J C S;R
D E P A Y | E P A Y;D
D K F U N | K F D U;N
B Y L M I | L I Y B;M
B U G P F | B U G P;F
S N F D Y | F Y S N;D
F L J O V | F V J L;O
J M X L Y | J M X Y;L
S Z Y A O | Y A S Z;O
V T M S Y | V T S M;Y
F N P G A | A N G P;F
F Q G M R | Q M R G;F
E I T Y P | E T P Y;I
E I F Q G | E G Q I;F
X H F I C | C X H I;F
H U S B D | U H D B;S
Q F C M R | C R M F;Q
H B D N M | B M H D;N
U I B R W | W I B R;U
P Y M C E | C E Y P;M
A I C L Y | A Y I C;L
H N S R P | R S H N;P
Z G P W Y | W G Z P;Y
X B L N D | X N B D;L
P N D Z S | N P D Z;S
E H X P I | P X H E;I
Y A K W E | E K Y A;W
A Z H E K | E Z A H;K
Z E M L C | L E C M;Z
Z F B S Y | Z B S Y;F
B O U G R | O G U R;B
J U K Q G | G Q U K;J
L H R Z X | X L H R;Z
H C K J A | J A K C;H
O Q M A B | O Q B M;A
A Q E S Z | S Q A Z;E
R L C Z V | V Z L R;C
C W T H I | H C T I;W
K W N M J | W N J M;K
S I A T R | I S T A;R
L V F A W | V F A W;L
N U X C E | X U N C;E
N R U C E | E R C N;U
B F K H L | K L B H;F
V I C R U | I R V C;U
D I T L R | R T L D;I
S Q D V L | Q D S V;L
X D Z W T | X D T W;Z
G R C S I | S I G R;C
T Z O K M | Z O T K;M
M Y H D E | H Y D M;E
D S K V Z | V D Z S;K
Y R S A N | Y S A R;N
Q X N R L | L N X R;Q
J T I V H | T V H J;I
P L S Q M | M S P Q;L
P T A K L | P T A K;L
R H Y X F | R X H Y;F
E I J Q L | J E I L;Q
M C P G L | M P G L;C
L B H G C | G H C L;B
O J V F U | O J U V;F
G R V M D | M D R G;V
O N I R F | O N F I;R
M U X I V | M I X U;V
A S H C T | S C A T;H
M C I G B | I B M G;C
G U D F V | V F U D;G
R Z C P V | C R V P;Z
K Y U B E | B E K U;Y
Q F O I Y | F I O Q;Y
S H J M I | S I J H;M
T F X U G | X U G F;T
W B F S D | S B W D;F
D W J P R | R D W J;P
N T P C W | T W N P;C
D F S I L | I F S L;D
W X O C T | O X T W;C
U X I Q E | I X Q U;E
S C R F E | F R S E;C
S I G E Q | Q I S G;E
W S G A I | A S G W;I
C I Y L W | C I L W;Y
W H E R U | U E W R;H
Y V R E F | F V R Y;E
Y X K D L | Y L D X;K
Y X R P I | P X I Y;R
G T P X H | P G H T;X
R A T Q K | R Q K A;T
P O E H F | O H P F;E
K V U Z B | K Z V U;B
O G K E S | S G K E;O
Z P A O I | P A I O;Z
R I W Q S | S R I Q;W
N R S M C | S M C R;N
N X V K F | V K N X;F
R A T X M | R A X T;M
D B H L S | S B D H;L
N Z E G V | V N E Z;G
Y X K Q H | Y X Q H;K
O Y H S M | O S M H;Y
B F V T M | M T F V;B
G Y M N J | N J M Y;G
N D K F M | D F K N;M
Y L H O I | I L Y H;O
Q A J G D | Q A J G;D
T E J M P | T P M J;E
X Z W P J | X W P J;Z
Z J D C L | D L J C;Z
B S V E P | V P E B;S
E T Q C W | T Q W E;C
N J G C P | G C N J;P
B Z A Y O | B Z A Y;O
G X Q C P | P X G C;Q
T W X E Z | W X Z T;E
U G A D Q | G A Q D;U
A W X K M | X K A W;M
Q J S Y C | J C S Y;Q
R Z H D C | C R D Z;H
U Q W K P | W U K P;Q
A K F E X | A K X F;E
P D M E W | E D M W;P
K P U M I | M U K P;I
Y K E H Z | H K Y E;Z
T N K M G | T G M K;N
Y M E A P | M E A Y;P
K F S H J | S K F J;H
Q S R V F | V S Q R;F
A X N R H | R A H N;X
D E O P H | H E O D;P
I V L S X | V L I S;X
Z E S O F | Z F O E;S
L I N V A | L A I N;V
H I U S A | A H U I;S
J C M X O | C O X M;J
V T N E X | X T N V;E
E T Z X J | J X Z E;T
A O M C V | V C O A;M
S I C N Y | S C N I;Y
S W L I H | L H I W;S
N O J S T | J O N S;T
I Y F D P | Y D I F;P
G T X F Z | X Z F G;T
U X N B D | B X U D;N
Y V G D R | R D V G;Y
C S Z G J | G J Z C;S
R H G F M | F R M G;H
W C N B K | N W K B;C
Y V B R A | Y R A B;V
F O Z G A | G Z O A;F
K W D L M | L D M K;W
O R F H K | K O F R;H
L T S F P | T L F P;S
F D T G K | D F K G;T
O T Z N H | N Z H T;O
P V M J K | P M K J;V
F S P E N | N S F E;P
H V C O L | O H C V;L
H T Q L R | R H L T;Q
B J N V G | J V G B;N
V S J C R | C R J V;S
T Y V U J | Y V U J;T
J N X Q K | X N Q J;K
K C V P L | K C P V;L
T H U K M | M T U H;K
X C H R B | R C X H;B
A U Q N I | N U I A;Q
B U R Y J | U B J R;Y
R I G K E | E I K R;G
Q O S C G | O S C G;Q
D H O A F | D O H A;F
A O K I J | K J A O;I
C A N K D | A N K D;C
K X Q R F | X F Q R;K
R S O H I | S R H I;O
V Y H L J | H V L Y;J
K R O Q J | J O Q R;K
K T E B R | T K R E;B
V U D G R | R G D V;U
R B D Y X | Y X D R;B
N P I K X | X I P N;K
I J H T G | G T J H;I
A T U V J | U A T V;J
V D M I Q | D Q V I;M
L W M A O | O L M A;W
D V C G I | I G D C;V
J W S K T | J W S T;K
E Y Z C V | C V Y Z;E
U M J B I | I U B M;J
E K Y O V | V O E K;Y
L N Y D P | P L N Y;D
W H O D Q | D H W O;Q
R H T Y G | H R T Y;G
M C X Z B | X C B M;Z
L G U Y I | G Y L I;U
W E C R Z | W C R Z;E
F Q X I J | F J X Q;I
F U D Z L | L F D Z;U
G U E F W | F G E W;U
Q P I A N | Q A P I;N
U I O C D | C I O U;D
H V Y J Z | Z J H V;Y
O U Z K P | K Z P O;U
S D G N A | D G A N;S
N B A Y P | B N P Y;A
S Z Q R U | S U Z R;Q
H N Q K R | R N Q K;H
P X Z L W | X W P Z;L
K D I Q X | Q K I D;X
U Q O X M | Q U O M;X
Z L F Y B | F L B Z;Y
L H S X A | X L S A;H
A E Q U X | U A X Q;E
V F H G B | G B F H;V
G Q C B F | C Q G F;B
G Q D U E | E Q D G;U
K N F D Q | F D Q N;K
X T F L K | K L T F;X
R N P B D | P R D N;B
G L W T A | A W T G;L
O E L A S | S O A L;E
S P M J I | J M I P;S
W L N S E | S W N E;L
W B C M H | B C M H;W
H B L N E | N L B H;E
A X D J K | X K A D;J
O B Y D Q | Y B D Q;O
D Q O G A | D A G Q;O
L U C B K | B C K L;U
N R G V Y | Y G V N;R
R Q N M W | Q N R W;M
K A E Y F | A K Y F;E
X I C A R | I X A C;R
B K I X U | X K I B;U
I O M W U | W I M O;U
F W G Q B | W Q G B;F
F W V T S | F W T S;V
X G P J H | H G J X;P
T J O V W | V J O T;W
E W N J K | W E K N;J
V S D T R | R S V D;T
R V Y L G | G V Y R;L
L E H R C | H R C L;E
W E T K H | W H E T;K
W Z A F I | Z F A W;I
L F U V G | G U F V;L
W Q C U R | U C W Q;R
B Q Z E M | E B M Z;Q
W Z Y U I | I U W Z;Y
M K D H B | H K D M;B
Q D G U K | G D Q U;K
C E X Y O | O E C Y;X
X C M Q H | M C Q X;H
O M T Q J | T J O M;Q
B D W C G | G D W C;B
V N J P S | J V P S;N
P V C N S | S N V P;C
H F D T M | D M H T;F
E U A F K | A E U F;K
F L K H N | H K N L;F
B H T D N | B N D H;T
I C E Y N | Y E C N;I
I N Z T E | Z E N I;T
S I X G L | X S I G;L
A E Z M I | I Z E A;M
I C D F W | I F D W;C
U I F V N | I F U N;V
F X K M R | K X R M;F
G C H B U | B H C G;U
S N O Q R | R O S Q;N
C Q K T F | C T K Q;F
J Z R N H | R J N H;Z
T L A K F | L A F K;T
W D Y T U | W Y T D;U
F X Y Z K | Y F X Z;K
S P T G C | P G C S;T
B U J K F | K J B F;U
U S W G Z | U W S Z;G
H S Y B R | S H R Y;B
N Z T Y R | N Z Y R;T
F D R W C | W D R F;C
I Y X C U | Y X I U;C
K D L B E | D E K L;B
Z C K M R | M Z R C;K
P T B N D | T P B N;D
A E X J H | H J A E;X
J F X B K | J X K B;F
R Y B S W | Y W B S;R
I W Q A S | A S Q I;W
A W C M N | C W N M;A
O J W D K | D O J W;K
Z V M E C | Z E C V;M
F R U B H | H U B R;F
Y R N W P | R Y P N;W
F E T R J | T R E F;J
O M J E K | J E O M;K
G V S P R | V R P G;S
D X I Z J | Z I D J;X
Q Y T J L | J L Q Y;T
B N F J Q | Q F N B;J
L O V N C | O N V C;L
G J F B A | F B G A;J
Q G B J K | G J B K;Q
J H Y N C | N C H J;Y
D Q H X O | H D Q X;O
Q D O N E | N O D Q;E
K S M E L | M K S E;L
J S H A Z | H S A J;Z
I K L H O | H O I L;K
P A C B E | A C B P;E
H V E G R | V R E H;G
V G C Y Z | Z C Y G;V
Y B Z P L | Z L P Y;B
L R D U S | L D U R;S
X Y S L P | S X P Y;L
R P C U E | U E R C;P
L Z N I E | Z N E L;I
V D E N I | D N E I;V
H F K Q X | H K F Q;X
C B S N W | C B S N;W
H K F D X | H X F D;K
L K M X O | M K X O;L
R H F B X | F H X B;R
U X Y S J | J Y X U;S
J F V K T | V T K J;F
K Q R Y L | Q L R K;Y
P F T M H | H M P F;T
K B N C S | N B C K;S
X G M E J | J X M E;G
M L F Q U | M F U L;Q
T N Y B E | Y N T B;E
X H D V T | H X V T;D
K A F H B | A B F K;H
U N X K R | K N U R;X
I K G W N | N G I W;K
B Q C I O | C I B Q;O
O I M H C | C H O I;M
W G Q R J | J Q G R;W
R S V P O | O P S V;R
L H Q G I | G L Q I;H
T G S B O | T S O B;G
R G X B Z | B G R Z;X
Y M T G J | M J T Y;G
C Y R N B | C B N R;Y
Z X K F B | K F X B;Z
U S V R L | S V L U;R
U D F T G | T D U G;F
P S Q F T | T Q S F;P
T J R N Q | Q N J T;R
I Y T X B | X T B Y;I
Y B J L N | Y J B N;L
P R K Q B | K Q B P;R
B T I Q X | I X Q T;B
V E S U T | S T V E;U
M Q P D S | D M S P;Q
Q B S X W | W Q S B;X
Q K D C B | C Q B D;K
E Z Q G S | Q S E Z;G
B J T O F | B O T F;J
N U A W J | U W N J;A
R M Q B G | B R G Q;M
S F R H L | L H F R;S
M E R V I | R M E V;I
U A L D W | W U L A;D
K F O M L | L M O K;F
P Q N H R | R N H Q;P
C E P B I | E I B P;C
H B G S E | E H S G;B
H R D B E | B R E D;H
D T H Z V | D H T Z;V
Q W X C R | R W X Q;C
K F C H L | L K H C;F
V U G L F | U V G F;L
I E B Y R | Y I E B;R
N K R U V | R U N V;K
J E X K A | J E K A;X
I Z G J L | Z J I L;G
G A D U O | U A G O;D
Q A U D S | D Q A S;U
R E J K A | E A R K;J
Q S R V J | R S Q V;J
A S V M X | A X M V;S
F A E C N | N F C E;A
S W L H B | S B W L;H
U Z V D W | W Z D U;V
R Q L J D | Q J L D;R
O L A S G | A O S G;L
C M J R G | C M R J;G
O M J D Z | O Z D J;M
V Z K F L | F Z L K;V
R N Y M C | M N R C;Y
Z C K X V | K X C Z;V
Y X Z G W | X Z G Y;W
T S O F M | F O S T;M
N W K Q M | M N W K;Q
W D X P R | P R X D;W
X T V L K | T X K L;V
Z S B G X | Z S G B;X
P X U K E | U K X E;P
M R I H A | A M R I;H
P D O M G | M G D P;O
Z J X R I | R X I J;Z
O U J G Y | J U O G;Y
U R M Z D | R D Z M;U
J D T O I | O I D J;T
E O F K M | F E O M;K
W Y S L Z | W S Z L;Y
Q A L P K | L K P A;Q
O A Y H F | Y F O H;A
C A G F D | C A F G;D
U T D L Z | D T Z U;L
D Z G P M | G P Z D;M
Q R O H D | R O H Q;D
V C E P Z | E Z P V;C
L U B Z P | P U L B;Z
D E V W F | D F V W;E
A P S B W | A B P W;S
B L E J M | J M L E;B
Q I M Y Z | M I Y Q;Z
U E R N D | N R D E;U
A E Y G S | S G E A;Y
G M J N T | J T N M;G
M D C W S | W S D M;C
C E X U Q | C U Q E;X
G B O Z W | Z O G B;W
O X P T I | P O I X;T
O I L X H | O H I L;X
X G R F T | X F T R;G
C X B V T | C X B T;V
E P G S V | P G E S;V
D C W Y U | U D Y W;C
Y E W B T | E B Y W;T
V L F X N | F V X L;N
E X W R Q | E R W X;Q
U T S Q J | T U J S;Q
X F C K H | H F K C;X
Z W K H S | H Z W S;K
G P K B U | G P U K;B
S W T L G | S G L T;W
Z B I R O | B O I R;Z
A L J C X | X L J A;C
U L V Y W | L V W U;Y
A O P H S | O S A H;P
M Q R C S | S Q M C;R
D U K S J | K D U S;J
Z T O D G | T Z D G;O
D W U R X | U D R X;W
A F K X P | X K P A;F
T G P L M | G L T P;M
L D E J G | D J E L;G
E X J W B | E X J W;B
T C L B I | B C I T;L
Y D Q Z X | Y X Q D;Z
A G E D U | U E D A;G
M E O U Z | E Z U O;M
U X P L C | X U C L;P
G D H E C | H D C E;G
P C Y K D | Y C K D;P
U F K T P | K F P T;U
G D P Y U | U P D Y;G
O Z Q D E | Z D E Q;O
Y W A D B | B Y D W;A
V I A N Q | I Q V N;A
C T N R M | R C T M;N
Y D B L G | Y D L B;G
Q J G R W | J Q W R;G
F X Q B Y | Q F X Y;B
X B O P H | P O X H;B
P E D Y G | E D Y P;G
Y B V T Q | T V B Q;Y
N A L I S | I A S N;L
W R M D O | O M D W;R
K N R Q S | N Q K S;R
N Q B G E | E B Q G;N
I W Q N P | Q I N W;P
S B V O J | B V O S;J
Z H N X O | H X N O;Z
N Y D C E | E Y N C;D
V A Z Y M | V M A Y;Z
Y F I D T | F Y D T;I
R A K D C | R K A C;D
D Z Y K S | Z Y S D;K
U M H S I | M U S H;I
I L H W Z | L Z W I;H
O J P I Y | Y P I J;O
O S C X P | P S C X;O
Y X Q G H | G X Q H;Y
H D F P A | F D H A;P
I Y P Q V | V Q I P;Y
K M T A I | M I T A;K
Y C N G M | C M G N;Y
N Q B G P | N B G Q;P
Y M V W S | Y M S W;V
O R E A M | M A E R;O
B N Q W U | N U Q B;W
C W B S N | N W B C;S
E I B F L | I F B L;E
B M R Z Y | Z M Y R;B
A G V B Q | V Q B G;A
H A I P C | H I C A;P
H U S P R | R H S U;P
S Q H N L | L N H S;Q
F M K E X | K M F X;E
A T B R M | M A B R;T
N M B L P | L N B M;P
N Z Y R G | R G Z N;Y
V O E Z U | O Z E V;U
A P H Y Z | A H Y P;Z
G J R B K | K G J R;B
Y N P B J | Y J P N;B
A P N J Z | A N J P;Z
J P A L H | L A P H;J
T X V K R | T R X K;V
S M G V E | G M V S;E
E M R D I | M R I D;E
A R Q B J | Q A B R;J
Q C G J F | F C J G;Q
Q G W R Z | Z G R W;Q
U R O T C | U T O C;R
T Z L E N | L T E Z;N
N W C O S | W C O S;N
C X V Z M | V M Z C;X
Q X U W D | Q U W X;D
T A K C X | K A X C;T
G P Z N C | C G P N;Z
Q N Y S U | N S Y U;Q
F P U L M | F L M P;U
U S O Q J | J Q O S;U
S T E U F | T U F E;S
W D N I Y | D I W N;Y
F N A P X | X N F A;P
O X I Z V | X I V O;Z
B P I U J | I P U J;B
J O U Y N | Y N U J;O
L V E H K | K L E V;H
B R W X A | R A X B;W
E G U J B | E J U B;G
K J Q T E | J K Q E;T
Q D K I L | Q L D K;I
R P L Y K | R K Y L;P
Q M R V W | M W Q V;R
L B G C A | C B A L;G
W R Y S J | Y S W J;R
V Z O I B | Z B O I;V
Y A T P X | Y P X T;A
D J Q P B | J Q P D;B
S V J U Y | S U Y V;J
O V N Q F | O F Q N;V
F R J W G | G F R J;W
N D S L V | D V N S;L
L Z B D A | L A D B;Z
O F Q Z N | Q O F Z;N
P X B T R | T B X P;R
T M W Y C | T W M Y;C
P V N R U | P U R N;V
S D V C U | V C U D;S
L X C E R | R E L X;C
V F H Z R | V R F Z;H
Z T J A P | J A P Z;T
E U R A W | U R A E;W
O F W G V | G V O F;W
T M I H N | T H N M;I
O E A Y H | H A Y E;O
Z M E D H | Z H E M;D
W H X F U | U H X W;F
C J B P S | C P B S;J
G T B C O | G O C T;B
T M Z J H | M J H T;Z
H I D Q B | Q H D B;I
I E D P Z | Z E I P;D
L W Z B O | L Z O B;W
G I T C K | G T K C;I
L H O X T | X H L T;O
T P U N W | P W T U;N
A C K X J | J C A K;X
K B Q J O | B J Q O;K
B V J G Q | V G B J;Q
G Z C A H | A C Z H;G
X W E O B | W X E B;O
I G W T H | H G I W;T
I H J C B | J B C H;I
E Q G T P | E G Q P;T
V A C H J | C J A H;V
W K E N R | N R W K;E
B Y W F P | Y B P F;W
E Q S U N | S E U Q;N
M I Y H V | Y M I H;V
O D W P N | W P N O;D
Z N O W X | O W N Z;X
H U A B T | A H U T;B
D U X A K | D U A K;X
R T O U B | T U B O;R
L Z O Q B | L B O Z;Q
C R Z U A | R Z U A;C
J S C Z K | J Z S K;C
B Z U W X | W X U Z;B
T R V E C | T V C E;R
B R H U V | R V H B;U
P J N X D | N P D J;X
Z F L S T | Z L F T;S
K R C S O | C K S R;O
T W D K Y | K D W Y;T
V W D E R | W V R D;E
V F R E C | C F V E;R
S X A T H | S X A T;H
M E Q R K | M Q R E;K
Z S A W G | W S G Z;A
P J S I N | S J I N;P
O L P K S | P S L O;K
G Q Y Z E | Z Y E G;Q
N I F H E | H F I E;N
F E Y M Q | M F Q Y;E
C H O J N | N H O C;J
O N F C B | C B O N;F
E D M Y R | Y E D M;R
V B N X C | V N B C;X
V B D C X | D X V C;B
C G Q B L | L C Q B;G
I S X N T | X I N T;S
U K G I A | I K G A;U
T U X P A | X U T A;P
U M R D F | M U D R;F
P W Z U C | Z W P C;U
K U S H G | U S K G;H
V Z U X Q | U X V Z;Q
D Y B P F | Y F B P;D
F U P L A | U F L P;A
L P O S G | G L S O;P
V F D J T | F J D V;T
M Z G C U | M C Z G;U
D L O I U | I O D U;L
C Y P D A | A D C Y;P
W J S T D | D T S J;W
X M R N H | H R X M;N
G W S J Q | G Q S W;J
V E D Y G | E V Y D;G
V R K M Y | M K Y R;V
W E O H P | E P O H;W
E T M I B | I B E T;M
K Q H I S | S I H K;Q
K P G V H | K H V P;G
S A R F P | R F S P;A
D K P A I | D K I P;A
Z V K X E | K V E Z;X
J K E Q Y | Q E Y K;J
Q R C O U | U R Q O;C
M E Y D R | E M D R;Y
Z R J N V | V N J Z;R
V M E W T | W V M E;T
O V G A E | E G A V;O
N L P I W | I W L P;N
J C S O M | O C J S;M
S C Y F L | F C Y L;S
S I E A U | E S U A;I
H K F L A | H K F L;A
V F G X U | F G U X;V
D U M X R | R U M D;X
Y V L W U | U Y L W;V
C P A F L | A P F L;C
T Q O Y Z | T Q Y Z;O
G Q O B P | G O B P;Q
U X P J S | P X S U;J
B E N R K | R E N K;B
I P A B T | I P A T;B
V W O H E | V H W E;O
E F A B Z | B F A E;Z
G Y W T V | T W Y V;G
N M C S T | N S T C;M
W J A L S | J L W S;A
N I H R Z | N R H Z;I
G M A D E | A M D E;G
E C I N Q | E N C I;Q
G U Z W P | G W P U;Z
D O Y B I | I Y O D;B
A V J L I | J I L V;A
L Z E A Y | E Z L A;Y
B E Y H U | B Y E H;U
A F S V Z | A F S Z;V
Y P G C J | G P Y J;C
L R F A N | L R A F;N
W J H G C | W J H C;G
U Z P S F | Z U F P;S
W H J X S | W X J H;S
G T F U S | S F U T;G
Q C E L H | C H Q E;L
D C Q R Z | D R Z Q;C
C P E H U | U P C E;H
O C W Q U | U W C O;Q
V S E T K | V T K E;S
S Q C P Z | S Q Z P;C
R H L Z X | H R L Z;X
F C R K Y | F Y R C;K
S W B I D | S D W I;B
Y C D E G | Y C E D;G
C Q R X D | R X C D;Q
E A O R X | A E R O;X
T I B S O | B T S O;I
H N B K A | H N K A;B
B R O J F | J F B O;R
P L B Y X | L Y P X;B
R L O U Q | L Q O R;U
W H N R E | N E R W;H
A C L P U | C U A L;P
B C U N Y | U N C Y;B
K Q S C E | C E Q K;S
O V M S Z | S O Z V;M
V E M X U | E V M U;X
O U X F L | O U F X;L
M I H B C | I C H M;B
G R D K Q | D Q R K;G
V X Q R F | X F V Q;R
Q J D W V | W J V Q;D
F K P E G | P E F K;G
O K M X Z | O M X K;Z
I A M H R | M I A R;H
I W C E T | W T I E;C
U Q A X N | N A X U;Q
I R E O C | I C R E;O
Q E H Z C | H Z C Q;E
T P M F B | B F T M;P
O P L V M | L V M P;O
Z Q H N V | V H Q Z;N
Y Q R T Z | T Z Y Q;R
F E R C L | E R L C;F
F C D P Z | F D C Z;P
W F B S A | W S F A;B
Z L K V B | L K Z V;B
K B M Z L | L M K Z;B
Y B O U C | O C B Y;U
Y R O X L | O Y R X;L
Z S I W K | I S K Z;W
W K T N C | C N T K;W
E A Z T N | T A E N;Z
A O W Q U | Q O W A;U
U T Z I W | U Z I T;W
T I Q V R | T Q R I;V
Z G D P Y | D P G Z;Y
G R K V E | R K G E;V
Z G N U Q | G Q U Z;N
Z R P M T | P M R Z;T
S K R C J | C S R J;K
I P H J X | P H X I;J
E Y V G J | G V J E;Y
L W B G E | B G E W;L
U G V Z D | D G Z V;U
G W Q U T | U Q G W;T
U L A N D | N A U L;D
D B C A L | B L D C;A
I K B A R | R B K A;I
T B H F X | B X T F;H
U D A J W | A J D W;U
N Q O M R | M Q R N;O
E A X B N | E N A X;B
K G P R O | P G K O;R
