K Y O H | O Y H;K
X H V N | X N H;V
Z G V S | S G Z;V
X C P M | M P X;C
P I K T | K I P;T
C K G L | K C G;L
J Z G B | J Z G;B
I Y N K | Y N K;I
Z G X N | N Z X;G
I X K R | R I K;X
Z Q O S | Z Q O;S
Y J L Z | Y J L;Z
L U R H | L R H;U
H G M V | G H V;M
N B R X | B R N;X
R P Z S | P R S;Z
V Q H F | V F Q;H
B F Z W | B Z F;W
I P O M | O I P;M
L Q N X | X L Q;N
P K H Y | H K P;Y
L W J Z | J W L;Z
I F A V | A I F;V
A I O H | A H I;O
B U Q I | B Q U;I
M F H L | H L F;M
O L B H | B L H;O
T J M L | M J T;L
K E W X | W X E;K
Q I E B | Q E I;B
S J O U | U J O;S
N I H D | I N D;H
R V K E | E R V;K
V I C A | I C V;A
O I J K | J I O;K
U K B T | U T B;K
O X U H | H X O;U
O I A R | I O R;A
K H C B | C H B;K
S M D F | D F M;S
E P C G | E C G;P
Q B T Y | Q T B;Y
L C P E | L C P;E
O X I E | O I E;X
L J R C | L R J;C
W T M Y | T M W;Y
A C P W | P C W;A
S T K Q | K S T;Q
W F Z E | E W Z;F
U H D Q | H D Q;U
B N O J | O J B;N
D V P S | D V P;S
X D M T | M X D;T
C Q Z K | C K Q;Z
A O W J | A W J;O
H T B K | T B K;H
C T S K | S K C;T
E G A T | A E T;G
Q W R Z | Z R W;Q
M A O H | A H M;O
H D I K | I K D;H
F R V L | F R L;V
K S L Q | Q S K;L
N B H I | I H N;B
G U L C | G U L;C
C J R X | J R C;X
F C U Z | U Z F;C
V P F T | V T P;F
I H Q X | X Q H;I
Y L V A | Y L V;A
I Q S A | A S I;Q
F G I N | N F I;G
Q R G N | R N Q;G
F M J W | J M W;F
H N K S | N S K;H
R W G X | X R W;G
C P B M | P M B;C
E M O P | P M O;E
S T X E | S T X;E
A I V M | V I M;A
L S M T | L S M;T
U P G W | U W P;G
S R U T | T U S;R
D A L V | V L D;A
B N C Q | C B N;Q
B S Y F | B Y S;F
Z W I H | Z I H;W
M B A H | H B M;A
B G J N | G J N;B
Z P K R | Z P R;K
G S M E | G E S;M
T A L G | G A T;L
V H P C | V P H;C
J D Y E | Y J D;E
W Q B S | Q B W;S
U R S J | U S J;R
C X Y R | R X C;Y
N O C I | I O C;N
H O J G | G H J;O
X Z G C | G C Z;X
N V S M | N S V;M
W C T M | W M T;C
H D T J | D J H;T
L I N X | X L N;I
P R T D | D R T;P
W V F I | V F W;I
E M N A | A N M;E
D V Y J | V Y D;J
G J V U | V J U;G
W V J R | V J W;R
D C R H | C H D;R
F X N T | X N F;T
N O R M | R O M;N
R V G K | G R V;K
N U B C | U C N;B
L C Q R | C Q L;R
P N I Z | P N I;Z
Y J V T | V Y T;J
O Y L F | F L Y;O
J V C W | J W V;C
V I N E | V I E;N
P E M G | G E P;M
C W S L | C W L;S
J R Z O | O J R;Z
Z I B V | V I Z;B
F G O T | T G F;O
I O Y F | O F Y;I
N R K U | U R N;K
X E I L | L I X;E
A R J Y | Y J A;R
G P O D | O P D;G
G U C V | G C V;U
W N P C | N P W;C
T L D C | L C D;T
S L B D | D S L;B
D P B T | P D T;B
L X Q W | W Q X;L
U H C A | C H U;A
T L N P | N P L;T
G X K V | K G V;X
Z E W Y | Z Y E;W
N M Z H | H M Z;N
C I Y Q | C Q I;Y
M N S J | S N J;M
O Y B W | W Y O;B
B U M I | B M U;I
Z K V A | V A K;Z
M J Y C | Y C M;J
B V D U | B U D;V
N F S D | S D N;F
I B X D | D X I;B
E L D O | O L D;E
W U A Q | Q U A;W
I C K G | G K C;I
W K F E | E K W;F
Y Z D G | G D Z;Y
U I K Q | Q U K;I
W H A L | W A H;L
G A D N | N A G;D
Z E U Y | Z Y U;E
E V I W | V W I;E
M O N G | G N M;O
Z T C Y | Y T Z;C
S D Y I | D Y I;S
D C X L | C X L;D
E P G I | G P E;I
F O E J | F J E;O
Q J Y W | Y Q W;J
K Y J W | J K W;Y
A R N C | R C N;A
R E O Y | E Y O;R
X K D P | P K D;X
L V H N | V L N;H
C V S R | C R S;V
J Q B A | J B A;Q
C N D X | N X D;C
V G B Y | V G B;Y
K L U Y | L K U;Y
N Z E P | E P Z;N
G T B J | T B J;G
V U H L | U L H;V
V S U K | K S U;V
X W K J | X K W;J
A O N V | N V A;O
R H V Z | H V R;Z
C W O L | W L C;O
F K V J | J V F;K
O H M L | H M O;L
D W V G | W V D;G
D P F Q | F D P;Q
J V Q X | X V Q;J
M K Y Q | M Q Y;K
H P C E | E H P;C
Z A W G | W A Z;G
B Z O X | Z O B;X
W F R P | R P F;W
M J I S | I S J;M
I E X Q | E Q X;I
A Y V H | Y A V;H
J D R E | J R E;D
V D A Q | V D Q;A
H M T Y | H Y T;M
U K B G | G B U;K
J Z Y M | Z M J;Y
A U H G | H G U;A
K F G J | J F G;K
M P Z G | Z M G;P
J E Y G | J E Y;G
J E X L | E J X;L
Y V F E | E Y F;V
H A X R | H X A;R
M J N F | M J N;F
Q M K R | Q R M;K
M R D K | R D M;K
A S C F | A F S;C
C R P W | W R P;C
P S G Q | Q S P;G
Z Q J M | Q J Z;M
M S G Y | G M S;Y
A Z D J | J A D;Z
M D J W | J W M;D
F D E G | E G F;D
H I K Z | Z H K;I
C O U E | C O E;U
G I Q N | G N Q;I
S T V R | V S T;R
V B Q N | V N B;Q
P Y W K | P W Y;K
E U O K | U O E;K
D L Z J | Z L J;D
B Z Y T | Z B Y;T
J Z K S | S Z J;K
Q K M X | M K Q;X
E R X C | C X R;E
P K Z A | A P Z;K
O S W K | W O K;S
N D Y K | Y N D;K
X O Y D | D Y X;O
M A U P | A U M;P
F S G B | F G S;B
M V J B | M B J;V
N F L D | D N L;F
L E D I | E L I;D
V T Y G | G V T;Y
G D E X | G D E;X
S X C U | C U S;X
F G I C | G C I;F
R L C J | J L C;R
Z R S J | S J Z;R
U X Z P | X U Z;P
O B G C | O C G;B
Z Q D N | Q N Z;D
W I G D | W D G;I
P A B I | B P I;A
U D M C | C U D;M
X V C Y | C V X;Y
F Q D Z | F Q D;Z
K T X F | X T K;F
Z M S B | Z B M;S
E P S B | P B S;E
D X L N | N X D;L
Q W Z J | Q J W;Z
D Z O C | Z O D;C
X B V C | V B C;X
A Z T Y | Z A T;Y
W C O D | C O D;W
F Y Z Q | Z Y Q;F
S C W U | W U C;S
O F M J | J M O;F
I A O Y | O Y A;I
U Z W K | U W K;Z
M G P R | M R P;G
P X G K | X P G;K
Y H I M | I M Y;H
W V L A | V A W;L
Q C Z W | W Z C;Q
T J U V | U T J;V
Y L A W | W Y A;L
K U G F | G K F;U
N G H M | N H G;M
Z R V T | T Z V;R
O B Y F | O Y F;B
C D K X | X K C;D
X V I T | I X V;T
T W B X | W B X;T
E M Z Q | Q M Z;E
C H P V | P H V;C
N H Z I | I N H;Z
Y P S C | Y S P;C
C U Y K | Y K C;U
B U J K | K U J;B
R L F V | L V F;R
U L B X | L B U;X
C B I Z | C Z B;I
Z J S B | S B Z;J
B A R X | A X B;R
W R G Z | R W G;Z
U V Q E | V Q U;E
H Z W R | H Z W;R
Y S Z K | S K Y;Z
B K U W | B U W;K
V L F H | F H L;V
B K G J | G J K;B
J X Y T | T X J;Y
W S A P | P S W;A
L N M E | M E L;N
O J V R | O J R;V
Y O D Z | D Z O;Y
S I R Z | S I R;Z
S F J L | S L F;J
V C X Z | C Z X;V
X F R O | R F O;X
H L G Y | H G Y;L
G J H D | H J G;D
H T A R | R A H;T
N B F U | B N F;U
V L U H | H U V;L
E L D I | E I D;L
I G O A | A O I;G
A D P V | D A V;P
P W C D | P W D;C
R K I C | R C I;K
V G H R | H G V;R
H N Q A | N Q H;A
J I D R | D R I;J
Q R L I | I Q R;L
V A E G | E A V;G
R T V N | T R N;V
G S Y M | Y G M;S
D N J S | J D N;S
Z T N O | T O N;Z
V F P B | V F P;B
J R O E | E R O;J
E T A Y | A E T;Y
J R A V | R J V;A
Z S H T | Z H T;S
J X E Q | Q J E;X
A O P H | A H O;P
L F T S | T L S;F
B G T A | A B T;G
T F K B | F K B;T
Z R K V | V Z R;K
J Z M C | M Z J;C
I R S C | C I S;R
N M F Q | M N F;Q
R B Q D | B D Q;R
W G Y Q | G Y Q;W
B J F S | F B S;J
A D R S | R D S;A
D Q S C | Q C D;S
B U Y T | Y B T;U
X U D Q | U D Q;X
Z G R Y | G R Y;Z
Z C V W | W Z C;V
V F D R | V D F;R
A G T U | U G T;A
X F J V | F X J;V
U R G C | C U R;G
S X K B | X S B;K
S D N H | H N S;D
A E T F | A T E;F
G X C E | C E G;X
V D S L | S V L;D
U W R D | R D W;U
E F T X | E T X;F
V W A Q | W V A;Q
D F V R | R D F;V
W Z T M | W M Z;T
M X V U | M V X;U
Q F B S | S F Q;B
Q I P A | I A Q;P
B Q T N | T N B;Q
B F D H | B D H;F
C U H N | C U H;N
V T R W | V W T;R
F X E T | F T E;X
E V P M | M E P;V
B G D C | G D B;C
Y Z V A | A Y Z;V
Q H S K | K H Q;S
Q N M A | M Q N;A
I V M G | G I V;M
B T S A | B T S;A
Y B A Z | Z B A;Y
K C D Q | C D Q;K
S U R O | S R U;O
T U P Y | T Y P;U
I F D Y | Y I D;F
I A T H | I A H;T
I D Z C | Z D C;I
R U J I | J U I;R
D J F Y | J Y F;D
Y H J E | J E H;Y
F O H G | O H G;F
F H L S | S F H;L
V M J K | V K M;J
U P T Q | U P Q;T
W B K I | K W I;B
Y K N L | K Y L;N
P S X C | S P X;C
W R P C | P C W;R
S R T J | T S J;R
M I T O | T M I;O
F X Q K | X F Q;K
R W Y Q | R Q Y;W
F R J L | L R F;J
P N U T | T P U;N
T L G H | T H L;G
Z L A T | L Z A;T
O T S U | O U S;T
W B S L | W B L;S
T G X E | E G T;X
O R U F | O F R;U
K L J M | K M J;L
I B A X | I A B;X
R K Z C | K C R;Z
Y D T K | Y D K;T
L D Q F | L F Q;D
K D X Z | X Z D;K
P J K M | K M J;P
O B N Q | Q N O;B
J I N W | W I J;N
F K C N | C K N;F
M R J O | J M O;R
L Q N S | L Q S;N
W R O M | W R O;M
W H T Q | Q H W;T
K P U D | U P K;D
M W P V | M P V;W
Y L G B | Y B G;L
G Y P D | P Y D;G
K F B D | K D F;B
T A J U | A J U;T
M O R C | O R M;C
G H V F | V F H;G
P G S K | S P K;G
I G F W | G W I;F
R C A N | C R A;N
O L E B | O E L;B
H S D N | H D S;N
S X O U | S O U;X
E F H Z | F H E;Z
M D E N | N M E;D
R O I D | I O R;D
D J V N | N D J;V
F C B W | F C W;B
K B W A | A K B;W
V B C E | E V C;B
P R J L | L J P;R
X E M R | M E R;X
J V X Q | J V Q;X
M G Y V | M G V;Y
N B D S | N B D;S
Z B Y E | E Y Z;B
S W V E | E S W;V
U X G I | U G X;I
K Z E I | E I K;Z
Z G O J | Z J G;O
R I F Y | F R I;Y
W V B K | W K B;V
S U D P | S U P;D
L O W X | O L W;X
E C V Q | V Q E;C
B A G J | J A G;B
D K F V | V K F;D
E A I J | E J A;I
G J D T | J T G;D
V G Z B | V G B;Z
U C F N | N U C;F
Q V B D | B D V;Q
F N J K | J N K;F
A Y U X | A Y X;U
M S B Q | B Q M;S
A Y L V | Y V A;L
Y V W T | Y V T;W
N A B H | N B A;H
X T Q Z | T X Z;Q
I L D A | A L D;I
A U T J | A U T;J
L N E R | L N R;E
F W A M | A M F;W
N O R E | N O R;E
D R G Q | D G R;Q
M W P L | W M L;P
Z D B H | H Z D;B
K B U Y | B Y U;K
G R X J | G J X;R
A E G W | E A W;G
G E J F | E G J;F
F V E D | D F V;E
D B G J | G B J;D
Q X O V | X V Q;O
R W M Z | Z M R;W
E F S Q | E S Q;F
W D G V | W V D;G
V H D O | O V D;H
Z D R J | R D J;Z
J F X O | F X J;O
C Z E N | E C Z;N
T Y W P | Y W P;T
A J Q T | T A Q;J
Z P D A | D P Z;A
H W K E | W K E;H
L U I R | U R I;L
G A M L | A G L;M
I G N F | G F I;N
E O P V | V O P;E
M P G B | G B M;P
U D P I | D I P;U
Z X B C | X B Z;C
S X T U | U T X;S
O T E K | E O K;T
K W F Q | F K W;Q
S U O J | O S U;J
W G F Q | G Q W;F
A V D E | D V E;A
Q O X A | Q X A;O
K Y H I | Y K H;I
M C R K | R M C;K
E Y K J | Y E J;K
F A B E | E F A;B
U I L G | I G L;U
N R B J | R J B;N
O D T B | O T D;B
Y Z O D | Z O Y;D
S O P T | T O S;P
C K L P | K P C;L
Y U G T | U G T;Y
Y S L I | I S L;Y
I O T Y | T O I;Y
A T I G | G A I;T
V J K B | J K B;V
X P B M | B P X;M
Q H E L | L Q E;H
E V M W | E W M;V
Y D L W | Y W D;L
D A V L | L A D;V
V H Q L | Q H L;V
Y L S I | I S L;Y
S B G J | G B S;J
A P X G | A P X;G
W C R V | R W C;V
R V L M | V L M;R
T R O F | F O R;T
N K B V | B K V;N
L N K Y | Y K L;N
T U A D | D A T;U
T B V A | A V T;B
K B F O | B K F;O
V J P O | J V O;P
S R J H | H J S;R
Y D X O | X O D;Y
G Y C A | G A Y;C
S U R J | J S U;R
P A S U | U A P;S
M C O K | M O C;K
C P L R | L C R;P
B J V C | B V C;J
E G U V | E U V;G
K P M O | O P K;M
A N Y W | Y A N;W
P W N R | P R N;W
X S P U | P S X;U
U D Y B | D B Y;U
P D E A | D E P;A
D B J V | D J V;B
K O N W | O K W;N
L M Z Q | M Q Z;L
X F M V | V M F;X
F D A K | F K A;D
V X O F | F X V;O
Q Y S H | H Q Y;S
Z V R B | V Z R;B
R F X P | P F X;R
N Q A D | Q A N;D
S P T N | S N P;T
Y F K W | F K Y;W
T L Z S | S L Z;T
T G F R | G T F;R
M J H A | M H A;J
P V M D | P V M;D
R Z W Q | W Z Q;R
A M I T | M A I;T
K J A Z | K A J;Z
G O V H | H G O;V
Y L P J | L J P;Y
W I K B | I W B;K
M Y H S | M H Y;S
K G U T | K T G;U
D S I U | I D U;S
I N V T | I V N;T
B H W F | F B W;H
N R Z C | Z N R;C
H P B I | H I P;B
Z B R V | B V Z;R
U T J E | J E U;T
U Z N W | W Z N;U
Q Z P N | Z N Q;P
O Z T L | T O L;Z
P X U C | C X U;P
Z A K C | K A C;Z
K S G N | K N G;S
A Q X L | X Q L;A
N L M W | L N W;M
E R W U | E W U;R
L A D U | A L U;D
W Q A J | A Q W;J
X M F Q | X M F;Q
K U A D | D K U;A
O Z E U | U E Z;O
U S P R | U R S;P
I V D S | S I D;V
N Z L P | N L Z;P
Z M Y I | M Z Y;I
T C V I | C V I;T
P W C K | C K W;P
W B C U | C W B;U
M W V X | M X W;V
R Q M E | R M Q;E
C T G K | G K C;T
E K L R | K L R;E
Y J C K | J Y C;K
A E V Q | Q E A;V
U Q D M | M D Q;U
A B J M | A M B;J
V W K U | K W V;U
Q C V J | V Q C;J
X Y F G | X Y G;F
B H Y I | I B H;Y
K B O Z | B O K;Z
R I F B | I F R;B
R D S B | D B S;R
W I M S | M W S;I
M Y C A | C Y M;A
U G I S | I S G;U
F C Z E | F Z E;C
Y L F S | S F Y;L
H Q U W | Q H U;W
Y A R G | R Y A;G
I H E N | H N I;E
G T P J | G T J;P
U F R W | U F R;W
H R W B | R W H;B
H V W D | W D V;H
M U X D | U D M;X
V S O D | O S D;V
G U Y I | Y U G;I
P Z S W | W Z P;S
X I E H | E I H;X
H N O U | O N H;U
C V Y L | V Y C;L
J C W E | W J E;C
A L F R | R L A;F
U F O X | U X F;O
O W G P | P G W;O
J N X G | J G N;X
I U K Q | U Q I;K
F T V X | T X V;F
B P H L | P B L;H
Z O M P | O M Z;P
D Y H O | O H Y;D
R B W K | W B R;K
M E I F | M I E;F
P X E Q | P X Q;E
B H E I | E I H;B
K M T Q | M Q K;T
A G O Z | O G A;Z
D J C N | N J C;D
E P B M | P M B;E
G O D Y | O D G;Y
K R G S | R G S;K
L P V Q | P V L;Q
K M E L | L K E;M
X Z H W | W Z X;H
A Z F M | A M Z;F
M U Z K | U K Z;M
H U N G | U G N;H
M W B J | B M W;J
C E L O | L O E;C
V K B T | K V B;T
C Q S Y | C S Q;Y
B N V P | V B N;P
X P R F | F P X;R
M U A F | F A M;U
T Q V W | V Q T;W
K O J I | O J K;I
V G B F | V B G;F
P N O J | N P J;O
M Z J N | N J M;Z
V X W G | W V X;G
J Y T B | Y B T;J
R I U F | U R F;I
F Z M U | F Z M;U
S D M O | S D O;M
Z O A H | H A Z;O
Z X E L | L X Z;E
S X V Y | X Y S;V
T P C M | P C M;T
R S G T | T S R;G
A V Q G | A Q V;G
G T X U | X U T;G
L U E D | U L E;D
T X F U | U T F;X
O E F T | T E O;F
T A M O | A T O;M
U E F O | U E F;O
Q C H K | K C Q;H
F B O Z | B O Z;F
K G I M | I M K;G
Y E T I | Y E T;I
Q B S K | S B K;Q
S F B G | B F S;G
U T Z X | U T Z;X
P F Y B | F Y P;B
P U M O | M U O;P
J Y F W | F J W;Y
U S Z E | E Z U;S
H D Y J | Y J H;D
V K N L | V K L;N
Y X F E | E Y X;F
U H N R | R N H;U
Y S J U | U Y J;S
L C Q S | C Q S;L
C L X U | U X L;C
E C J I | E I C;J
A M W Z | W A Z;M
O A T E | T A E;O
Q Y V S | Y Q V;S
Q J I B | B I Q;J
L B K A | A K B;L
S G D M | G M D;S
P X J V | P X J;V
C U A B | A C B;U
U N S C | S U C;N
C T K G | G T C;K
Q X S E | X S E;Q
V X A S | A S X;V
C Q V I | Q I V;C
A O U F | A U O;F
L H S P | L P H;S
B F P D | B F P;D
U C M X | M U X;C
V A Q Y | Q Y V;A
A W X C | X C A;W
Q B K U | B K U;Q
V B N C | C V B;N
C H Q K | K H C;Q
U B Q L | B L Q;U
Y T S W | Y S T;W
T M P W | M P T;W
P Y S K | Y K P;S
V M Q F | M V F;Q
O H S F | O H F;S
M W O X | W M X;O
S T E C | T S C;E
M Q B A | A Q B;M
Y L J S | Y S J;L
Z F B K | B K Z;F
D S L C | L D C;S
D M H R | H D M;R
K H L M | H K M;L
W M O V | V W O;M
N T Z M | Z M T;N
F Y K U | Y U F;K
F Q E L | L Q F;E
J W R E | J E W;R
O Q M H | H Q O;M
X L M U | X M L;U
J Q R H | J H Q;R
T F S Q | S Q T;F
C J N W | J N W;C
Y R I C | R Y C;I
A M O X | O M A;X
K P M S | K S M;P
H J U T | T J H;U
Q I E L | L E Q;I
E H S W | W S H;E
U T F P | F P U;T
A R P W | P R A;W
J K E F | J F E;K
G L R O | O G R;L
D R G A | R G A;D
B Z W E | W B E;Z
N P B A | P N A;B
O H T K | O K H;T
U Z E R | U R E;Z
W I B R | B W I;R
C N B E | E C N;B
K H D G | H G D;K
R A Z F | F R A;Z
U M X L | X L U;M
H B E K | K B H;E
K Z U J | K Z J;U
L X I W | W I L;X
L E U V | U V L;E
G S U W | G S U;W
N D R P | R N P;D
O F T E | E O T;F
P K B G | G B P;K
G O S T | T G O;S
Z A L K | K A L;Z
O W X B | B W O;X
R D Z O | O Z D;R
K U I Q | U K I;Q
W E M A | A E W;M
P K U O | K P U;O
G O I J | I O J;G
A B D M | M A B;D
T B V C | V B C;T
J A I V | I J A;V
Z D Q E | Z Q E;D
K R M N | K N R;M
F K J Q | K Q J;F
P A S E | E P A;S
T X Z O | O Z X;T
S U C X | U X S;C
P R X F | X R P;F
T H Q I | H Q T;I
L O Z N | N L Z;O
M Q R L | Q M L;R
O P X N | X N P;O
U A T E | T E U;A
K A W G | W G A;K
G V T K | T G V;K
R P M V | R V P;M
B S C F | C S B;F
B Q V S | S Q B;V
A I R O | O I R;A
F V J T | F J T;V
V K Z N | N Z V;K
P T M G | M T G;P
D L Z Q | D L Z;Q
U N S L | S L U;N
V X L Y | V Y X;L
S O A Q | A Q O;S
P T F K | P K F;T
E Q N B | E Q B;N
F B O P | P B F;O
F H N G | G N H;F
A N F M | N M F;A
A Y H Q | Y A H;Q
A R D B | A D B;R
L F B W | L W F;B
G M Z F | G Z M;F
R C S L | L C S;R
N L E A | E N A;L
P U X N | N X P;U
F J X K | K J X;F
C L V T | L V C;T
C I X D | X I D;C
H N F C | F C H;N
A S R T | R T S;A
D A M E | E A D;M
G Y M E | M Y E;G
G I S R | R I G;S
O B U I | B U I;O
T U V J | J V T;U
D O B G | O G B;D
U E Y R | E R Y;U
D A I Q | I D A;Q
E I D T | D E I;T
P K O W | P K W;O
S P N Y | Y S N;P
C R Y N | Y N C;R
L N R D | D R L;N
K F S H | H S F;K
D J C W | J D C;W
N W U T | U T W;N
M C Y E | E C M;Y
Q V E J | Q E V;J
N A L S | S L A;N
M T Q O | M O Q;T
B F D S | D F B;S
M P E S | E M P;S
C O M X | X C O;M
O C P W | W P C;O
I C F E | E F C;I
T H G P | T H G;P
N O I D | O I D;N
P O E V | E P O;V
H U J E | H J E;U
D Z E R | R D Z;E
X G I Z | I G Z;X
V K Y L | K V L;Y
S T I B | B T I;S
B W V K | W B K;V
C S I O | O I C;S
F M A R | A M F;R
W M K I | K W M;I
J T E X | J X T;E
S J A N | J N A;S
U O E C | O U E;C
V K P X | K V P;X
Y I T M | I Y T;M
W E G Z | Z G W;E
I C G H | C I G;H
A R P I | A P R;I
G E W F | G F W;E
H O M P | O M H;P
C W X T | C T X;W
W Z Q R | Z R Q;W
C M R V | M V R;C
S E H T | E S H;T
B L H P | P H B;L
U O H S | U H S;O
Q X R J | J Q R;X
D L F H | F D L;H
G M L S | L M G;S
P G R N | P G N;R
D M C I | I M C;D
U X J C | X C J;U
U F E T | F T E;U
C R P H | H P R;C
I Q M V | M Q I;V
C E G Z | G E Z;C
E J F L | F L J;E
T A D G | T D A;G
V I Z Y | Z V I;Y
B H U X | X B H;U
D B T A | A B D;T
E V O F | E V O;F
R Z C A | Z R A;C
Q B A N | B Q N;A
Y D Q A | Q A Y;D
M D J K | J M K;D
V D E F | E F V;D
T J L M | M L J;T
W N L P | P N W;L
B F W I | I F W;B
U O M W | U O W;M
O H N K | K N H;O
U P Q V | U P V;Q
T Y O E | T O Y;E
N D Z X | X N D;Z
K U O I | O I U;K
T W S Q | W S Q;T
U Z M R | Z M R;U
R N G P | G N R;P
U T Q G | G T U;Q
V A W Y | A W V;Y
Z Y K D | K Y D;Z
U J F Q | F U Q;J
U E T G | E T U;G
K J G E | K G E;J
Q B R Y | R Y B;Q
G V M E | V E G;M
C A S J | S A J;C
Y G E T | Y G E;T
V C W A | A V C;W
B F Z Y | F Z B;Y
D H E S | H E S;D
W F A D | W D F;A
R Z L V | L V R;Z
O C Z T | O Z T;C
T R P G | G R P;T
I S Q M | M Q I;S
K C X I | K C X;I
A T Q N | T Q N;A
Z W Q B | W Q Z;B
R I N F | R F I;N
X A B V | B X A;V
R W G V | G R W;V
G D Y V | G V Y;D
W Z Y J | J W Z;Y
K O X M | K M X;O
G T D W | D T W;G
J A G W | J A W;G
Z R N L | N R L;Z
K P B E | K B E;P
Q R L P | P R L;Q
M J Q X | M J X;Q
F I L G | G F L;I
N T B I | I N T;B
F T R Q | T Q R;F
W K S M | W M K;S
H U C N | H C N;U
P W R V | P R V;W
D A X I | A D X;I
Y D H F | Y D H;F
S F E V | F E V;S
C B T Z | Z B T;C
X D Y S | D X S;Y
Z I S D | I Z D;S
N I S Z | Z I N;S
K T U S | U T S;K
W X P E | X E P;W
Z R T I | T I R;Z
V C B K | K V C;B
C X U E | U C X;E
G N C Q | N G C;Q
W L A M | W A L;M
I F Q H | F Q I;H
I B C L | C B L;I
G H K R | K H R;G
E Q C N | N E Q;C
V F L X | L X V;F
P H A T | T H A;P
K B P T | T B K;P
K W L H | K W L;H
D S O Y | D S O;Y
D Z H F | F H D;Z
G V A K | G K V;A
S M Y N | Y M N;S
S P M A | P S M;A
G V Q R | R Q G;V
N H G E | N E H;G
I V Z J | I Z V;J
I C P D | P D C;I
L N B S | N B S;L
N K Q C | C N K;Q
T D U Z | T U Z;D
X F T B | F T X;B
R X W M | W M X;R
P V X E | P V E;X
E Y P T | P E T;Y
J K L Y | Y K J;L
H Q O J | J Q H;O
S Y O N | O N Y;S
Q O H D | H O D;Q
W A V Z | W V A;Z
H B V R | R V H;B
W V K T | T V K;W
I H F Z | F Z I;H
G A Y R | R Y A;G
G K B A | G A B;K
M U R L | R U M;L
J N D W | W D J;N
Y G X L | G L Y;X
F R O U | R U O;F
P U N T | U P T;N
B S H N | S H N;B
Q Y N U | U Y N;Q
B Y R S | Y R B;S
L J H R | R L H;J
A T O J | A O J;T
Y Q N H | N H Y;Q
D Y R B | Y D B;R
R B L D | B R D;L
L Q A P | Q A P;L
H E Z I | Z H I;E
V X C W | C V W;X
N D B M | B N D;M
W S Q N | N Q S;W
E J M V | E M J;V
J O K Q | Q K O;J
Z E K W | W E Z;K
B P M Z | P M Z;B
E P V L | V E P;L
B N D Z | D N Z;B
I E M J | E M I;J
D M H W | D M W;H
T K D F | T F D;K
X P B J | X J P;B
C P Z N | N Z C;P
Z J F R | J F R;Z
B K S P | S B K;P
Z I G X | I Z X;G
U T S H | U S H;T
G J U Y | G U Y;J
X K U F | K U X;F
I T M Z | T Z I;M
V Y I W | W V I;Y
P D K U | D U K;P
U T J R | U T J;R
R Q S F | F R Q;S
H Z S A | S H A;Z
G K B J | G J K;B
W I L U | L U W;I
G J O T | G T O;J
L C M F | M F C;L
H M P U | H P U;M
D A Y V | Y V D;A
W C B Y | W C Y;B
E O N Q | N O Q;E
O K Z F | F Z K;O
K Z R H | H R Z;K
H K N V | K V N;H
T S Z H | H Z S;T
T X O G | T G X;O
S A O N | O S A;N
L I H T | H I T;L
S A C I | A S C;I
X R W T | W R X;T
B U T I | T U I;B
G L I S | S I G;L
J T G S | G S J;T
Q Y V O | V O Q;Y
Y I S N | I N Y;S
Y A Q P | Y A Q;P
Z A O P | Z A O;P
O A W H | W A H;O
I K J M | I J K;M
N I W C | W C I;N
A J F C | C A J;F
X V L U | X V L;U
K R G Y | R G K;Y
Q T X U | Q X U;T
F M Y I | Y M F;I
G N X B | N B X;G
D O Z F | F D Z;O
D O G S | S G O;D
M D B X | B X D;M
Y Z N X | N Z Y;X
M A B E | M A B;E
D I X C | X C D;I
D P X E | E P X;D
V X L Q | L V Q;X
T W R Y | T R Y;W
Y Z C T | C T Y;Z
D B C H | D C B;H
L X Y T | X L Y;T
R C D X | C X R;D
D A N Q | D N A;Q
A R W S | R S W;A
P A M J | A M J;P
X S M U | X U M;S
B L M E | E M L;B
L G Y R | Y L G;R
I N S Q | N S I;Q
J P I B | B P I;J
M S P G | M G P;S
U T I R | U R T;I
O R W P | W R O;P
O P J R | J R P;O
W R B O | O W R;B
E W Q A | W E Q;A
I H Z N | N I H;Z
E R X A | R A E;X
F H U V | H F U;V
H E C B | B E C;H
T J C S | T C S;J
E Q V L | V L E;Q
O N Z I | I N O;Z
W A Y S | W Y A;S
S T P G | G P S;T
Q N T Y | Y N Q;T
W G P J | J P G;W
B E N Y | E B Y;N
J N O Z | O Z J;N
O Y D X | X O D;Y
J E T O | T J E;O
K A U B | K A U;B
P A D I | A P D;I
Q L E D | Q D L;E
V Y Z A | V Z Y;A
W H I T | T H W;I
P R Y C | C Y R;P
C M X O | O X M;C
X W D Y | X W Y;D
I E X V | X V E;I
D G H M | D G H;M
Y X R E | E Y R;X
O X A M | M X A;O
D Y P O | D Y P;O
D E S B | D E B;S
U K D E | U D E;K
G K S B | S K B;G
G J D E | E G D;J
J O C B | O B J;C
H S D Z | Z H S;D
J B F Q | Q F J;B
Z B U C | U B Z;C
O Q C W | O W C;Q
P A Q K | Q P A;K
Y L A D | D Y L;A
C P I E | I C P;E
S N F V | V S N;F
I W L M | L I W;M
Y S X A | Y A S;X
U G R V | U V G;R
H W Y K | H W Y;K
Y F A L | F A Y;L
X V S U | U X V;S
I S W L | I L S;W
N H P S | S P N;H
G M A B | B M G;A
M Y Z H | Z M Y;H
J Q Y N | Q Y N;J
X L M K | L X M;K
E N G V | G V N;E
N S P T | P T S;N
V Z B N | N V B;Z
S M T L | S T L;M
J Y U D | Y U J;D
M P H W | W M P;H
N H Y G | N Y H;G
C S L I | C L S;I
L S M A | M L S;A
L I T P | P L T;I
Q I L A | I A Q;L
P I H B | P H I;B
S N J Y | Y N S;J
C S W Z | S Z C;W
Y R B D | R Y B;D
I H K O | I K H;O
B L E S | L S E;B
S W M A | A M S;W
P M Z I | M I Z;P
A Y Q S | Y A Q;S
D Y W V | Y W D;V
B Z T Q | Z B Q;T
Z J K I | Z J K;I
R W C P | W P R;C
J W K E | J K W;E
V K F N | N V F;K
V N I M | I N V;M
N F Y O | O Y F;N
R F O B | F R B;O
O S M V | M V S;O
Z U T J | J U T;Z
G J B P | B G J;P
T V Y X | Y V T;X
C B A V | B A C;V
X L W S | W L S;X
E Z K M | M Z E;K
W Z O A | Z O W;A
N D U L | D N U;L
X A E G | G A E;X
H Y A G | A Y H;G
N C O E | C N E;O
B T N L | T L B;N
I Y H F | H I F;Y
Q F G N | N G Q;F
E K H D | D E H;K
D H T V | D V H;T
D E J U | E J D;U
R K I T | I K R;T
T U V H | T V U;H
J F V N | N J F;V
Y F Z E | F E Y;Z
M B Z X | Z X B;M
E M F S | M E F;S
J X V W | J W X;V
A D B S | D S A;B
Y V L W | Y V W;L
V K R Z | Z R K;V
N R A D | R D N;A
N Y A Z | A N Y;Z
O J T V | O V T;J
C K X R | C X R;K
Q B V W | V Q B;W
Y L P H | L Y H;P
R W C Y | Y R C;W
W T R C | C W R;T
B S O U | U S B;O
R K H S | K H S;R
A B Q G | G B A;Q
Z O B M | O Z M;B
X O Y I | X I Y;O
E Z F G | F G E;Z
K C F M | F C M;K
V Y S K | V S Y;K
Y S J Z | Y Z S;J
C O A H | C A H;O
H T O Y | O H Y;T
B E Z H | Z H B;E
D Z M S | M S Z;D
Y G O M | Y G M;O
D Q X Z | Z X Q;D
D G M N | D N M;G
H D W L | L W H;D
L W M P | L M P;W
Q F K L | F Q K;L
S W J V | W J V;S
B T F D | D T F;B
W O R Y | W R O;Y
A C O K | O A C;K
T W Q Y | T W Y;Q
X R V Z | X R Z;V
C N B V | V C N;B
B X Q W | W X Q;B
E G J S | G S J;E
P B J R | B R J;P
M S A K | S K A;M
H V R W | V R W;H
O B P J | B J P;O
P R F E | F P R;E
Z C Y S | Y S Z;C
E N J T | J T E;N
R H Q G | R G H;Q
J X L D | X J L;D
A N J S | S J A;N
A U H Y | A U H;Y
V N O I | N V O;I
M V E X | X M E;V
B Z C V | Z V B;C
C V N A | A N C;V
W K I U | I K W;U
A L G D | L G D;A
A C X Z | A Z X;C
Q M W B | Q B W;M
K N S Q | S K Q;N
O B M K | B K O;M
D P J O | D P J;O
O X A H | O H A;X
K T Z S | Z T K;S
A T Z Y | A T Z;Y
R V J N | V J N;R
G B M W | B M G;W
M A G T | G M T;A
P I D H | H I D;P
J P Z C | C J Z;P
B I Z V | I V B;Z
C L Z X | C X Z;L
C Z U G | C G U;Z
D I U Q | Q I D;U
W D T Y | Y T D;W
C I X P | X I P;C
Z W R C | W C Z;R
C X K Y | C X Y;K
W R F E | R W E;F
Y Q D F | Q Y F;D
B H J G | B J H;G
P N J I | P N I;J
W Z V X | X W V;Z
B X V E | B X V;E
A E W N | E N W;A
L S P H | L P S;H
S U Y D | Y S U;D
V Y M Q | M Y Q;V
V H T L | V L T;H
Q F R U | F R U;Q
I T C D | D T C;I
I O Q R | R O I;Q
K Z C I | Z I C;K
P X M U | U P X;M
U W O P | W O U;P
K V D N | V K D;N
E V R J | V R J;E
O I D G | O I G;D
F N I A | N A I;F
O K B Y | O B K;Y
Z S B D | D Z B;S
O X P U | O U X;P
M I X V | I V M;X
G I P O | G I O;P
C R O M | R C O;M
E O H U | O H E;U
T C S F | F C S;T
Z A S I | I Z A;S
P S Z R | S R P;Z
B V G O | G V O;B
T Z I D | Z D T;I
I W S Y | S W Y;I
U M Y L | U Y M;L
Q H Z K | Q Z H;K
V F M D | V M D;F
I A W Q | A I W;Q
Y R W J | Y R J;W
A D U F | U F D;A
L W H S | H L S;W
R J P U | P U R;J
S D H R | H D S;R
A Y M T | A Y M;T
Y Z D K | K D Z;Y
Q B W J | W J Q;B
Z W I Y | Y I Z;W
J B F L | F J B;L
W Z N U | N W Z;U
O M Y Z | M O Y;Z
C J E B | C B J;E
I B R K | R B K;I
Q C B P | Q C P;B
U L Q G | U L G;Q
Z M L C | C M L;Z
Q Y F N | Y F Q;N
U I W A | U W I;A
I Z N P | Z P I;N
G O X A | O X A;G
T F E V | F T V;E
T N Q H | T H N;Q
E O D T | O D T;E
C Q S P | Q P C;S
H N K G | G N H;K
P M Y Q | Q P M;Y
Z H D J | J Z D;H
E S O R | R S E;O
F C X Y | F Y C;X
M S X Y | S X M;Y
I H Q T | I Q H;T
E Q W S | W S Q;E
C Z V S | V Z C;S
G M J W | G J W;M
S I K N | I K N;S
V O F B | B O V;F
Z D H X | H D X;Z
O F H B | F O B;H
U M V P | M V P;U
R Q H F | H Q R;F
W D L Y | W D L;Y
L D N Y | Y D N;L
T W P H | P T W;H
C Q B I | B C I;Q
L O P U | O P U;L
W Q H M | W M Q;H
Q N A K | Q N A;K
C B A I | A B I;C
Z K O D | D K O;Z
O S G E | O E S;G
F I A Z | I Z A;F
B P T H | T H B;P
B Q E T | E Q T;B
N X D L | D X N;L
K N R C | K R C;N
Y W F K | F Y K;W
A T B O | A O B;T
I N C F | N C F;I
P L J S | L P J;S
X I L Z | L X Z;I
O U H X | H X U;O
W E C N | C W N;E
G J I T | I T J;G
U G J S | S G U;J
B Y S T | Y S T;B
Y C W R | C R Y;W
I Z A J | A I J;Z
E O C J | E J O;C
M O X V | O X V;M
B N H G | B G N;H
T N Y Z | N Z T;Y
L P F C | F C L;P
K O R N | O K R;N
L T Z D | L T Z;D
A M V U | V M U;A
M I R D | R M I;D
K O V E | V O K;E
P J A G | G J P;A
Z B I C | B C I;Z
N M D W | N D W;M
T H Z E | Z T H;E
W Z P R | P W Z;R
A E I N | E I A;N
U Z P M | Z P M;U
Q X U J | Q U J;X
C K O I | I K O;C
G O E J | E O G;J
I D Z U | I U Z;D
J N K I | I K J;N
K D S I | S K D;I
T C G J | J G T;C
Y M L R | Y L R;M
F K E Y | Y F E;K
Q I N Z | I Q N;Z
Q I V X | V X I;Q
J E D S | J S D;E
Z E Q W | W Z E;Q
O H A D | D A O;H
U F N I | U F N;I
L X C D | X D L;C
U O Y S | O Y U;S
C M D Z | D Z M;C
Y D F Q | Q Y F;D
I L Z R | L Z I;R
N E Y H | Y H N;E
B P L G | P G L;B
T W G H | H W T;G
P Q S J | J P Q;S
M H P R | R H M;P
Y H C S | C H S;Y
T J S A | A T J;S
F E X Q | F X Q;E
A E Y R | Y R A;E
O U W J | J W O;U
B W U C | C B U;W
V I Y O | V I Y;O
W O V N | W O V;N
U K V T | K V U;T
D K U I | U K I;D
T D C O | C O T;D
Z E R Y | Z R E;Y
F R N P | N P F;R
R W D S | D R S;W
Y U M D | Y U D;M
Y L F A | Y F A;L
Q P L T | Q P L;T
Z P R K | K Z P;R
B W O S | O B W;S
T S V X | S X V;T
C F O X | F C O;X
K W I Y | K W I;Y
K I W A | W I K;A
F Z I O | F I O;Z
I F T N | F N T;I
C H I V | I C V;H
F S W I | F I S;W
K A L T | T K A;L
Y B O V | O Y B;V
C K S D | C S K;D
S C O J | S J C;O
G N A V | G V N;A
I J K C | J I C;K
F B E T | E F T;B
K D I H | K I D;H
J T V L | J T L;V
Z M G B | M G B;Z
K U E R | E R U;K
L S Y O | L S Y;O
I L O N | I O L;N
V S M A | A V S;M
E M L N | E N M;L
H V U J | H V J;U
G L F Q | Q F G;L
Z Y J L | J Y L;Z
P A L Z | L P A;Z
V X E T | V E X;T
Y M J H | M Y H;J
E G W Y | E G Y;W
O G Z Q | Z Q O;G
I J T S | T I J;S
I E F W | E F I;W
N R J X | J N X;R
Q L R F | R Q L;F
W A P I | A W P;I
J D Y O | Y O J;D
R W V G | V W R;G
M L A G | M G L;A
T O M E | O T E;M
E Q H X | H X Q;E
C S W O | O S C;W
T A I H | H T I;A
W K O H | H K O;W
K C P T | K P C;T
U X B G | G B X;U
F Y D E | E D Y;F
G A X J | J X A;G
O P N V | N P V;O
T K C M | M K T;C
Y T O I | I T Y;O
Q J B X | J X B;Q
A H B Q | A B Q;H
X A W Q | W Q A;X
N G J P | G N P;J
R Z H O | O Z H;R
Z S M P | M P Z;S
H N U D | U N D;H
B S P D | S D B;P
A G E H | H G A;E
K L S Y | Y L K;S
R W B V | W V R;B
Z N A X | N Z X;A
S N T C | S C T;N
W J S Z | J W Z;S
T Z F B | F T Z;B
L N J X | J X L;N
Q V S O | S O Q;V
Z J O L | L Z J;O
Y X T C | T C Y;X
H X A P | X A P;H
B Q E P | B Q P;E
D N L J | J N L;D
P W G E | G P E;W
I L W M | M L I;W
S R Z E | Z R S;E
M G L C | M C L;G
S E J W | S W E;J
O X G S | S O X;G
V A H Z | A V Z;H
C K G R | R C G;K
W T P N | T P W;N
Y C Z U | Y C U;Z
R K Z Q | R Z K;Q
E Y V I | Y I E;V
O J C N | O N J;C
U X B Z | U X B;Z
U Q Y G | U G Q;Y
J X P L | L J P;X
L E N B | N B L;E
H F V J | J F H;V
D I B E | E D I;B
D L P K | D P K;L
D X J E | X J D;E
M X K W | X K W;M
M C W P | C P W;M
D A L N | D N L;A
T D Z P | D Z P;T
E Q U T | E U T;Q
D H T O | D T O;H
K U V J | U K V;J
V H U A | A V H;U
V N J Q | J Q V;N
W D Z Y | Z D Y;W
X Y S P | X S P;Y
J E U B | U B J;E
C P Y W | Y P C;W
L N T V | T V N;L
P W N X | N W X;P
H E G W | E W G;H
C Y M U | U M C;Y
S F E B | S F B;E
R Y V H | Y V H;R
R S F X | X S R;F
C S X H | X C H;S
O P D R | P D O;R
F S P N | S P F;N
U H B F | U B F;H
V H F L | H V L;F
A N P B | P A B;N
C P K N | N K C;P
Q C A R | C R A;Q
L E F O | L O F;E
T J Z A | A J T;Z
X K B H | B K H;X
N K Z G | G Z K;N
S C D O | O S D;C
N D E Z | E N Z;D
N Z P X | Z P N;X
K O C N | N O K;C
R V D Y | V Y R;D
N O W J | O J N;W
H S Y X | X S Y;H
U C N I | I N C;U
J M Y F | F Y M;J
T F Z O | O F Z;T
I J R H | R J H;I
K G V Y | Y V G;K
H F M E | E H F;M
B K F P | F K P;B
Z U C T | C U Z;T
G B N W | B N G;W
E A C M | M E A;C
I Z H M | M I H;Z
A W O P | O P A;W
K U H Q | K H Q;U
Z Q T S | T S Q;Z
X O Z Y | Z X Y;O
R B J K | K J B;R
P I M V | M P V;I
M P L K | L K P;M
D E A T | T D E;A
E R T S | E T S;R
F S U I | S I F;U
N B K W | N K W;B
T R K H | H T K;R
K G D L | K G D;L
B X D K | B X D;K
I B K M | I K M;B
B G E N | G E B;N
I L D C | I L D;C
T J F V | F V J;T
F Q V L | Q F V;L
A L X E | E X A;L
A J Q O | A O J;Q
L P R Q | L R Q;P
Q P W J | W P Q;J
F X I D | X F D;I
D P N A | P D N;A
F E C D | E C F;D
Q T H Y | Q Y T;H
Y J B T | T Y B;J
L Y U S | S L U;Y
A P H M | H A M;P
T J E X | T E J;X
P A Y G | A G Y;P
J T G C | C G J;T
J N H T | T J N;H
J T I S | S J T;I
Y E Q T | T Q E;Y
H J F V | F J V;H
T N D M | M D T;N
I G J H | J H G;I
F Q C U | F Q C;U
X A I C | X I A;C
J E X Y | J X E;Y
P S D Z | Z P S;D
V M O Y | O Y M;V
O E K C | C O K;E
D E L K | K E L;D
D N X L | D L X;N
L Q I V | I V Q;L
Z P C W | W P Z;C
F A P Z | F Z P;A
W T R Q | T W Q;R
Y K N C | Y K N;C
V L F R | R F L;V
V W A Z | V W Z;A
O X V L | X V L;O
C Z T W | C T W;Z
U X A Z | U X A;Z
A D G K | K A G;D
C G V Q | G C V;Q
J D H V | D V J;H
X B A Y | A B X;Y
C R O Y | C O R;Y
J C U Y | J Y U;C
W O M J | M J W;O
K F Y A | K Y A;F
A Z H W | A H W;Z
I J B X | B J I;X
N Z L T | T L Z;N
Q O B D | D O Q;B
Y K T P | T Y K;P
P E O G | P G E;O
U K F S | F K U;S
P D G W | W G D;P
W O D X | W O X;D
L C F B | B C L;F
J S Q V | J S Q;V
I Z Q O | O Q I;Z
Z Y V U | U V Y;Z
K N L S | K S N;L
K M N Z | M Z N;K
Z P S F | F S Z;P
B T M R | R T B;M
I M R D | M R I;D
Y R K T | Y R K;T
Y Q R D | D Q Y;R
T G C S | C T G;S
O Q G S | G Q S;O
G N V D | G D V;N
Z P R V | R Z V;P
O X B W | X B O;W
E I Q F | I Q E;F
Q P W Y | Y P Q;W
G L K I | L G I;K
G W H P | H W G;P
E W I A | E I A;W
V L X O | L X V;O
Q S C E | E Q C;S
Q F Y W | Q W F;Y
T R H D | H T R;D
T A R E | E R T;A
E K W S | W K E;S
V B Y N | B V N;Y
U H E F | H U E;F
R N D V | D V R;N
B F E M | B M F;E
Q J I K | J K Q;I
I H G A | G H A;I
B C T I | T I B;C
S J A P | S A J;P
E J D X | D X J;E
C J V U | V C J;U
A J S V | V J S;A
L I G B | G I B;L
C M K O | K M C;O
T J U R | J R T;U
V P H N | V P N;H
U S Z Y | Z S Y;U
Z G K Y | G K Z;Y
J W B R | R W J;B
Z X K U | X U K;Z
O M F A | O M F;A
T W Z U | Z T U;W
T Q J G | T Q G;J
X A G F | X A F;G
B R Q T | Q B R;T
P O U N | U O N;P
F H B T | T B H;F
K C R S | C K S;R
A Y W L | Y L W;A
A R B I | A B R;I
S G U P | G P U;S
X E Q R | E Q X;R
C O R S | C O R;S
P Y T G | P Y G;T
B O S W | S W B;O
Y M N B | N M B;Y
F O E W | O E W;F
O Q X G | G X O;Q
N D T E | T E D;N
Z V F N | V Z F;N
U J N F | J N F;U
Z P V L | Z L P;V
J P O I | I P O;J
Q M N L | M L N;Q
C Y O Q | O Y Q;C
F X P K | K P X;F
K B T V | T V K;B
J I E P | J P E;I
C Z W K | W C K;Z
W N R V | N R V;W
W C V L | W C L;V
J Y E U | Y U E;J
F P Q D | D Q P;F
D Z S E | E D S;Z
E X I Q | Q I E;X
U S P L | L P S;U
S F A Y | A Y F;S
X P B Q | P B X;Q
M Q N C | N C M;Q
K N A Z | Z N K;A
V N R G | V G N;R
O X M K | M X O;K
V E I B | I E B;V
F V M G | F M G;V
S T A K | A T K;S
D U G T | T U D;G
B Q G N | N B Q;G
V D Z X | Z D X;V
Y R L A | A Y R;L
G Q V T | Q G T;V
U N M S | N U S;M
T O G D | O T G;D
I A N M | A M N;I
U B N T | N U B;T
Q S K C | C Q K;S
Z N C U | N U C;Z
N Y M W | M W Y;N
W E Q D | Q W E;D
H F T V | H T V;F
R E B W | W B R;E
P E A T | T A E;P
Y M R L | Y M L;R
K Q X M | M X Q;K
A G M Z | G Z M;A
N C I S | C S N;I
U S C M | M S C;U
S K Y R | R Y K;S
G F W B | F G B;W
J D V K | V K J;D
S F O G | S G F;O
L Z Q W | W Z Q;L
K N G X | G X K;N
X G I S | X I S;G
B F D Z | D F Z;B
N K T J | K T J;N
G A U W | A W U;G
V D S I | V I D;S
X N T C | X C N;T
F C V K | C K F;V
S X A M | M S A;X
W Z P N | W N Z;P
R G L A | R A L;G
D B L S | L B D;S
Z T B I | I B T;Z
Z C A J | A C J;Z
X L Q V | V Q X;L
Y D S L | D S L;Y
P M B E | P M E;B
I B C H | H I C;B
J N F D | D N J;F
F M X L | L F M;X
A F H O | O A H;F
H U Y I | H Y I;U
K W F M | K M W;F
H C B A | B A C;H
L P A D | A L D;P
K R V B | R V B;K
B I T Y | B Y I;T
M W P D | W D P;M
E L F G | L G F;E
L Q F J | F J Q;L
S R J I | S R I;J
P H J N | H J N;P
K G S B | G K B;S
B L Z Q | B L Q;Z
V L F G | G L F;V
Y D J B | D J Y;B
I U N J | J U I;N
X E T L | L X E;T
G X Z Y | G X Y;Z
W N D Q | N Q D;W
N R Y A | N A Y;R
Y K U R | U K Y;R
V K U G | K V U;G
K X R A | A K R;X
M S G F | M S F;G
F T E U | U T F;E
D U V J | J V U;D
A C T X | T A X;C
P E V N | P N E;V
K U B V | B U K;V
P Q T V | T Q P;V
Q J H Z | J Z Q;H
S A E J | E A J;S
Y I D Z | I Z Y;D
B C O Y | C B O;Y
W I Z N | Z I N;W
V W X H | H V X;W
M C K X | C K M;X
W N R V | R N V;W
M D Q X | D Q M;X
H Q P J | H Q J;P
M W Y Z | W Y Z;M
D E Q K | D E K;Q
P T O H | T H P;O
W D N X | D N W;X
Q N A X | X N A;Q
M L T W | T W L;M
K I Y F | Y F I;K
C X I B | X B C;I
B D T N | D N B;T
H O D J | D H O;J
Z S N G | G N Z;S
B O R U | R U O;B
G X S I | I X G;S
P T G Q | T P G;Q
G P X H | X P G;H
B Y G J | G Y B;J
C N K B | C B K;N
M O P G | O G P;M
X F T P | F T X;P
X M V Y | X V M;Y
C T O I | I O C;T
X J Z Q | J Q Z;X
X J P L | X P L;J
H O L V | V O L;H
O W V N | W O N;V
F T L M | M F T;L
P L S X | S X P;L
Q R Z P | P Q Z;R
B J I R | R J B;I
N C Z Q | Q C N;Z
I L C P | P C I;L
U L W O | U L W;O
F R U I | U F I;R
H P O E | P H O;E
L P J A | P L A;J
I P G O | P I O;G
L N H W | N W H;L
A W S K | S A W;K
K R C A | K C A;R
J O I V | J I O;V
Q O E H | E O Q;H
A Q D N | D Q A;N
M H K A | A K H;M
X I P J | I P X;J
U Y C L | U Y L;C
O E Z G | E Z G;O
V Q Y U | U Y V;Q
X M W Z | W X M;Z
Q B A C | A Q C;B
R L C H | R H C;L
V X G E | E X V;G
H T V G | G H T;V
M Q N I | M I N;Q
G D W R | D R G;W
F Q E P | E F P;Q
E F T U | T F E;U
O S V K | O K S;V
Y L E D | D Y L;E
O U E J | O E J;U
X W S P | X P S;W
R Y L H | Y L R;H
L F J E | E J L;F
M G R S | M S G;R
Y G R L | G Y L;R
C G W B | C G B;W
O T J V | J T V;O
H U T R | U T R;H
D E N X | N E D;X
R X S Y | S X Y;R
B Q P T | P T Q;B
C I P H | P H I;C
P M B U | U B P;M
E M G D | G D E;M
X N Z T | T N X;Z
A L R O | R L A;O
Q O L S | Q L S;O
C I W U | I W U;C
P N C A | P C N;A
T M K Y | T M K;Y
V G F U | G U F;V
T E K J | E T K;J
B R A D | A R B;D
W S C A | S A C;W
I O J Y | J I O;Y
O J N Y | J Y O;N
Y C K Z | Y K Z;C
E K Z A | A Z K;E
H D A Q | Q H D;A
E R Z Y | R Z E;Y
W Q Y J | J Y W;Q
S A I N | A N S;I
U N X V | N X V;U
O G B A | A B O;G
E U G C | G U E;C
Z S Q U | U Z Q;S
X G T F | G T X;F
C D G Z | C G D;Z
U Z S T | Z S U;T
Y B H V | H V B;Y
T Z L D | T L Z;D
Q H C Z | Z C Q;H
K C P V | V P C;K
U Q N F | N F Q;U
F K L Z | K Z L;F
X D W V | X V W;D
J D F P | F D J;P
I W C G | C W I;G
X Q O N | N O X;Q
Q M G W | W Q G;M
E Z U G | G Z U;E
P N B J | B N P;J
Q D F P | Q F D;P
Z T K O | O K T;Z
F P D Q | F Q P;D
F B M G | G M B;F
T X Y G | G Y T;X
G W F M | G W M;F
S J B L | L S B;J
D M G R | R D M;G
I P T L | T I P;L
O U N Y | N U O;Y
X F G Q | F X G;Q
I F C G | F G I;C
B R H J | J H R;B
J T P N | T P J;N
T D P R | T D P;R
W Q N G | Q G W;N
H U C Y | U H Y;C
S U X K | S K U;X
E K S T | E K S;T
N Z K M | Z M N;K
A Z L K | L Z A;K
V W D Q | D V Q;W
V O M Z | V O Z;M
B X P Z | B X Z;P
T O M F | F M O;T
G I Z O | I O G;Z
O A P R | A P O;R
W N I K | W I K;N
C V S B | B V S;C
Y L G B | Y G B;L
I U B K | K I B;U
U X W Y | W U Y;X
O P Q M | M O P;Q
K D T C | C T D;K
W R G N | W G N;R
Z N K I | I N K;Z
A M Y H | Y H A;M
W J S A | J A S;W
M O B T | T O M;B
M K V C | C M V;K
G P C Y | Y P G;C
S U O D | O D U;S
G X Q A | A X G;Q
K C Z M | M Z C;K
Y B J D | D Y B;J
E H M J | E J H;M
E D I R | R E D;I
V G K A | V G K;A
C L D A | A D L;C
E A S M | S M A;E
N F C R | F R C;N
I S B T | S B I;T
Z U N C | N C Z;U
N D J H | N D J;H
L E C J | L C E;J
G J W C | C J W;G
E M H F | M E F;H
H A T N | T A H;N
N G B Z | G Z N;B
K T J A | T K J;A
C O L U | C O L;U
Z D I F | D I Z;F
H Q M I | M I H;Q
R W F P | W R P;F
R P Y G | P Y R;G
C N G U | C N G;U
P F H R | R F H;P
H Q J O | Q O H;J
R X I A | I A R;X
U D G C | D C U;G
Y H O N | H N Y;O
H A R J | J A R;H
Z F E M | M E Z;F
S W A T | A W T;S
B Z N D | N D B;Z
N X L M | X L N;M
M R X E | X M R;E
A P H Y | Y P H;A
W U R M | R W M;U
K W I Z | I W K;Z
J M D G | M D G;J
Z A H O | Z H A;O
R X C A | C X R;A
B C E G | C E G;B
A Q G H | A H Q;G
K W M X | M W X;K
V U K O | K V U;O
A W N S | W N A;S
Y H Z K | H Z Y;K
N J T F | F T J;N
W K D Y | W D Y;K
I F Z L | I L F;Z
H I K S | I K H;S
M B O W | B M W;O
F X W C | X F C;W
W I M L | I L M;W
X C T Z | T Z X;C
S Y M Q | M Y S;Q
L N X B | X B N;L
U W T Y | U W Y;T
Q G P C | C Q P;G
H Q Z M | Q M Z;H
I R O T | O R I;T
Y O F B | O Y F;B
Q B V F | Q F B;V
Z I B G | B I G;Z
D R F A | A R D;F
X F B D | X F D;B
W O S U | O S W;U
P M T D | D T P;M
Z G W V | V W Z;G
S O V H | S O V;H
Z Q P W | P Q Z;W
G P M Z | Z M P;G
C V M H | M H V;C
S N Q C | Q N C;S
V X N H | H N X;V
T U R Q | Q U T;R
S F C T | S C F;T
J X S H | S H J;X
P Z Q W | Q W Z;P
S M G A | M G S;A
V R X I | I V R;X
Q R P M | Q R P;M
V B A L | A B L;V
D Y M V | M Y D;V
B V O X | X V B;O
O Y C W | C W O;Y
C E N V | C N E;V
X V E P | X P E;V
T Q H X | X Q H;T
B L Q R | Q L R;B
E M X L | E L X;M
E K J P | J E P;K
D O G Y | G O Y;D
Y I D M | Y M D;I
W Y D Q | Q W D;Y
L O B A | B O A;L
K H C I | H C K;I
Q S K M | M S Q;K
R S N O | O S R;N
L R E S | S E L;R
T Q I M | Q T M;I
N G D J | G J D;N
X I Y L | X Y I;L
L V F G | F V G;L
F D P G | P D F;G
N Y R S | S Y R;N
V W U F | V F U;W
S K X Q | K Q S;X
C A R V | V C R;A
W I G O | G I O;W
E N C Z | C E Z;N
O A K S | S K O;A
J P H K | P J H;K
Y U M E | M Y U;E
K J G B | K G J;B
C P G V | C P G;V
A D W Q | A D W;Q
R W L D | D L W;R
C L R B | B R L;C
M D C E | E D M;C
Z A V W | V A W;Z
N J R W | J W R;N
O K D E | D E O;K
E N L X | N L X;E
U Z P R | P U Z;R
S Q D X | X D S;Q
K V N S | V S N;K
B T Q C | T Q B;C
L J O N | N J O;L
T Y G B | Y T B;G
P O H E | H O P;E
X V O J | X V O;J
I L B V | V I B;L
C D L N | C N D;L
L M I F | I L M;F
R Q Z C | C R Z;Q
B I Z U | Z I B;U
H K Q B | B Q H;K
T L S E | E T S;L
K W Q H | W Q H;K
W D S M | W S D;M
L O X M | L X M;O
M R F O | M R O;F
B A D E | E A D;B
N K X D | N X K;D
L Z M F | M Z F;L
U H F E | F U E;H
N G T C | T C G;N
G H I E | G H E;I
I P U S | U I P;S
T I G S | S G T;I
I C Q O | C Q O;I
C X F K | K C F;X
D W B C | C D W;B
H I B V | V I B;H
D N T K | T D K;N
A J C X | C X A;J
F N S I | S I F;N
T C Y M | M C T;Y
C B D L | C L B;D
Y V X H | Y H X;V
K E B A | A B E;K
J K Z E | E Z J;K
R N G U | N G R;U
T I U W | W U T;I
I L N D | N I L;D
B R P K | K B P;R
A L R X | R A X;L
D H I O | I O H;D
H J Y A | J Y A;H
N Q X T | Q N X;T
T R I J | J I T;R
P C R X | X C R;P
Y L U A | A L Y;U
N F D L | L D N;F
B O K Q | B O K;Q
G I V D | V D G;I
N P H E | P H N;E
N F L M | L F N;M
Y R O G | G Y O;R
A U T K | A K U;T
W F G X | W X G;F
N I J P | J N I;P
I W G J | W J I;G
C X O N | O C X;N
H B K A | B H K;A
U B V X | V U B;X
E R G X | G E X;R
U M V F | V U M;F
W C L I | L C I;W
O R T N | O N T;R
P L T V | V P T;L
I Q J B | I J Q;B
W X H Q | X H W;Q
S R N C | C R N;S
R F D C | R C F;D
X J H D | X D J;H
D L V E | E D V;L
B E G M | G B M;E
A R T Y | Y A R;T
S M I T | M T S;I
J B Y P | J Y B;P
R U S V | U S R;V
D K E T | T K D;E
I N O M | M O I;N
C P G B | P B G;C
X F E P | P E F;X
B E M A | E B M;A
N E M V | E M N;V
H P K C | P K H;C
K R G F | F K G;R
C D H J | H J C;D
W I M Q | I Q M;W
E D V T | E T V;D
X D B S | B D X;S
A L J F | J L A;F
J T H X | X T J;H
Z H R X | H X R;Z
Z X J L | J X L;Z
S Q M B | Q B M;S
L J D T | D L T;J
R K U B | U R K;B
D P T J | T P D;J
V F N D | V N D;F
S U L G | U L S;G
J Q W Y | Y W Q;J
T L D Z | L D Z;T
K M L D | M K D;L
U Y A Z | A Y U;Z
Z G U T | G T U;Z
H M R X | H M R;X
Y L Q T | Q T Y;L
J F L V | V L J;F
Z Y R F | Y Z R;F
N S Q P | S P N;Q
U G B C | G B C;U
X J S M | S J M;X
K T U L | U T L;K
K U Y V | V K Y;U
O R M Y | O Y R;M
T K F A | T F A;K
X E S L | E L X;S
C D A K | K A C;D
R V J S | J V S;R
B Q N K | N Q B;K
Z L T Q | Z L T;Q
F Q N D | N D F;Q
Y F O J | O Y J;F
F R Q D | R F D;Q
I X Y H | Y H I;X
W K F X | W F X;K
A N I S | A S I;N
B M T D | D M B;T
C T K V | K C T;V
G Q E I | Q G E;I
G Q I B | Q B I;G
Z W T A | Z T A;W
A C V G | G A C;V
Q X P Z | Q P Z;X
G F V O | O G F;V
Q R B Z | Q R Z;B
U N T Q | Q U N;T
Z N T U | U T Z;N
M E Y B | M Y E;B
F K M E | K F E;M
C V J F | V F J;C
Q M J S | S J Q;M
K Y O E | Y K E;O
E Z W P | P W E;Z
X C L S | X S L;C
C A T X | X T A;C
G P H O | P H G;O
F R W S | F W S;R
T X E U | U T E;X
B O P S | P S B;O
Y A F U | U A Y;F
Y U T S | U T Y;S
W U G B | G W U;B
V Q Z T | Q V T;Z
S F J T | J S F;T
D Z Q P | D Z P;Q
T L W U | U W T;L
P G M F | G M P;F
G C N S | N G C;S
N R D F | N F R;D
F B Z D | Z D F;B
R U S B | U R B;S
T L F H | L T H;F
L X G F | F G X;L
Q A Z H | Q H Z;A
K I T A | I T A;K
Y B P I | B Y P;I
F O X P | O F P;X
D K I F | F D K;I
W J N K | K W N;J
L R I G | L G R;I
Y Z J Q | Z Q J;Y
V U W Y | W U V;Y
J C E O | E O C;J
H C E M | C H M;E
P Z V Q | P Q Z;V
L M O H | M H O;L
R S K Q | R Q S;K
O U W F | U O F;W
F M U Q | M Q F;U
G E Q H | E G Q;H
A S J P | S P J;A
E O Z N | N Z E;O
D Q Y L | Q Y L;D
B I E K | I E K;B
M A D R | A D M;R
Y M O N | Y M O;N
D J X O | J O X;D
K E W F | W K F;E
H E I O | H I O;E
P M R K | R K P;M
M K H G | K H G;M
W C H M | W M H;C
H C Q G | Q C H;G
I U G J | I G U;J
Y G H B | H G Y;B
K X B R | R X K;B
Z P M Y | M Z P;Y
P Q B L | P L Q;B
Y I W C | C W I;Y
H Z T W | W H T;Z
M J E C | E C M;J
H X W L | H X L;W
Q M P G | M Q G;P
P R A F | F P R;A
I E Z U | U Z E;I
K T E R | K R T;E
N I L Y | I N L;Y
N J D T | D N J;T
V P M W | W P M;V
W Y J Q | J W Y;Q
L A T E | L A T;E
X K D V | D X K;V
D A R U | R D A;U
F L E Y | L Y F;E
P C J V | P V C;J
X C K L | K L C;X
R A M U | U M R;A
Y L G P | L P G;Y
T K L A | A T K;L
E B D R | E B R;D
S N A M | A N M;S
D F B K | B F K;D
W E X O | E W X;O
K F G Q | K Q G;F
E I M F | E F I;M
N B S X | X N B;S
H F W Y | W Y H;F
U G W Q | G W U;Q
U J X W | W J U;X
K G Y B | K G Y;B
V H X T | X H V;T
V Q T Y | V Y Q;T
U M X P | P X U;M
F C V S | F V C;S
C T B G | B T C;G
H Y I E | I H E;Y
S V H W | S V H;W
J R E M | R M J;E
H Q O V | O Q H;V
Q Z B L | Q B L;Z
N K E Z | K E Z;N
M E U B | M B E;U
S V K M | M K V;S
Q H W E | W E Q;H
L S C Y | Y S C;L
A U X S | X U A;S
L X B H | H B X;L
I U V O | V I O;U
X M G E | G X M;E
P J S W | P J W;S
Y B Q L | L B Q;Y
L A Q J | L A Q;J
E W D Z | E D Z;W
H J P S | P J S;H
G Y T M | M Y G;T
D O N R | D N R;O
S G F A | A S F;G
K B M A | K M B;A
P R J D | R J P;D
Q I L B | I B Q;L
P N W A | W P N;A
P R J A | A R J;P
F T Y H | H T F;Y
S J P A | S J A;P
P G T E | P E T;G
D Z H P | H D P;Z
W D Z C | D Z W;C
O F S D | F S O;D
Y G K T | Y K G;T
G M Y W | M Y W;G
J E Y U | U E Y;J
O G P N | P N O;G
R F A I | A R F;I
K E D O | K O E;D
O Q W R | R Q W;O
B L Z K | B Z K;L
B V J S | B S V;J
Z M R V | M R Z;V
H O L Q | Q L O;H
D Z F S | D S F;Z
Y C F X | X C F;Y
K J U N | N U K;J
S R E G | R S E;G
B J V P | B V P;J
S P D Z | S P D;Z
P Z T G | P G Z;T
P J F I | I F J;P
F T C W | F C W;T
U N D S | S U D;N
F E V Z | V Z E;F
E S C I | E I C;S
E Z M D | Z E D;M
G A T Q | G Q A;T
U T Y R | U R Y;T
Z U A B | B A U;Z
P W I A | W I P;A
D Y G J | J G Y;D
B O E V | V E O;B
O Q T X | Q T O;X
Y B H A | B Y H;A
E B J D | J B D;E
B N S P | P S B;N
R V Q I | R V I;Q
E J K B | E J K;B
O U L N | L N U;O
X C P I | C P I;X
C H L X | X L C;H
H T V P | H P V;T
Y U W T | U T W;Y
B E W U | W E B;U
P J D B | D B P;J
L Z H Y | Z Y L;H
B T V A | T A B;V
V Z T J | Z T J;V
X C F S | C X S;F
U E L O | L E U;O
U Q A X | A U X;Q
Z T B R | Z B T;R
A O N G | G N O;A
F Y E W | E F W;Y
Y J A D | J A Y;D
A Z N H | N H Z;A
L N R G | G N L;R
E M A T | E M A;T
M G T Q | T G Q;M
O S T R | O R T;S
R U N B | R U B;N
R E X P | X E R;P
H V X L | H V X;L
B X M Y | Y B X;M
F S X V | X F V;S
F D I X | I X F;D
N J O V | N V J;O
P Y K C | Y C K;P
J I M K | M I J;K
Y K E D | E K D;Y
M F K N | N M K;F
G A N B | B G N;A
W Y Q S | S Y Q;W
V R M A | M R A;V
O D K R | R D K;O
P H A L | A H P;L
D J G F | G D F;J
N P G A | N P G;A
N U H O | U N O;H
I C E Z | Z I E;C
C A U F | F U A;C
A S N F | A F N;S
R Z B O | R O B;Z
B H U Q | U Q H;B
Z N K S | S K N;Z
F I V H | V I H;F
Q P C B | Q C B;P
Z M H D | M D H;Z
N Z X O | N Z X;O
B L Z C | L B C;Z
S G P Q | S P G;Q
U F O M | O M U;F
N S E Y | N S E;Y
S R T J | S J R;T
F K Y X | X K Y;F
E U K J | K E U;J
B Y T A | A B T;Y
J X M P | X P M;J
R I V Z | V Z I;R
B Q V C | V Q B;C
I Y W D | Y W D;I
K X P L | L X P;K
M H W S | M S W;H
S T J P | J S T;P
D I E J | E J D;I
P X I F | X P I;F
U E D R | E D R;U
F N R G | G F R;N
N B M Z | B N Z;M
T C H Z | C T Z;H
N F B P | N F B;P
E M U L | E M U;L
G H L R | R L G;H
I A C G | I A C;G
F L C K | K F L;C
D O I R | O D I;R
O M E R | O M R;E
M L O A | M O A;L
E K Z C | E K Z;C
F C J V | C J V;F
A E J Q | E J A;Q
R D T F | D T R;F
I T H Y | T H I;Y
L X Q E | E L Q;X
P U S M | S P M;U
J B N S | N S B;J
Q F C V | C Q F;V
J K S Y | S Y K;J
B Q N W | Q B W;N
A X J T | J A T;X
K L R G | G R K;L
Q H D E | H Q E;D
Y S U V | U V S;Y
B O S K | K B O;S
P Z W E | W P E;Z
R N J A | N A R;J
K O G R | R O K;G
T Q N K | Q K N;T
B O D F | B D O;F
A F J E | F J E;A
F Q D V | Q V D;F
F P Y B | F P B;Y
F N M E | M E F;N
Y X Z A | X Z Y;A
U A G D | D A U;G
W F O E | E O W;F
W X U K | W X U;K
S O A L | A L S;O
Q D B S | B Q D;S
B X C R | C X R;B
Q D R L | L Q D;R
V D L E | V D E;L
K P R N | P N R;K
Y J W F | J Y W;F
J D V T | V J D;T
B H F P | P F H;B
V N Y S | S N V;Y
A M Z N | M N A;Z
O G Q T | O Q T;G
B N M Y | N B M;Y
L T Q U | Q T U;L
E C F D | C E D;F
C D U W | C U W;D
A Z P L | P A Z;L
D V P O | P O V;D
A V B Q | B Q V;A
V H B D | H B D;V
N L K D | L D N;K
V Q G B | B V G;Q
B Q N Z | B Z Q;N
D A K S | S A K;D
Q W O F | F O Q;W
U C L D | U L D;C
I Z M K | M Z K;I
E B M R | R B M;E
Y G I W | I W G;Y
F G V A | F V G;A
E D J C | J E C;D
U K V Q | V U Q;K
X T W U | X T W;U
S I V L | L V I;S
V O F C | O V C;F
A E K X | E A X;K
F H T Q | Q H T;F
P M D N | D P M;N
A D H Y | H D A;Y
W X P F | X P F;W
L E Q B | E Q B;L
S F O B | B O S;F
G Y W N | N W G;Y
P V D X | X P D;V
A Q P G | A G P;Q
X A D B | D B A;X
Y N D M | N D M;Y
Y T Z U | T Y U;Z
Z L S E | E L S;Z
T W K F | T K W;F
D V Y J | D J Y;V
L W S O | L W S;O
F Z E C | F C E;Z
N Q F P | Q N P;F
O V N P | P O V;N
P D H X | P D X;H
P L E X | X L P;E
N W E B | W B N;E
P L H E | P H E;L
E G B R | R B G;E
J U D P | P J U;D
A E M Q | A M E;Q
Z M P H | H M P;Z
S L K F | F S L;K
L A R D | D R L;A
Z B A L | L B A;Z
M Q W H | H M W;Q
X H F O | O F X;H
W E Y K | E Y W;K
D L T B | B L D;T
A G J R | R A G;J
A I E Z | Z E I;A
K D E O | D K O;E
W Z T X | W X T;Z
S H M N | M S H;N
F L U P | P U L;F
V U J Z | V Z J;U
H G T U | T G U;H
H D Y Z | Z D H;Y
E R K A | A K R;E
U I H Z | I H U;Z
G Q W H | W H Q;G
C I D F | I D F;C
D Z S M | M D Z;S
E G K X | K X E;G
J T N F | T N F;J
H O U E | O H U;E
Y N P E | P Y E;N
N X P E | E X P;N
V Q A W | Q W V;A
E N B P | P E B;N
M G B I | B I M;G
V U C Q | C Q V;U
N J S O | J N S;O
V M S T | V S T;M
A Z P W | P A W;Z
L D H P | L P D;H
I V U Q | Q V I;U
W I L K | I W K;L
J W V Q | W V J;Q
M G K D | K G M;D
A L G X | X A L;G
I E A T | E T I;A
C W O L | C L W;O
K S I W | K W S;I
N F T S | S T N;F
K G S I | I G K;S
B E O K | B K E;O
X D R Q | X R D;Q
V A S E | E A S;V
A O B C | O C B;A
U N S A | N A U;S
S B L Y | L Y S;B
J G U Q | J G Q;U
X S P N | N S P;X
L S N V | N V L;S
Q U B G | G Q U;B
F M G R | F G M;R
L A N T | N T A;L
X R A B | A R B;X
X B Z S | S X B;Z
K P Z I | P K I;Z
H Y M V | V Y H;M
W G L A | L G A;W
J Q S V | S J V;Q
V G N R | G V N;R
T R X A | T X A;R
F H D N | N F H;D
Y X C N | X C N;Y
K Q J V | K Q J;V
C S O M | C S M;O
S T J B | T S B;J
H L A T | L H A;T
O S I F | I S F;O
S E X H | S E X;H
O X T K | O K X;T
E T P V | V E P;T
V K A Z | V Z A;K
X Y P F | P F Y;X
Q S A B | S B Q;A
A F V O | O A V;F
B A D M | D B M;A
X H T S | X T H;S
Y L J V | J L V;Y
W D V C | W D C;V
Z B C R | Z C B;R
A V G T | T A G;V
M T S J | J T S;M
I N K J | I K N;J
H N T U | H U N;T
B X D L | X D B;L
O T R B | T O R;B
C K G V | K V C;G
L S R Y | Y S R;L
F U A P | F U P;A
O J B E | E J O;B
G E U Y | Y G U;E
L U E F | E F L;U
K S L F | S L K;F
D E Y M | Y D E;M
C K O U | C U K;O
V I C U | V I U;C
U T Z G | Z T G;U
Z E V D | D Z E;V
A L N Y | N L A;Y
J V D Q | Q D V;J
D P Y E | D E P;Y
Z E T Q | T E Z;Q
I C O T | C O T;I
P Q N H | N Q H;P
S V P T | T S V;P
J O A Y | O J Y;A
P I L N | L I P;N
K Q X J | K X Q;J
A W Q Z | Z A W;Q
S Q B M | B Q M;S
H V I D | D I H;V
S W U P | S P U;W
X V M W | X V W;M
T W F H | W F T;H
B A D N | N B D;A
X Y Q E | Q X E;Y
J K R T | T J R;K
B I F O | B O F;I
W O X V | O V X;W
T P B O | B P T;O
X Y V Q | Q X V;Y
P T B S | P T S;B
H F J A | J H A;F
C D Z V | C V Z;D
M A W Z | W Z M;A
S M B C | C S B;M
Y M I T | T I Y;M
V B J K | K V J;B
A G E H | A H E;G
K C N A | C A K;N
V X P U | V P U;X
B J W U | W J B;U
H V M Q | V M H;Q
D K W X | X D W;K
S M K H | H M K;S
P Y A Q | A Q P;Y
H L Y V | L H Y;V
Z Y E A | Z A Y;E
G C D I | I G C;D
Z X G I | X I Z;G
B K S V | B K S;V
B U J D | D U B;J
C X W A | A C X;W
V N G X | G V X;N
U E D B | U D B;E
U W X N | X N W;U
G T J E | E J T;G
B O L Y | Y B L;O
F S P Z | S P F;Z
L P T V | T V P;L
E I O A | O E A;I
Q X J O | O X J;Q
D F G M | F D G;M
J H F I | F I J;H
K Z N S | N K Z;S
O S P C | P O C;S
A E Z K | K A Z;E
M V F S | V F S;M
Q X W C | X Q W;C
B N U Q | N U Q;B
W Y U X | Y U X;W
N O I V | I N O;V
W L T U | W T U;L
H G Z I | I H Z;G
V L A O | L V A;O
T P U A | T P U;A
J Q D C | D C Q;J
G Q A I | A G Q;I
I D X L | I L X;D
J Q R K | Q R J;K
V I W O | O I W;V
D H S C | D H C;S
T A W Y | A Y T;W
F C Q X | F C X;Q
D G M U | U G M;D
V I W N | I V W;N
D J S N | J D N;S
D S X T | D X T;S
G W H J | G W H;J
A I H F | A I F;H
C T I S | I T C;S
F O M L | F O L;M
L H I D | D I L;H
B Z F Y | B F Z;Y
K Y L O | O K L;Y
Y O Z X | Y O Z;X
T F Z I | F T I;Z
C S P T | C T P;S
O U M F | O F M;U
O C J P | C O J;P
B V F Z | F Z B;V
B E D H | H D E;B
N L T R | T L N;R
A L K C | K L A;C
U L Y G | L Y G;U
V O Y A | A Y O;V
I J P H | H J I;P
M I H C | I C H;M
X R F A | A F X;R
H T F R | F T H;R
G L T W | G L T;W
W V R E | E W V;R
W R E G | G E W;R
N T A L | N T A;L
O Z S E | O E Z;S
N Z E U | E Z U;N
O X W D | O W X;D
J H L S | J S L;H
E H M X | M H X;E
R A U X | A R X;U
U B T H | T U B;H
N P T M | M N T;P
N V C X | N X C;V
Y U S Z | Z U S;Y
L B Y O | Y L B;O
Y Q N S | Q S Y;N
C X I H | H X C;I
E K R J | J E R;K
M L H C | M C H;L
U E J X | J X U;E
S G Q Y | S Q G;Y
T V D M | M V T;D
D A V E | A D V;E
T L E R | T R L;E
O T Z R | Z O T;R
V W F Z | V W Z;F
M O P H | O P H;M
S K M L | L M S;K
L S M A | M S L;A
D P Z K | P K D;Z
H O T F | H F O;T
G V C K | V K C;G
A N K C | C A N;K
Z E F B | Z E B;F
Q R E J | R E J;Q
W Z H B | Z B W;H
Q A M D | A Q D;M
U A N G | N U G;A
J Z X A | A Z J;X
N U V W | U N V;W
R Y W A | W R Y;A
Y F W D | D W Y;F
M Z A V | V Z M;A
H I L A | L H I;A
P I S C | C P S;I
A F X U | U F X;A
Z W P U | U Z W;P
S I W D | S W I;D
G V Z J | J Z G;V
P C Z J | P J C;Z
M J Y D | D M J;Y
W F O C | O F C;W
E X I T | I T E;X
Y B D Z | D B Z;Y
L R E G | E R L;G
E X U V | X V E;U
K T V O | V K T;O
R E L S | E L S;R
T F D W | D T F;W
N E P D | N P D;E
C A X W | W A X;C
T A L K | L K T;A
F A V R | R A F;V
J G M L | G M L;J
E M U C | M U E;C
E R B P | E B R;P
X W Z S | W Z S;X
X L B Z | Z B X;L
F A I Q | Q I F;A
U P G E | U P G;E
S M G Y | M G S;Y
V F S Z | V Z F;S
X V Y E | X E Y;V
A P Y T | T P Y;A
Y X Z U | U X Y;Z
W B X I | I B X;W
Y U I C | U Y I;C
Q V J Y | Q V Y;J
Q X N E | E Q N;X
P M O Y | M P Y;O
Q F O U | Q O F;U
T B H F | B T H;F
T C G D | D T G;C
I T L K | K L I;T
Q Y C K | K Y C;Q
S Y Z W | W Z Y;S
B L F V | L F V;B
C X H T | H T X;C
S C G F | F S C;G
W A D K | A W K;D
Q J K I | Q K J;I
C T M U | M C U;T
W N U G | G N W;U
K Y O Q | K O Y;Q
T D Y W | Y T W;D
J N L Z | J N L;Z
K Z O R | O K Z;R
H C T E | T H C;E
J Q I V | I J V;Q
N O X T | N O X;T
N P Y V | N Y P;V
R V C A | A R V;C
U M Z E | E Z M;U
S V E Y | S Y V;E
R T G F | T R F;G
S J B T | J B T;S
X T H Y | Y X H;T
I T C O | T O I;C
C G Q M | G Q C;M
K U G Z | K G Z;U
D N E R | D E R;N
D F G W | W F D;G
P Q M D | P M D;Q
X I L G | G L X;I
U T V R | U R T;V
P H C F | P H C;F
J C V Q | C Q J;V
S D G X | S G D;X
F X N G | G F N;X
Z C K Y | C K Y;Z
Y Q L E | E Y L;Q
P F D I | F D I;P
L K F G | G F K;L
Z D G E | D G Z;E
Q I U N | N I U;Q
N Y H Z | Y Z H;N
V N C F | F C V;N
Z A D O | Z D O;A
H R Q O | O H R;Q
N V L T | L N T;V
Z A D M | M A Z;D
H Z O W | O Z W;H
E D K N | K D E;N
X J T P | P J T;X
C A I P | P C A;I
Z Q I O | O Z Q;I
J X Q K | Q J X;K
V R I S | V R S;I
Q A S B | Q B A;S
F Q U J | J F Q;U
K S W L | S K L;W
U C V L | U C L;V
L Z E B | E Z B;L
Q N H B | N Q B;H
W K N E | N K E;W
H W B E | E B H;W
L A W V | W A L;V
I K P M | K P M;I
R I V B | V B I;R
P F L X | P F L;X
L X B D | X B L;D
P K C V | K V C;P
W L F K | K W L;F
Z G T N | G Z T;N
C E B F | F E B;C
T F G Q | Q G F;T
H C I O | C O H;I
N Q W K | W K N;Q
S B E R | B R E;S
X O U M | M U X;O
Q Z I J | Z Q I;J
J R E Y | E Y R;J
S P F Y | P F S;Y
H T B P | B H T;P
K X B T | X T B;K
U W E C | W C U;E
C D V P | P C D;V
Y C Q F | C F Y;Q
J P I F | I P F;J
E U R P | R E P;U
O J F K | F O K;J
S M U A | S M A;U
I G E R | E R I;G
A Z G X | Z X G;A
H X W E | H W X;E
Q G O A | O Q G;A
S X J G | X S G;J
N I Z O | I Z N;O
R U E I | I U E;R
N S T A | N S A;T
S C N H | H S N;C
J H E F | H E F;J
I R J U | J R I;U
Q W N F | W F Q;N
I B R T | B T R;I
M D T I | D I M;T
Q F H I | F I H;Q
K A U Z | A Z U;K
L X F S | F X S;L
P E M O | P M O;E
C L Y H | C Y H;L
U I L E | U I L;E
B A D M | A B M;D
R B D C | D R B;C
E C P W | C P W;E
V P Q W | P V Q;W
A O G C | O G A;C
N V T K | T V N;K
Q J O H | Q O H;J
I S Q K | S Q K;I
E S W D | D W E;S
Q Y E V | V Q Y;E
A J G P | P A G;J
V C O J | C O J;V
G E D K | E K G;D
N F S C | C N S;F
T B Q M | M Q B;T
H D B Z | B D H;Z
H O Y B | Y H O;B
D A X U | A D U;X
R X W L | R L X;W
K X F U | K U F;X
W V M Q | V M W;Q
E U X Z | E Z U;X
M F W H | H W M;F
Z Q N T | Z T Q;N
J K G R | R G J;K
C P B D | C P B;D
S B N K | K N B;S
S I E D | D S E;I
V Z G B | B G Z;V
Q U R L | R Q U;L
J I G T | T G J;I
L X J D | X D J;L
X N V A | N X A;V
T M Y Z | Z T Y;M
Y V P C | C P V;Y
P A M J | P M J;A
B G Q J | G Q B;J
J D O R | O R D;J
Q N U O | N O U;Q
G T L P | L G T;P
E C H Q | C H E;Q
N P C D | N P C;D
P C M Z | Z M C;P
W N G D | G W D;N
D P E O | O D E;P
D X I B | I X B;D
J T Y D | D J Y;T
O C E S | S O E;C
K R C L | K L C;R
Y W U X | W X Y;U
K G L E | K L E;G
U A M Q | U Q A;M
S W A K | W K A;S
M Z J E | Z J M;E
Q T G U | T G Q;U
X F H M | F H M;X
M V C I | M V I;C
H Y E W | W Y H;E
G Y A J | A Y J;G
G K N P | N P G;K
N T L D | D L T;N
C L E O | C L O;E
I F U N | I F U;N
Y W D L | L W Y;D
Z U S B | Z U B;S
P O J E | J P O;E
G C F E | F E G;C
F Y Q X | Q F X;Y
O R K C | O R K;C
J N W K | J W N;K
N O E Q | N Q O;E
X Y D Z | D Y X;Z
I C S J | J I S;C
M Q R L | Q R M;L
L K A E | K E L;A
J L X O | L X O;J
F E M D | F M E;D
W Y A X | A X Y;W
O Q W K | K O W;Q
K F T U | K F T;U
N D E J | E D J;N
V H U E | E V U;H
N X G V | G X N;V
H F U O | F U O;H
Z V M R | V R Z;M
W Q O B | Q O W;B
T R Q J | J R T;Q
B H D K | H D K;B
T X N O | N T O;X
H I E F | E F I;H
E W J Y | W J E;Y
V I W H | W V I;H
A O I Y | O A I;Y
G R C W | W G C;R
U L O N | N L O;U
S F V K | V S F;K
K X A C | A K X;C
T I C E | E I C;T
L N M W | N M L;W
Z I X W | I W X;Z
M C X B | B M C;X
B N E K | E N B;K
Y O X D | O Y D;X
S D N M | N M D;S
T W P V | V T P;W
K P A L | K A P;L
Q C G X | G Q X;C
Y I R F | R Y I;F
B V S G | G S B;V
C U B Z | C U B;Z
X P K H | K P H;X
E F O Y | Y E F;O
D F A B | B D A;F
Z H I E | H E Z;I
A P T U | U P A;T
N X D F | F X N;D
N E A W | N A W;E
X I D N | X N D;I
H K F O | H K F;O
N W H X | W X N;H
C P U N | U C P;N
J I P V | V J P;I
B I A U | U A I;B
V Z Y E | Y E V;Z
S T V O | V T S;O
X R U H | H R X;U
Q X M W | W Q X;M
N J K P | K J P;N
N J P Y | J Y P;N
F B V G | F B V;G
T Y A B | A T B;Y
U B V G | B G V;U
R W S D | D W R;S
G K L F | F L G;K
W D Y Q | Q W Y;D
E M X N | N E X;M
Q O L P | L Q O;P
T E O R | T E R;O
W C T V | V T C;W
Y G Q E | Q G E;Y
I V W U | W V I;U
V E A L | E L A;V
V T X F | T X V;F
C J I H | C H J;I
H F I X | X F I;H
R X T I | R T X;I
J D F W | W J F;D
V U G T | T U V;G
S Y N M | Y M S;N
W D I N | N I W;D
R X H M | M X H;R
D I G E | E G I;D
M W H Q | H M Q;W
D L M A | A D L;M
C B T V | C V B;T
F E V M | V E M;F
K O P J | P K O;J
D Y U P | Y U D;P
K V W P | K V W;P
G C B H | H B G;C
W T H A | W A H;T
W D P O | W O P;D
H F Y G | Y G H;F
F A T X | F A T;X
G A E H | E H G;A
V T K L | T V L;K
U O W P | W U P;O
M U F E | M E F;U
P M F Y | Y F M;P
P A H Z | Z H P;A
N Z X F | F Z N;X
M J T H | M J T;H
S X N H | H N X;S
Z U J S | Z S J;U
K Z O T | O Z T;K
X M L P | M X L;P
Q F G U | F G U;Q
C F O A | O A F;C
I T O G | I G O;T
Y C I B | C Y I;B
U L Z G | Z G U;L
B I F D | B F D;I
Q O L H | Q O H;L
O Y V J | O J V;Y
R J Z Y | Z Y J;R
B J F R | J B R;F
L R U A | R A U;L
O B D S | S O B;D
J E L F | E J F;L
N T I F | I N T;F
O G M F | M G F;O
O S U G | G O U;S
I Z M R | Z I R;M
M D L C | C M L;D
O C U Y | C U O;Y
I P S A | P I S;A
T E Y H | E H T;Y
X G P D | G D P;X
Q T Y F | Q F Y;T
K N C L | C L N;K
U J L Z | J Z L;U
G N Q O | O G Q;N
J W Y O | O J Y;W
Q S E V | E Q S;V
N B I C | B C N;I
M N W I | N W M;I
F M Q T | F T M;Q
H G Q X | G X Q;H
T H K Y | T Y H;K
B I X J | B I J;X
V N U H | H N U;V
A P F L | P A F;L
N Y Q S | Y Q S;N
P B G C | G C P;B
U R K Q | K Q U;R
E J F Z | E J F;Z
C B N E | E B N;C
V G O C | G O C;V
Z Y I N | Y Z I;N
H N V C | H C N;V
M U Q C | M U Q;C
E R K V | K R E;V
M S K N | M K S;N
O Z J E | O Z J;E
V K S X | K S V;X
G H U T | G U T;H
E O T L | E O L;T
I X A G | I A X;G
Y Q W G | G Q W;Y
X V W K | K X W;V
A U H V | A V U;H
L B R Q | R L B;Q
U C R P | R P U;C
X D Z B | B Z X;D
O U C R | O U R;C
J D Z W | Z W D;J
B N F Q | F Q B;N
E D L Y | Y E L;D
J Q X B | J B Q;X
Q N A J | Q N A;J
J Y U I | Y U I;J
J L P K | P K J;L
A D L X | A L X;D
S R I N | R N S;I
G Q S X | Q G S;X
M I T H | T M I;H
A Y T U | U A Y;T
G O Y V | Y G V;O
V A E P | E A V;P
G R M Q | G Q R;M
E V W A | V A W;E
B I F D | F D I;B
P O D V | P V O;D
L K S T | K S L;T
O V U W | U W O;V
T Y D J | D J T;Y
X P Z M | Z M X;P
J W Q R | R W Q;J
Y C P U | U P C;Y
O U R T | T R U;O
G H Z O | H Z G;O
N F W J | J N F;W
A C K E | A K C;E
T B D A | B T D;A
H P E I | I H E;P
J T L M | T L J;M
F X C T | X T C;F
F M D O | F O D;M
S Q M Y | M S Y;Q
W L N R | R L W;N
M P T W | T W P;M
C Y O Q | O Y Q;C
T N Z H | N T Z;H
X V O C | C X O;V
V T O Q | V Q O;T
G M R J | G M R;J
G U V J | U V G;J
D J I N | D J I;N
O U B L | O B U;L
B F I A | I A F;B
U D E S | S D U;E
N J G R | G R J;N
R K S C | K S R;C
E Y M N | M N Y;E
X P Q D | X P Q;D
G B N H | H B N;G
W Z M K | Z W K;M
C Z L U | L Z C;U
X R B L | R X L;B
F R B Q | B F Q;R
F S M D | F S D;M
M K J Z | K J Z;M
F I B E | E I F;B
Q V F Y | V Q Y;F
R Q X V | X Q R;V
X B N F | F X N;B
X B V E | E B V;X
D G U M | M D U;G
M A R C | C A R;M
Q O T W | T Q O;W
W B J C | W C J;B
D Q S V | Q V S;D
T P H Q | H P Q;T
C E N I | C N I;E
Y R M X | M X R;Y
T E Q Y | T Q Y;E
N Q U A | N U Q;A
J R P K | R P K;J
S U F I | I U S;F
C E U Z | Z U E;C
S J V Z | J S V;Z
Y Z Q I | Y Z I;Q
O K T B | T B K;O
L Q F E | F L E;Q
U B G L | B G L;U
L A E B | E A B;L
V C S H | S V H;C
U Q F G | U Q G;F
H O U L | U L O;H
I S P C | I S P;C
D L E J | L D J;E
Y C W D | D W Y;C
X Q L A | L A X;Q
C P K F | P F C;K
K U W R | R W U;K
X G R F | R G X;F
F P L Y | L Y P;F
R N T K | K N T;R
T S C A | T A C;S
M C P F | C P F;M
M B A R | M R B;A
K N P X | X N P;K
I S Y L | S L I;Y
C R I Q | R Q C;I
A W H Q | W H A;Q
H K C Z | H Z C;K
B H V W | V B H;W
H G A Q | G H A;Q
M H D U | H D U;M
Q I F O | I O F;Q
V P U J | V P U;J
H R S D | H D R;S
P E V Y | E V Y;P
O R U M | U R M;O
V G T Y | G Y T;V
O V H E | H V O;E
Y N R L | R N Y;L
F H A O | A O F;H
N M I R | I M R;N
U K C N | N K U;C
D A H J | H A D;J
S L G U | L U S;G
E R Q G | G Q R;E
X L I S | X I S;L
M E F K | M K F;E
N T F Z | T F Z;N
A O X R | R A O;X
R E N B | E R N;B
R C Q U | U Q C;R
H P Y W | H W Y;P
Y O V B | V O Y;B
M P E Y | E P Y;M
S Q U H | S H U;Q
Y R A F | Y F R;A
P Q G I | I Q P;G
Q U K P | K P U;Q
F G S B | F S G;B
V D I O | I D V;O
L V S T | T V L;S
G V P K | P V G;K
N I M U | N U M;I
Y M E Q | M Y E;Q
D I H U | H I D;U
U M A X | U X M;A
B X Z Q | X B Z;Q
S E O Y | Y E O;S
P S T K | P S T;K
V P C J | C V P;J
I T N V | V N I;T
O P Z F | P O Z;F
W I Q O | I W Q;O
Z F M O | M F Z;O
R M Z O | M O R;Z
L N Y A | N Y L;A
Q B I G | B I G;Q
P D Y H | H P Y;D
B A Q C | Q A C;B
V P W N | V N W;P
S B E G | E G B;S
G U N E | U G N;E
C V U X | C U V;X
W I X M | M I X;W
I U W J | U J W;I
J F W O | F W J;O
A O I E | A O E;I
V P S L | S V P;L
T V Y Z | Z Y V;T
R S A Y | R Y S;A
R F C G | F C G;R
U N K G | G N K;U
G J W V | W J V;G
Y D V S | S Y V;D
P H R K | R P K;H
G F L J | F G L;J
Y L H V | V Y H;L
W F J Z | W J F;Z
B L S Z | L B S;Z
L I Q X | I Q X;L
E U J F | E U J;F
V T P X | T X V;P
N V B X | N V B;X
G Z J I | Z G I;J
S Z N I | N I Z;S
C Y H O | O H C;Y
N L P T | T N L;P
U M I Z | I M Z;U
X Q T Z | T X Z;Q
S D I N | N I D;S
E J Z M | E M J;Z
S L U X | U X S;L
U Z H N | H U N;Z
F W H T | F H W;T
M Y E W | Y M W;E
O E J T | O E J;T
J C M O | C M J;O
L N I J | I L N;J
E L J G | G J E;L
X E G P | E X G;P
U Q J E | Q E U;J
L O M D | L M O;D
E N P J | J N P;E
N V P A | A P V;N
X A P Q | X A P;Q
Z V T N | V N T;Z
H C M J | H M J;C
H Y M X | X Y H;M
X F H E | F X E;H
Z U I W | I Z W;U
B H F N | H B F;N
J P K X | K J X;P
C S G U | C S U;G
N X V C | X V N;C
D R E K | R E K;D
X P L F | L F P;X
C A N Q | N Q C;A
Q E R G | Q G R;E
T R B Z | Z T B;R
O R Y D | O Y D;R
P K G B | P B K;G
V M N J | N J M;V
J U Y C | J Y C;U
S D X J | J X S;D
M Z U P | P U Z;M
H C I Y | H I Y;C
D C G Q | D Q G;C
B D Q E | Q B D;E
N E T W | W E T;N
P W Q N | N Q W;P
M I X K | K I X;M
F N G B | G F B;N
G M U S | G M S;U
L T I S | S T I;L
S J I V | S V J;I
B D E A | B E D;A
D U O N | D U N;O
Y J V A | V Y A;J
R O Y G | O R G;Y
H J I T | T I H;J
F P C O | C O P;F
Q Z J N | J Q Z;N
Q P Z T | T Q Z;P
T Z F J | F J Z;T
Q C I Y | Q I C;Y
G M L I | L M G;I
B F Q J | B F J;Q
E L B F | B F E;L
W G J A | A W J;G
O W E V | O V E;W
P M J R | M R J;P
M E F N | F E N;M
Z F E N | F Z E;N
J Q G H | Q G H;J
Q E L I | I E Q;L
V L U Y | Y U V;L
O N B E | B O N;E
Y E P D | E Y D;P
Z R K A | Z R A;K
W U F L | L F W;U
C W V H | C W H;V
U A D L | L D A;U
Y G T N | G T N;Y
X I G V | V I X;G
E S I K | K I S;E
R T U H | R U H;T
T R Y O | O R T;Y
T O Q E | E Q T;O
M F H D | D H M;F
T A Y K | A T Y;K
S F T E | T E S;F
Y X Z M | X Y Z;M
N L F U | F N L;U
E Q O B | O Q B;E
E V L H | V H L;E
B Z S R | R S B;Z
J A I Y | A I J;Y
Y O N R | N O Y;R
J Y O N | N O J;Y
J I A R | I A J;R
H K M I | I M H;K
Y D X U | U Y D;X
T A B J | B J A;T
M E O S | E M S;O
D Q V J | V D J;Q
X I Q A | A X I;Q
X A U T | U T A;X
X Y L T | T L X;Y
D Z L F | D F Z;L
O Z J D | J Z O;D
X Z W M | Z W X;M
U M L I | M U L;I
J F I S | S J F;I
W K P C | K C P;W
T U N K | T K U;N
W O M A | W M O;A
Y U F D | U Y F;D
G C E I | E C G;I
O T B M | B O M;T
Y R M J | Y R J;M
F T M A | T A M;F
R J L Q | R J L;Q
T P J S | P S J;T
V R N L | L R V;N
M Z H L | Z M H;L
B J G Z | Z B J;G
L J X A | L A X;J
R O T K | R K T;O
Y I R O | O Y R;I
V H P O | O P V;H
K W Q T | Q W T;K
E A N K | A N E;K
D B J E | E B J;D
I T A Q | A I Q;T
F G Y R | R G F;Y
A X K F | X K A;F
Y Z A G | Y Z A;G
Y O W J | Y O J;W
X L D U | U X L;D
F I V P | F V I;P
U W M J | U W J;M
Z B E S | E B S;Z
Y S Q T | Q Y T;S
C A M R | M C R;A
G E T J | G E T;J
A K Z D | D Z A;K
O P I X | I O X;P
Z V I Y | Y V Z;I
T R X Y | X T Y;R
D C Q W | W D C;Q
K I O F | I K O;F
O P E C | C O E;P
E X N D | E D X;N
A S I T | S T I;A
V K M D | M V D;K
C L V Z | Z V L;C
Q U M P | P Q U;M
N S C I | I C S;N
O J S Z | J Z O;S
T R J Q | Q T J;R
E V I G | G V E;I
U H Q A | H A Q;U
L H Q K | L H K;Q
B Z J V | J V B;Z
W E U I | I E U;W
O P N E | P N O;E
T Z Y V | Z Y T;V
J O T M | T O J;M
J K X F | J K F;X
T L A P | L P T;A
Q E K F | F K E;Q
W O X L | O L X;W
P G H V | P V G;H
R D O A | A R D;O
L N T M | L N M;T
Y R E Q | E Y Q;R
D R P W | P D R;W
R T H L | H T L;R
O I Z Q | O Q I;Z
J Z A Y | A J Z;Y
C I A F | I C A;F
R Z H N | Z R N;H
U L H N | U N H;L
V Q X L | X V L;Q
E K T J | T J E;K
C F X L | C L F;X
I F L Y | L Y F;I
M B J N | M B N;J
K A F D | K A D;F
K L T F | K F L;T
Z E F P | Z F E;P
D M S I | M S D;I
N Y A F | Y A F;N
W P B X | W X P;B
J A N L | L J A;N
M W S A | S W A;M
Z N L V | L N Z;V
F E J S | S E F;J
F Y L U | Y L F;U
H X O N | H O N;X
F G D T | G F D;T
L Y G I | I Y L;G
Y Q C S | C Q Y;S
R M W X | M X W;R
A K S U | K A S;U
O M V G | V M G;O
V L A E | A E L;V
V W G D | G D V;W
J Z F Y | F Z Y;J
H U I A | A H U;I
Y W U M | U M W;Y
L S H F | H S L;F
A Y O H | H A Y;O
S Q U K | U K S;Q
U F L K | L F K;U
V F T B | F T V;B
V F Y R | F V R;Y
J D R Y | Y D J;R
W D U F | W D F;U
O Z V Y | V Z O;Y
T Q B C | B Q T;C
W L H B | L B W;H
Y K D P | D Y K;P
S I K Q | Q I K;S
I G Z W | G W I;Z
M F I J | F M J;I
M O Q E | Q O E;M
P F R D | D F R;P
S U X B | U X B;S
E L D V | V L D;E
K C P V | P V K;C
B M T W | B M T;W
S V R D | R S D;V
I R V N | V I R;N
C T G N | T N G;C
I L G S | I L S;G
Z Q M W | M Q Z;W
G P Y Z | Y P Z;G
K W D M | M D K;W
J Q O C | J O C;Q
Q K D L | L D Q;K
B G U P | U P B;G
W S V K | V K S;W
O T N P | P O N;T
C L K Y | Y C K;L
Y X G U | X G U;Y
B M I C | M C I;B
H T R C | R H T;C
B C D N | N C B;D
F N P V | V P F;N
B F P E | F P B;E
Z I M N | I Z M;N
U E K B | K E U;B
V Y I R | I V Y;R
N X B K | X N B;K
B A Z H | A H Z;B
L G I B | L I G;B
M Q P U | P M Q;U
O B X C | X C O;B
F B H E | E H B;F
M A R V | A M R;V
H Q G M | H Q G;M
F W O D | D W O;F
K Z X J | K X Z;J
P A T D | P D T;A
O C S J | J C O;S
S C T O | C O S;T
S A M W | S A W;M
R Z L T | L R T;Z
Q J K O | J O Q;K
Y A I M | M Y I;A
S L X E | E X S;L
R N A C | N R C;A
E L I M | M E I;L
S F B K | B F K;S
J Y M C | C M Y;J
C E K Y | E Y K;C
C G E X | G X C;E
A N L J | L J A;N
Q H U F | Q H F;U
X W D R | R W D;X
R E G M | M R G;E
E F C D | D F E;C
I Z C H | H I Z;C
L V A B | A B L;V
X F Y R | X Y F;R
W F Z B | Z F B;W
M C E G | C M G;E
K I U B | B K I;U
J N A X | J A N;X
G V U Y | Y U G;V
Z B R G | G R Z;B
P O A T | P O A;T
F A R E | E A F;R
L Q T J | J Q L;T
T P E M | M T P;E
E G R F | E R G;F
F B O C | O C F;B
P U L O | P O U;L
A Q N Y | N Y Q;A
L A M N | L N M;A
K F N O | F K N;O
C M J S | M J C;S
L R X K | L R X;K
K A N I | N A I;K
P D U Z | D P U;Z
M Z J X | J Z M;X
N R F A | N A F;R
I R N W | W I N;R
L K B G | K G L;B
A I U J | A U I;J
A U N C | U N A;C
G L E C | C E G;L
J M P G | J P G;M
Y W Z G | W Y G;Z
E S C P | E P S;C
G B F Z | B Z G;F
V Y W Q | Y Q W;V
C W D H | W H D;C
C G T K | C K T;G
X P O C | X C O;P
K P B D | B D P;K
P T Y X | T X Y;P
Q R B K | R B Q;K
D V M X | M X D;V
L I A G | I L G;A
E S R K | E S K;R
V K H A | A V H;K
H W R Y | W H R;Y
G S P L | P L S;G
J N B A | A J N;B
G H O W | G O H;W
M F P X | X F M;P
C Z H M | C M H;Z
X E B O | B X E;O
F E Q C | E F C;Q
G T H O | G T O;H
B M C U | M B U;C
E W H P | W E P;H
A B N T | N B T;A
M W P O | P O M;W
F Y H X | Y F H;X
N E V G | V G N;E
D K V A | V K D;A
S K R D | R S D;K
N B V A | B A V;N
D A J G | D J G;A
S P F G | G S F;P
F M T E | M T F;E
P Q U A | P A Q;U
C J Y Q | J Y C;Q
P G V E | E P G;V
J T P E | P E T;J
C E L F | F L E;C
O M A R | A R O;M
D P F V | V P D;F
T W Q C | W Q T;C
Q W I R | R W I;Q
P X Y D | Y P X;D
X R S G | S R G;X
A K Y U | U A K;Y
V S K A | V S K;A
C F U L | U C F;L
G D I K | D I K;G
P U M H | M U P;H
G K T I | T I G;K
H V E N | V H N;E
O F L R | L F R;O
G L I K | K I G;L
U S V Z | Z V U;S
O A L W | L O W;A
Y S F Z | Z F Y;S
M F K Q | M F K;Q
A G U H | A U G;H
H Q V Z | V H Z;Q
L D I Y | D I L;Y
R N I K | K I R;N
T X P V | X V T;P
O I A E | A E I;O
N T W J | W T J;N
A P V D | A D P;V
H F R N | F R N;H
E C H T | H C T;E
V N I Y | Y V N;I
G P A Q | A P G;Q
J Z H L | L H J;Z
U B P O | B U O;P
C W M Q | C W M;Q
E J Q H | Q H E;J
G M P E | M E G;P
O N P V | N P O;V
G A H V | H G A;V
G K P N | P G N;K
N O I E | E N O;I
P D R L | P R D;L
D J G Z | J Z D;G
Q O T D | D T Q;O
J I X Z | I X Z;J
C R I N | N I R;C
B Q W M | Q W B;M
K J Q E | Q K J;E
F W Q P | P Q F;W
W O X G | G X O;W
Y M P B | B M P;Y
W C D N | D C W;N
V Z C E | Z V E;C
M R B U | M U B;R
D T R Z | Z R D;T
M Q R J | J R Q;M
Z S Y Q | Y S Z;Q
Q K E T | K E T;Q
D N Q O | D N O;Q
A B T E | E B A;T
G D N F | N G D;F
H P O T | T H O;P
Q O B S | O S Q;B
S X F K | X S K;F
T M C E | E M C;T
U A Y Z | Y U A;Z
P C N E | P C E;N
C X H M | X M H;C
U S W Y | S W U;Y
D X W H | X W H;D
N D M Y | M N Y;D
B I X U | I U X;B
H M V S | M V S;H
I S C F | C I S;F
Z X D B | B D X;Z
D C Z T | D Z T;C
K S C B | S K B;C
D S I H | H I S;D
K W L T | W K T;L
X G N C | X G N;C
C T F L | F L T;C
S M V O | V M O;S
C I A U | A I C;U
Q C P I | Q C P;I
S M E C | S M E;C
H J Z C | Z H C;J
S R J I | J I S;R
T G M W | T G M;W
J K C L | C J L;K
F Q B N | Q N B;F
L M U Z | L Z U;M
K V H L | L V H;K
C U V F | U V F;C
S G X E | E G X;S
H Q K U | U Q H;K
Y F C Z | F Y C;Z
F V I E | E I F;V
M D Y I | Y M I;D
T U K C | C T K;U
P U M O | M U O;P
N V J B | N B J;V
U B M O | U O M;B
I C Y Z | I Z C;Y
F B J H | H J F;B
Q H A L | L H Q;A
T J Q G | Q T J;G
K V D W | D V K;W
V I D S | S D I;V
B D J A | A B D;J
X G P O | O X P;G
C F U K | K C F;U
J O T B | T O B;J
X Z C O | Z X C;O
K G T I | K T G;I
H U M V | M V H;U
E Y X K | X K Y;E
D R U W | W U R;D
T M H D | M H T;D
J R X M | J R M;X
J B O Q | O Q B;J
D I H N | H I D;N
P K F B | K P B;F
K W U Q | W K U;Q
G I F K | I G K;F
A D K I | A K D;I
Z T S P | Z S P;T
R F X J | J F X;R
I D T F | F D I;T
F C W Q | C W F;Q
W B N U | B N U;W
Z M R S | S R M;Z
A E L U | E U A;L
Z H S F | S F Z;H
F H X A | A F X;H
K F W O | O W F;K
D X W L | L W X;D
T P A C | A P T;C
N F J Y | F Y N;J
D J Z I | J Z D;I
E G Z I | I G E;Z
F I V A | F A I;V
E I S F | F I E;S
T O U F | O U T;F
L C J V | J L C;V
K J Z Q | K Z J;Q
X K L H | X L H;K
W X E Y | E W Y;X
X G J Q | J Q G;X
F A H O | A O H;F
D G C Q | Q G C;D
H O T J | H J T;O
K T N D | K N T;D
Z B O W | Z B W;O
F E C S | F E S;C
Q G H Y | Q Y G;H
B P S O | S P B;O
K O J S | K S J;O
I L H T | T L I;H
C P I R | P C R;I
O G D E | E D G;O
Q W L D | D W L;Q
A I O C | O C A;I
Y R S I | S Y I;R
S W H A | W S A;H
F M P R | P F R;M
P N U E | N U E;P
O W V R | W V O;R
B R Y I | I Y B;R
C I B V | V B I;C
U T N W | U T W;N
W G U L | G W U;L
H K W S | W K H;S
M J K R | R M J;K
D S A U | D A U;S
Z U F B | U B Z;F
C I D H | D H C;I
M B O W | O M B;W
A R S Z | A Z R;S
X V L I | X V I;L
W V D M | D W M;V
J T V L | L T V;J
I B A J | B I J;A
Z C K Q | Q K Z;C
U Z B C | U C Z;B
D V Z E | D E Z;V
T N H X | H X N;T
Y X L B | X L B;Y
V I H X | X I V;H
G P B V | G B V;P
Z T J Q | T J Q;Z
L T M C | T C M;L
D U X Q | Q D X;U
V D H N | V D N;H
Q U Y C | Y C U;Q
B A U W | B U A;W
J R E F | F R J;E
Z N F T | T Z N;F
M J E W | E J W;M
Y B F P | P B Y;F
P O N K | N O K;P
Q I Y A | I Q A;Y
Z S B M | S B M;Z
E C T Q | E Q C;T
Y Q O L | O L Y;Q
G K L R | L K R;G
H X A G | X A H;G
S I Y D | Y D S;I
P Q J K | P K Q;J
Y W V E | W Y V;E
V U A H | V U H;A
W G L V | L V G;W
X W B I | X W I;B
R E Q V | E V Q;R
M X C B | M B X;C
Z O D J | O J D;Z
M G K F | G K M;F
Z B J Q | Q Z B;J
F Q S A | S F A;Q
U R L E | L U R;E
H I N S | S H I;N
M Q V F | M F V;Q
R Y D Z | Z Y D;R
A B V F | A B V;F
W M T D | D T W;M
C U S B | S C B;U
W S B F | B F S;W
L A Q R | Q L R;A
G T L Y | G L T;Y
T Q V Y | Y T V;Q
A U N C | U A N;C
E X I L | I E L;X
H S D O | H S D;O
D P W R | P W R;D
O G J V | G V J;O
B M P R | M R B;P
T E U A | E U T;A
R Q N C | C R Q;N
J W Q Z | Z Q J;W
L U T Z | U Z L;T
M S C V | C V M;S
D F I J | J F D;I
N J H Z | N H J;Z
X U Q H | X H Q;U
J I O H | I H O;J
G M F T | M T F;G
U D S X | X S U;D
B F Y S | S F Y;B
A L M X | M A L;X
J X B D | D J X;B
F P Q V | V Q F;P
Z I A G | G A I;Z
S L Q D | L S D;Q
B U K V | B K V;U
G A I W | A I W;G
D V H E | V D E;H
J S F X | X F J;S
K Z Q R | Q R K;Z
Q I J F | J F I;Q
A G O F | O A G;F
V H Q S | S H Q;V
E G N Q | E G N;Q
T P M Q | Q T P;M
P V N X | P V X;N
B H W G | B G W;H
G C K P | C G P;K
H S O J | O S J;H
A X O J | X A O;J
U O I R | U O R;I
S Q R D | S R Q;D
U L Y V | Y U L;V
N Y S W | S W N;Y
I S A G | S G I;A
T Y H N | N T Y;H
P A I U | U I P;A
L Y Z W | L W Z;Y
V F I S | V F S;I
S L R T | L T S;R
L T V W | L V W;T
X L R Z | Z R L;X
K U X V | K U V;X
I P N Q | N P Q;I
I M T X | M T I;X
T Z U E | Z T E;U
L E U G | G U E;L
X J F H | J F X;H
R V G Z | Z R G;V
B I A D | A B D;I
N L D S | L S N;D
B Y F T | B T F;Y
T J V E | T J E;V
W S F D | F S D;W
V C Y T | Y V T;C
K T J C | K J C;T
H F P Y | H Y F;P
K E L H | H E L;K
A Y E K | Y K E;A
N E S A | N A E;S
T P X C | P X T;C
U D O Q | Q D O;U
Q K N D | N K Q;D
W K X I | I X W;K
B X O H | O X B;H
G L X J | L J X;G
U J M Y | Y U M;J
Q A H N | Q H A;N
E B K F | F B E;K
G K Y M | Y M K;G
A H Q D | A Q H;D
F K Q Z | Z F K;Q
U C J X | J X U;C
N Y I E | Y I N;E
F Y O G | Y F O;G
H Y P O | O H Y;P
B S V G | S B V;G
B Q T N | B T N;Q
L P Y O | P L Y;O
E X L F | X E F;L
U X V P | U P X;V
B W N V | W N V;B
V B D K | D K B;V
E X Z S | X Z E;S
X S U I | X U S;I
J C U V | C U V;J
R N Y V | Y R V;N
B J E I | B I E;J
Q D J H | D J Q;H
C W X Y | C Y X;W
O Q M W | O Q M;W
U Y Q J | Q J Y;U
Z O I M | Z O I;M
O G Y N | Y N G;O
L E H T | E H T;L
Z D M W | M W D;Z
D Z C R | Z C D;R
K P X Y | X P Y;K
U W F B | W B U;F
X D O M | O D X;M
T D I M | I D M;T
V L Y O | Y V O;L
J G Q C | Q C G;J
C Z Y K | C Y K;Z
Y A J L | J A L;Y
R M W L | M W R;L
C M X B | B M C;X
R H Y A | A Y H;R
F Y P Z | Z Y F;P
B N K R | R K N;B
Z W Q O | Q Z W;O
L Q P A | Q A P;L
A G Z I | Z I A;G
N Q T X | X N T;Q
O D Y P | D Y O;P
E L F B | B E F;L
I X E A | E I X;A
C I T F | F I T;C
M F Y H | M H F;Y
F P H R | F P H;R
Z Q Y K | Y K Z;Q
Q N R S | S N R;Q
S Q W J | J W Q;S
A P H E | A E H;P
A J N S | S A J;N
M J F G | F M J;G
G Q E V | G V E;Q
S Q V B | Q V S;B
U Z B H | Z U H;B
S D O L | S O L;D
F K E P | P K E;F
O S L U | L U O;S
H Q L Y | Q Y H;L
K D R E | E K D;R
R D F I | R F I;D
T H N V | V N T;H
H O B T | O H T;B
Z Y W A | Y Z A;W
E O G C | E O G;C
V X Q G | X G V;Q
H F O X | H O F;X
N G V Y | N G Y;V
Y K S J | Y S J;K
V L U T | L U V;T
Z I N F | N I Z;F
Z M C N | N M Z;C
X O D W | W D X;O
J U Q T | Q T U;J
N K R V | K R N;V
U K P C | K C P;U
V K I F | V K I;F
D Z M J | M J D;Z
A D R M | M A R;D
Y E L D | E Y L;D
G L Q N | Q L G;N
W I X Y | I X W;Y
E G Y V | G E V;Y
Y H L S | Y S H;L
R W D E | R W E;D
A K W O | O A K;W
R I D W | W R I;D
G C N D | D N C;G
T P I Z | I Z P;T
Y F G W | Y W F;G
U R P D | D R U;P
P Q N Z | Z Q N;P
Y X E F | Y F E;X
T L N Y | Y L T;N
N Z O A | O Z N;A
R M Y A | R Y M;A
R J P W | P W J;R
E R U M | U E M;R
C B N G | G C B;N
Z S P V | P Z S;V
Q X C Y | C Y Q;X
D C E O | O E C;D
G J V H | H J G;V
U X P F | F P X;U
Z I S H | Z H S;I
O F P U | F U P;O
T U R W | R W T;U
N R U T | T N R;U
E O U Q | O U E;Q
W S D I | S W I;D
N C S F | N F C;S
W V Z D | W V Z;D
W N R O | R N O;W
A X S N | A X N;S
N Y T I | I Y N;T
T F D Y | T F Y;D
J W P V | P V J;W
A H B K | A H K;B
S M U X | S X M;U
L H A E | H E L;A
U H Q K | K U Q;H
J U G B | U B J;G
A H J X | J H X;A
A S D K | A S K;D
U Z Q S | U Q S;Z
O X J Z | X J Z;O
G T B E | G E B;T
X Z E T | Z E T;X
G S O L | G O L;S
J M V G | J V M;G
B R I S | R I B;S
I W R P | P I R;W
C Q D B | B Q D;C
G H O D | G H D;O
E A Z V | A V Z;E
R N O D | N R O;D
R F W J | R W J;F
E W P G | E W G;P
S N J V | S N J;V
E N W X | N W E;X
M C S N | N C S;M
W R E H | E R H;W
U F O B | O F U;B
U B C P | C U B;P
D W T N | N T W;D
W L C Y | Y L W;C
I Y T G | Y T G;I
O J Z T | O J T;Z
R A Z Q | A R Z;Q
L P K X | L X P;K
Y Q Z B | Z Y B;Q
M N Y I | I Y M;N
Y G V F | Y F G;V
D X R C | D C R;X
H C G L | C H L;G
A P D I | P D I;A
O R P C | O C P;R
X M Q G | G X Q;M
I E D V | V I E;D
Y P F U | P Y U;F
U R B X | U B X;R
V Z R J | Z V R;J
T I Y A | A T Y;I
N S V L | L V S;N
H M K O | O K H;M
I Q O W | O I Q;W
S H O M | H M O;S
Q J O C | Q C J;O
I R H Z | I R H;Z
C F L B | C B L;F
U M D I | U I M;D
I D N V | I D V;N
C W X S | C W S;X
Y U A X | X U Y;A
I Z C P | I Z P;C
P E L M | L E P;M
W B Q P | W B P;Q
Q S X G | G Q S;X
G I Y D | G I Y;D
E S F Q | F S E;Q
I C F U | I U C;F
X O T U | U X O;T
S D Y X | D Y S;X
O T X W | O W T;X
D G B K | B K D;G
G S E M | G S E;M
I A C E | E A C;I
S H X E | E H X;S
I F M A | A M F;I
R H L P | H R P;L
M U A S | A S U;M
Y W M I | I Y W;M
Z I A S | I Z S;A
W K E C | W E K;C
B A P X | P X B;A
Y O K Z | O Y Z;K
W X G U | G X U;W
Z U J F | J U F;Z
M V S Y | V S Y;M
E O U K | K E O;U
K R S D | R S K;D
I G V E | I E V;G
B Z G T | T B Z;G
X C O W | W O C;X
Z Q M O | O Z Q;M
M X D V | D M V;X
F J L C | L C F;J
D P Y F | D Y P;F
X B R J | J X R;B
M H Y J | J H Y;M
T F C Z | Z C F;T
Y F H M | Y F M;H
N M H K | K M H;N
A J C N | N J A;C
P H I G | P G H;I
B D H A | H B D;A
E U R H | U R H;E
I L R Q | Q R L;I
Z G J W | W G J;Z
G N J A | J N A;G
L Q M G | M L Q;G
B P Q S | B Q P;S
D O U B | O D B;U
S Y F E | F E Y;S
K D B Z | Z B D;K
B I Q K | B Q I;K
T D R B | R D T;B
O U Q V | O V Q;U
H A T U | U T A;H
T A N X | T X A;N
U C W R | R W C;U
O Z N W | W Z O;N
D W X U | D W U;X
F E T D | E F D;T
W Y V X | Y W V;X
A E I C | A E I;C
J I K L | K J I;L
Y L O Z | Y Z L;O
V Z K O | Z O V;K
E A Y R | Y R A;E
M U B Y | B Y M;U
G L W J | W L G;J
C X T F | F T C;X
O I L A | L A I;O
F J O G | O F G;J
H E Y Z | Y E H;Z
I H K T | K H I;T
Q C J K | Q K C;J
O S U D | S D U;O
F Z D E | E D F;Z
Z P K Y | Z P Y;K
I S X N | N I S;X
X V N Y | V N X;Y
I W D P | D W P;I
G I F T | G I T;F
S E B M | S E M;B
L V N X | V N X;L
S H E M | S E H;M
E I P Z | P E Z;I
M T V S | M T S;V
U E W Q | W E U;Q
D T Z J | D Z J;T
L K V N | L N K;V
B L E P | P E B;L
H K C N | C K N;H
J I P W | J I W;P
X N D F | F D X;N
G P K Y | G P Y;K
S N T F | S N T;F
R E L P | E P R;L
D Y O E | O Y D;E
M N L X | X L M;N
G Y R D | R D Y;G
H K L Q | Q L K;H
L W Y V | Y W L;V
F D I Z | D Z F;I
G M S P | S P G;M
B L N U | N L B;U
J W H L | J H L;W
A N F C | F C N;A
K U B T | K B T;U
Y V S X | S V X;Y
I L Y M | Y M I;L
G M K D | K G M;D
Z D L W | D Z W;L
Q B F L | B L F;Q
X T N A | T N A;X
P E J O | J E P;O
Y V R H | H V R;Y
E K N L | K E N;L
A V W L | L A W;V
F A N G | N G A;F
I Y U M | U Y I;M
B R H I | B H R;I
J C V R | V J C;R
C T Y F | Y F C;T
M B L Q | Q L M;B
V G M X | V M X;G
K I X D | D K I;X
O X D L | L O D;X
W L A N | L W A;N
F X V H | V F H;X
V D X N | X D V;N
E H W L | E W L;H
D B R P | R B P;D
S W F P | F S W;P
K J X E | J X E;K
T B N K | N K B;T
Q U T Z | T U Z;Q
P L Q M | L Q M;P
L B J M | L J B;M
K L A Y | K L A;Y
E J Z R | Z R J;E
I M G L | I G M;L
Q Y T Z | Y Q T;Z
B T E A | T E A;B
J D F C | C J D;F
F H Q B | H B F;Q
L K Z D | K D L;Z
G Q T V | G V Q;T
D X M F | X F M;D
I Q A D | A D I;Q
Z F S R | F R Z;S
N D C W | D C W;N
L P Q O | L O P;Q
U Q H T | T U H;Q
Y I A W | Y W A;I
L U F I | F I L;U
B F E T | F E T;B
W P K A | A P W;K
U L V E | V E U;L
F R B U | F R B;U
T D O Z | Z T D;O
A Z I U | Z I U;A
N J M T | T J N;M
W A I O | I W A;O
C F A R | F A R;C
F G U I | U G I;F
M S F T | M S T;F
I K T C | T K I;C
H U S G | S G H;U
S K Y R | R K Y;S
A Z U W | W U Z;A
Z F T Y | Z Y T;F
O N D T | N O T;D
B D M X | D M X;B
T F Z O | T F Z;O
U O Z P | O P Z;U
V I O A | V A O;I
W Q G D | G D W;Q
T F N Q | Q T F;N
Q S G V | G V Q;S
W B H M | W M B;H
B C R I | R B C;I
I E D Y | I E D;Y
W L Z Q | W L Q;Z
M N U A | N U M;A
X Y A H | A Y X;H
P D S H | H D S;P
O E J Z | Z E O;J
R Q E C | C R Q;E
V Z B E | E Z B;V
D F O G | O D F;G
E V G B | G B E;V
M L J Y | J L M;Y
C B J O | C O J;B
O E H Y | Y E O;H
V W U F | U V F;W
E Q T V | E Q V;T
S Y F R | F R Y;S
T M I U | M I U;T
A J T Y | Y A T;J
P T Q D | T Q P;D
B D H M | B M H;D
P H Y U | U H Y;P
X L T B | L X T;B
D A R E | E R D;A
E K G X | E G K;X
M U I N | N M U;I
P T L C | L T C;P
Y S G O | Y S O;G
C H T E | E T H;C
G O I A | A O I;G
U R B A | A U R;B
N H L R | H L R;N
P L Q M | P M L;Q
G J L Q | G Q L;J
N Z I L | N L I;Z
N B T D | N D T;B
B C N P | B P N;C
P Y B I | Y P I;B
R F O U | O R U;F
H C E V | V H C;E
G H L Q | Q L H;G
O U H Z | O U Z;H
K L R U | L R U;K
T A X E | X T E;A
L A V D | D L V;A
Q N D R | R N Q;D
M T D A | A T M;D
U Z Q X | Q X Z;U
V X U F | U X F;V
L R B I | I L R;B
F O W Q | F W Q;O
Y L E T | Y E L;T
B V I G | G I V;B
N A F M | A M N;F
A W S O | O W A;S
B F G C | F C B;G
M B P U | P M B;U
A O U N | A O U;N
D W C Y | W C Y;D
W A O I | W I A;O
Z D L F | F D Z;L
T H I D | D H T;I
E L S J | E J L;S
Q B T A | B A Q;T
B E R U | U E R;B
S T O Q | O S T;Q
J B I Q | J Q I;B
Q A U R | Q U A;R
P M Q N | Q P M;N
P E D U | D E P;U
K Z U B | K B U;Z
Z P B G | P B Z;G
O X U Z | O Z U;X
H G P A | H G P;A
G V H T | V G T;H
S N Q V | N V S;Q
A Z X Q | A Q Z;X
S A D G | S A G;D
V S U W | U W V;S
W B C O | W O B;C
V C D A | C A V;D
O D Q J | D O Q;J
J B N U | N B U;J
K Q P D | Q D K;P
Z R G A | A G Z;R
E J P G | E G J;P
M R D S | R M S;D
H B P Y | Y H B;P
Z T X H | T X Z;H
W Q A J | A J Q;W
A W K O | K O W;A
M W Z S | W M Z;S
V W B X | V W B;X
Y R J I | I Y J;R
C Y I Q | Y I C;Q
P K E M | E K M;P
U T Q O | Q O T;U
G B X Q | X G Q;B
F B O X | X F B;O
P E V T | V P T;E
Z W Q B | B Q Z;W
P U O L | L U O;P
I V Y J | J V Y;I
J C I Z | J I Z;C
U H F D | D U H;F
K S D A | S D A;K
S I A T | I S A;T
Z P U G | G U P;Z
H N C S | N S C;H
H Y I W | W I Y;H
S I E L | S L E;I
H P D A | D A H;P
F M Q P | F Q P;M
C S O B | O C S;B
I C Q H | H C I;Q
F C U L | L C U;F
S Z R C | C S R;Z
B I K X | B K X;I
Y L D V | D V L;Y
D V J H | H J D;V
E H Y M | Y M H;E
H U C D | D C U;H
B Q C P | C B P;Q
L I Q E | E L Q;I
F Q B U | F B U;Q
S W E N | N E S;W
T J B L | J L T;B
V H L O | L O V;H
T G M W | W G T;M
V T H C | V T H;C
Y J M W | J W M;Y
E B U C | U E C;B
U E Q L | U E Q;L
O J S V | S J V;O
Z X K J | K J Z;X
C F E Q | E F C;Q
L F G W | W F L;G
O A F Z | F A Z;O
K P B R | K P B;R
G O N D | G N D;O
I Q X O | I X Q;O
D R P W | R P D;W
N Z M O | M Z N;O
N P O E | O N E;P
N Z P Y | P Z Y;N
Z K W L | K Z W;L
B R G J | B J G;R
Y D E G | G D E;Y
Y X G H | X H G;Y
E J S D | S D J;E
N Y U W | W Y U;N
T K U G | U T K;G
T U Y G | Y U G;T
E V P J | V P J;E
R M I J | J I M;R
L H O K | H K O;L
B Z A R | A Z B;R
G J L Q | G L J;Q
Z D O K | K O Z;D
Z I K M | I M Z;K
G K I N | N I G;K
L S F G | S L G;F
F M H D | D M F;H
Z G E R | Z G E;R
H E Q T | H Q E;T
G U O S | O G U;S
S C U E | E U C;S
I Q H S | I Q H;S
S D Y L | L D S;Y
D L Q Z | Z D L;Q
O N Y W | N W O;Y
M V I D | V D M;I
E I D W | I W D;E
K M X R | R K X;M
L T V X | V X L;T
C S P R | R S P;C
X G Z D | G X Z;D
K H B D | H D B;K
W E Y T | T Y E;W
V R K N | R N K;V
E C J W | W C J;E
C Z D Y | D C Z;Y
F H M Q | Q M F;H
A Y I X | Y X I;A
B C E F | E F B;C
K C J U | U C J;K
O D G Q | D Q G;O
K A C V | V A K;C
S A C R | R S C;A
A Z B X | B X Z;A
K O B S | S K B;O
K B A W | B A K;W
L K W A | L K A;W
M L B Q | Q B L;M
L P O M | P L O;M
R H I Z | Z R I;H
H P L S | P H S;L
U J B Z | Z B U;J
Y H N M | H N Y;M
J G L V | G L J;V
H A Y L | H L Y;A
C J O V | O J V;C
N X T Q | X N T;Q
F S E T | S E T;F
X O S C | C S X;O
G F E Q | E F Q;G
Y J I V | V Y I;J
G Y X L | G L Y;X
R E H T | H R T;E
Y B U T | B U Y;T
T E P V | V P E;T
P V Y C | Y V C;P
G J O I | G O J;I
W I G M | G W I;M
I T H E | I H T;E
O V D B | D V B;O
F B Y V | Y V B;F
K T L Z | T Z L;K
X W R B | W R X;B
R W T X | W R T;X
F E Q Y | F E Q;Y
D N H U | N D H;U
P D S V | P V S;D
V C M L | L M C;V
S Q U D | S U Q;D
Z A P Q | Q Z P;A
H E X B | B H E;X
W B Z H | H B Z;W
M E V U | V M E;U
Y U K Q | K U Y;Q
N B T S | B N S;T
J V S F | S F J;V
X E M I | M X I;E
K J U O | O J U;K
I V G R | V R I;G
H N I T | H I T;N
E B L H | B L E;H
S U L P | U S P;L
H E U X | U E H;X
R T L H | R T L;H
D R C P | C P D;R
P C H F | C H F;P
P K I W | W I P;K
B N S L | B L N;S
H N K D | D N K;H
E Q P C | C Q P;E
X P T Y | X Y T;P
D B Y E | E B Y;D
R I J A | A I J;R
T D V M | M V T;D
A D J Z | Z A J;D
Y E C H | C Y H;E
R Z S I | I R Z;S
V M Z Y | M V Z;Y
X Y Q H | Y X Q;H
R N F I | I N F;R
X B R D | D R B;X
I E A S | A I S;E
V D E T | D T E;V
Z T Y S | Y S T;Z
Q F B R | B F R;Q
L T W O | W T O;L
S A H W | S A W;H
K T S W | W S T;K
B S O I | I O B;S
W K M R | M W K;R
M L D A | M A L;D
K Z Y S | K Z S;Y
G I J R | R I G;J
F X D B | X F D;B
W T K Z | T W Z;K
U F V H | U F H;V
A G I B | I B A;G
L Q K F | K L Q;F
U X Y R | R X Y;U
D C B G | G C B;D
H I O E | H O E;I
J I Y D | I D Y;J
V G T D | D V G;T
R L Y B | B Y R;L
T B V W | T W B;V
C P F M | F M C;P
F E A M | M E F;A
F W I Q | Q F I;W
W P R L | P R L;W
L B I Q | Q B L;I
X L R J | L X J;R
X W U G | G W X;U
L M Q A | L M A;Q
Y N L U | U N Y;L
A C H N | A C N;H
L Y C W | W L Y;C
K Y U V | K Y V;U
G O L D | D G O;L
C E G O | G O E;C
F V I H | F H I;V
Z J D V | D V Z;J
S P I M | M P I;S
A I Y J | I J A;Y
O E P C | O E P;C
E K L D | K E L;D
D A O J | D J O;A
Y G B U | U B Y;G
N P I K | P N K;I
R H B K | B H K;R
C A T M | M T C;A
S J P E | E S P;J
P W R J | J R W;P
B T A D | T B D;A
Z A R N | A Z R;N
X G V E | V E G;X
Q S V Y | S Y V;Q
U P I M | U P I;M
P N I Z | Z N P;I
N E A S | A N E;S
O W P N | N P O;W
O C Q V | O V C;Q
S A R F | R F A;S
D L I C | D L C;I
Y D I Z | D I Y;Z
Q I P Y | I P Q;Y
F R Z Y | R Y F;Z
O Q Z L | L O Z;Q
W T F Q | F T Q;W
T D U Q | U T D;Q
A F G M | A F M;G
H R Z Q | Z H R;Q
Y B E F | B E F;Y
H G B D | B H G;D
X U F O | O U F;X
X V P I | P X V;I
G S J D | G J D;S
K D E W | D W E;K
H A J S | H A J;S
R T O B | T O R;B
M P K E | M E K;P
A O K D | K O D;A
Y T V K | K Y T;V
S J L G | S J G;L
A E G Y | G Y A;E
R K Y B | R B Y;K
S Y K V | Y K V;S
J Q Z M | J Z Q;M
H O Q G | O Q G;H
I L S G | G I L;S
T O D X | O D T;X
T I K R | R T K;I
X W J M | M X J;W
S T M G | S G T;M
H X M O | H M X;O
C O D V | D V C;O
J Q N X | N X Q;J
R M S P | M R P;S
R A P K | A K P;R
V R B O | B R O;V
D J N M | N D J;M
Q U F N | Q U F;N
X A Y R | X A R;Y
R K G U | G K R;U
J K H C | H C K;J
H X R D | H X R;D
B U R A | U A B;R
X Q K G | X Q G;K
J F S D | J F D;S
B L F O | B L F;O
X G K Q | Q X G;K
L K V X | X V L;K
E U A Q | Q U A;E
S U E D | S D U;E
H I C N | N I C;H
E Y V B | Y B V;E
O G V L | O L G;V
C W L T | T C L;W
M L H I | I H M;L
N K A Q | K Q A;N
G C B V | C V B;G
R E F N | N E F;R
M L F R | M F R;L
N T V L | L V N;T
M X N D | X N M;D
J X F I | J I X;F
X R O D | R D O;X
A O K W | A O K;W
P X O R | R X O;P
J S D Z | Z S J;D
X L K A | A X L;K
Q X A M | X A M;Q
L M Z Y | Z Y L;M
U O I F | U O I;F
D E N G | G N D;E
D T R I | T R I;D
M R H K | M R K;H
K P F L | K P L;F
J N U T | U N J;T
H A X I | A H I;X
N J G X | G X J;N
L O D F | O F D;L
K D B Z | Z B D;K
K W I D | D K W;I
J Q A G | J A G;Q
R K I V | I R V;K
J D Y W | D Y J;W
Y O D N | D N O;Y
G T B Y | T B G;Y
Q P W L | P W L;Q
H T Q R | H Q R;T
A B H G | A B G;H
T F N J | J T N;F
N P A W | N A P;W
Q V X N | X V N;Q
Z R I V | V I Z;R
Y P K G | P Y K;G
V D J Z | V J D;Z
L H Y B | Y L H;B
X Q N V | N Q V;X
J V A B | A B J;V
B W X C | C W B;X
X E U P | X P U;E
W M K H | K M H;W
K J S R | J K S;R
J A G H | G J A;H
C O H M | M O C;H
G N J F | F N J;G
T W G A | W G A;T
X B A D | A D X;B
S U G Y | U Y G;S
Z K U X | X Z K;U
S M B F | F M B;S
K U F M | U M F;K
O C T J | C J T;O
O G Y Q | O G Q;Y
C X W V | V W C;X
H A K J | J K H;A
Z Y M O | O M Y;Z
T F C Z | T Z C;F
X W P T | P W X;T
Q B R H | H Q R;B
G X Z U | Z X G;U
Y N E A | E Y A;N
P F K E | K F P;E
Z J L W | Z W J;L
Q A W B | Q B W;A
V Z L S | Z L S;V
N Q H W | N H W;Q
Z T Y O | Y O Z;T
X W V K | X W K;V
Z U L C | U Z C;L
H D F M | F H M;D
W H T X | H X T;W
N V A K | V K A;N
C X M V | M X V;C
Y C M U | M U C;Y
A V J F | F A J;V
M D C B | C M D;B
B W N U | W N U;B
E U C F | E U C;F
I L X O | I X O;L
C Q P B | B Q P;C
B X F J | B X F;J
U R L T | T R L;U
M Q D C | Q C D;M
U M B L | M U B;L
L M U O | M L U;O
F O E T | E O F;T
N T A V | N V A;T
G T V I | I G V;T
G N Z M | G Z N;M
J G O S | G O J;S
S X W E | E X S;W
S H Z M | S H Z;M
A E U M | A M E;U
O D A Q | Q O D;A
H S W V | S W V;H
N W M Y | Y W N;M
N I E M | I E M;N
G V X F | V X F;G
M L Y J | M L Y;J
C E Q U | C E U;Q
Q E C Y | E Y Q;C
S G D M | G S D;M
X U Y W | X W Y;U
L A S M | L M A;S
T I Y H | Y H I;T
K C F I | C K I;F
W D Z G | Z D G;W
M X I Q | Q X M;I
B Y P W | P Y W;B
F L E K | L E F;K
B O M W | M O B;W
W K V A | K W A;V
E Z Y D | Z E D;Y
I V S W | S V W;I
S K M T | T S M;K
Y A K J | K A Y;J
F G C P | C F G;P
P G V Q | P G Q;V
X B U N | B X U;N
N B U K | N B U;K
P U H Q | Q H U;P
T B O M | B M O;T
V B O Z | Z O B;V
Z P D U | Z U D;P
U V W J | U J V;W
N H G T | N H G;T
U O Z W | Z W O;U
B L R D | B R D;L
O A C X | X A O;C
R L V B | B L V;R
O F L Y | O Y F;L
F J A K | A J K;F
F T G Q | F Q G;T
A B L T | A B T;L
B D F P | D F B;P
H B X W | B H X;W
A J F Z | Z F A;J
E Y M Z | Z E Y;M
O I Q Z | I O Q;Z
Q B J H | H Q J;B
P Y T I | I Y P;T
I J A D | A I J;D
X E W N | E N W;X
H T B C | B H T;C
R I P Z | I R Z;P
G X A K | X K G;A
J S D X | J D S;X
M T Z P | T Z M;P
P K X U | K U X;P
W G I B | W G I;B
O X Q T | T X O;Q
R N K A | N A R;K
K S B O | S O B;K
Z S D H | H S D;Z
Y J G X | Y G X;J
O Y P G | G Y O;P
C S W J | J C S;W
U N V P | V U N;P
B S L R | R B S;L
I Z L F | F I L;Z
D S I G | D I G;S
F K J D | J K F;D
X N W I | X N I;W
J E M P | P M J;E
M V Q L | M V Q;L
O P E A | E A O;P
X J K P | X J K;P
Z W I L | Z I L;W
G W T D | D W T;G
M W O E | M E W;O
F L J D | L D J;F
F Q A Z | A Q F;Z
S X Y A | S X A;Y
P Y O S | P S O;Y
