G V C Q | Q G V;C
K I V S | I V K;S
K Z H C | C H K;Z
B E W C | W C B;E
H D X Y | X H D;Y
F D P L | L P F;D
F X V Q | X Q F;V
Z F K N | K F N;Z
K C L G | L G K;C
C U N X | X U C;N
P R W D | R P D;W
J W P M | J W M;P
I Z E M | M I E;Z
T I O N | T O I;N
A E B W | A W B;E
I L W T | L I T;W
J B K V | K B V;J
K I R S | I R K;S
S K Z X | Z K S;X
U X R T | X R T;U
M W Q X | X M W;Q
S I N Z | Z N S;I
U A H B | U A B;H
R B P N | N B P;R
L X Q C | X Q L;C
T D V O | T V D;O
E G V B | E G V;B
Y M C X | M C X;Y
E U M T | M T E;U
B F O D | B D O;F
I A Q S | I S Q;A
K H X G | G H X;K
B A M O | A M B;O
V T S X | T V S;X
Z P M V | P V M;Z
G J L Q | L Q J;G
W B F V | W F V;B
G C P A | A C G;P
I H D E | H E I;D
H S Z Q | H Q S;Z
R O L F | R L O;F
M A Z J | A Z M;J
Z X T E | E T X;Z
V G E O | E G V;O
J W X V | J V W;X
I U T P | P I U;T
X K Q L | X L Q;K
F W X D | X D W;F
M P G A | G M A;P
S Z U H | U S H;Z
I Y D M | D M Y;I
O Q I C | I O Q;C
P H N A | N P A;H
Q E G D | Q E D;G
U N H W | W U H;N
P D L U | L D U;P
U G L Q | G U Q;L
A G I U | G I U;A
L V H A | H V L;A
C N I D | C N D;I
A W X K | X W A;K
I C R E | R I C;E
D N Z C | D C Z;N
U Z W P | Z U W;P
A E O N | E A O;N
Q E K C | C K Q;E
T U Y G | Y T G;U
G B S J | S B J;G
G B P Q | G P Q;B
N I Z W | I Z W;N
M U W D | W D M;U
S P Q T | S Q P;T
H L B W | W L B;H
K O U C | O C U;K
Q O F S | O Q S;F
H E S Y | E H Y;S
H K L M | M H K;L
S V W B | S V W;B
X J M W | M W J;X
L C Z I | Z I C;L
A G E Z | Z G E;A
Z R T L | Z T R;L
Q R T L | L T R;Q
W P J Z | W J Z;P
C J R Q | Q R J;C
Y E S G | E S G;Y
G H S D | D S H;G
Y I F K | I Y K;F
O S A B | A O S;B
G H N D | H G N;D
O M N J | O M N;J
R D V C | V C D;R
Q P B K | K Q P;B
O V J Y | V J O;Y
C F K L | F L K;C
F V W A | A F V;W
X B H L | X L B;H
G J U Z | U J G;Z
Y H W C | W C H;Y
Y J R A | R Y A;J
X Y O F | F Y O;X
M H O Y | O Y H;M
S B X T | X T B;S
K V R E | V K E;R
N W Q G | N W G;Q
T F G Z | F T G;Z
Y S F L | L Y S;F
E L H W | E H W;L
Z P N X | N Z P;X
C Y D X | C X Y;D
F A W O | O A W;F
O U G B | U G B;O
K M W U | U K M;W
T V S W | S W T;V
Q C H S | H C S;Q
P S K M | K S M;P
I B R Z | R I Z;B
X I H W | W H I;X
C Q I U | Q U C;I
N F L G | F G L;N
P M G S | P M G;S
L S B D | S B D;L
P Z S Q | P Q Z;S
E Q H X | Q H X;E
D Y B M | B M D;Y
M G B S | G B M;S
A W J B | J B A;W
N S E T | N S E;T
T B A U | A U B;T
N H I Z | H Z I;N
B Q Z V | Q V B;Z
A M V U | A V M;U
M O X N | N X M;O
S J V T | T V J;S
D I B H | H B D;I
P N I J | N P J;I
T D E G | G E D;T
G I Q S | S I Q;G
F L Y O | O Y L;F
N C U P | N P C;U
D T E R | E R D;T
E B K U | E U K;B
B F M J | J F M;B
D U P Z | Z U D;P
G O T P | G P O;T
L S T J | J T L;S
B D H U | B U H;D
F J H M | H M F;J
K A R Y | R K A;Y
H R I Q | I Q H;R
C Y H T | T C H;Y
E J M T | T E J;M
Y D L U | D L U;Y
X D E S | S X E;D
P F C O | P O F;C
G T S E | S G E;T
A N C Y | A C Y;N
Q K I M | Q M I;K
Y F Q D | D Y F;Q
X D T P | X P T;D
N F P J | P J N;F
L R D I | L D I;R
J N S R | N J S;R
Q H A W | A H W;Q
V T W L | T W L;V
B A R F | F R A;B
H I V A | V I A;H
T W E F | E F W;T
I B L G | G I B;L
Q E U A | Q E A;U
E L G A | A L E;G
V Z R N | R Z N;V
N T H O | T H O;N
F Y O X | F X O;Y
Y Z O M | M Y O;Z
V B F X | V X B;F
V W J U | U V J;W
V H W E | E V W;H
Y B O J | O B J;Y
I J Y Z | J Z Y;I
T L J P | J T P;L
L M W O | W M L;O
G M K A | M G A;K
V C F W | F V W;C
T V Y S | V Y T;S
W Z T R | Z W R;T
I Y X F | Y X F;I
V G N W | V G N;W
E M T J | M E J;T
B Z X G | G B Z;X
M E N R | N E M;R
W E Y O | O Y W;E
S H T I | S I T;H
O V R M | M R V;O
E N U X | U E X;N
G A Y X | X Y A;G
D H R S | H D R;S
O K F M | K O M;F
A M C L | L M C;A
F P E B | F E B;P
N Y B X | X Y B;N
T Y U L | L T Y;U
F O R Q | R Q O;F
N L V H | H L N;V
O S M N | N M S;O
X G V A | V A X;G
F W I O | I O W;F
S A V W | V S A;W
X U L V | L U V;X
G E H N | E G N;H
L U W S | U L S;W
T Y D L | D L Y;T
J V W D | D J W;V
F H P Z | Z P H;F
M Q G E | E G M;Q
X B P G | P X B;G
D W G V | D G W;V
I M X N | I N M;X
N J O Q | J Q O;N
R W Q H | W Q H;R
G E Z Y | G Y E;Z
K P C U | K U P;C
Y V D P | Y P D;V
F W V O | W V F;O
R J H O | H O J;R
H M G Z | Z G H;M
Y G W J | W J Y;G
V A I C | C A I;V
G L C E | C G L;E
N B T L | T L N;B
W Y I Z | I Z Y;W
S K I Q | I S K;Q
D O M Y | Y D M;O
G B A T | A T B;G
B G W N | G B N;W
H B C S | B S C;H
Q F K C | Q C K;F
I Y B A | I B Y;A
W I B Q | I B W;Q
I Y U T | Y U I;T
Z L W J | W Z J;L
K L A X | X K A;L
W F H V | W F H;V
P D X W | W X D;P
K Q A D | Q A K;D
P N Q E | N Q P;E
K M X N | K N M;X
K N V G | K G V;N
R N K B | K B N;R
V B E S | E S V;B
R B A C | R A B;C
Q J N U | N Q J;U
A Z D Y | A Y Z;D
Z J Y O | Y J O;Z
I J C U | I C J;U
G I L Q | Q L I;G
N U Z S | Z S U;N
X V I W | I X V;W
A Q H E | H E A;Q
R L M S | S M L;R
G J C B | G C J;B
R T V E | V R T;E
J E H V | E J H;V
B G Y P | Y B G;P
S O B V | S B V;O
X I M Q | I X Q;M
E F X T | E X T;F
R F K J | R K J;F
R N H T | N H T;R
Q V J G | G J Q;V
H Z V R | V H Z;R
X Q F W | W X F;Q
M B I D | I M B;D
D G C J | D G C;J
D F U L | F L U;D
X N D E | D N X;E
X K Y G | Y K X;G
O Q R V | R O V;Q
R X I N | X R I;N
A F U Y | F U A;Y
M D T Z | T D M;Z
Z F M A | M Z F;A
V Z O N | Z N V;O
L Y P A | L A P;Y
F O L N | N O F;L
I C O Q | Q C I;O
X W O N | X N W;O
Y J I M | I J Y;M
Q H V P | P H Q;V
X F J R | J X R;F
Y H M I | I H M;Y
H Y K Z | H Y K;Z
H B A Z | H B Z;A
P V H R | R V H;P
H K R D | H D R;K
H R T W | W T H;R
V L F J | L F J;V
E Q D C | D Q E;C
L Z K E | Z L K;E
H U D P | D H P;U
S Q O X | S X O;Q
S Q I W | Q S W;I
V B G S | S G V;B
C I R W | C W R;I
N H T R | R H T;N
W K F S | S W K;F
G E O U | G U O;E
I W H P | W I H;P
U L J K | J L U;K
J B T G | T B J;G
F S H E | H E S;F
S Z R P | S R Z;P
Y P T A | P T A;Y
P R Z H | R Z P;H
N E Q I | I E Q;N
W F P V | V W F;P
A H V T | T A V;H
L G E Y | G E L;Y
K Q B F | F B Q;K
T Y A S | A T Y;S
K Z D X | X D K;Z
U J E V | E J V;U
R A L S | R S A;L
K W X U | X W K;U
Y B E N | E N Y;B
A B D G | D G A;B
E H J K | H K J;E
X D A G | A G D;X
U P Y M | P U Y;M
Y T U Q | T U Y;Q
V R H N | V N R;H
K B P D | P D K;B
V A C O | O V A;C
E C Q H | C H Q;E
M T Z K | Z K M;T
D U L I | L U D;I
O X B C | O C B;X
H P I D | D P I;H
O G D P | O D P;G
V G R F | R V G;F
N G M T | M T G;N
H D U X | X D U;H
U E N S | S N U;E
Z G H Y | Y H G;Z
N F A O | A O F;N
H O S K | H S K;O
F Q O I | Q I F;O
G X E U | X E G;U
Q S F T | S Q T;F
U G B O | U G B;O
Q U N E | N Q E;U
Y I U G | Y U I;G
Z K L P | Z L K;P
T C Y W | Y T C;W
O K W I | O W K;I
X Z E I | Z X E;I
P I B A | I A P;B
O Z A H | Z O A;H
Y F E U | F Y E;U
C I P Z | C Z P;I
S G A E | E G A;S
X Q M R | R M X;Q
A V O I | I A O;V
D W I K | D W I;K
F L N Q | F Q L;N
V J M N | M J N;V
I L H B | B I L;H
S O C T | S O C;T
L H Z E | Z L H;E
U X C V | C V U;X
K A M O | A O K;M
O L H D | O L D;H
Z F V O | O F V;Z
N U F D | N F U;D
O E I J | I O J;E
G S L Q | Q S L;G
J I F X | I X J;F
V Y B I | Y I V;B
B F Y R | R F B;Y
T P X A | X T P;A
W S R A | R S A;W
M B P X | M P X;B
T E P A | T P E;A
T K J X | J X K;T
T F D P | F P T;D
I T G V | T G V;I
C O A S | S A C;O
C O Q Z | Q O Z;C
O R U Z | R U O;Z
X M T Z | M T Z;X
Y D G L | Y L G;D
M C E Y | M C E;Y
S Z T L | L S Z;T
D T P X | D P X;T
M W F K | K M F;W
B V M E | M V E;B
O I D P | D I O;P
F C T S | F S C;T
E W V J | W J V;E
Y D K N | K D Y;N
V L W X | L X V;W
D J A X | X J A;D
R M F W | R M F;W
N T A V | A N V;T
F V A O | A V O;F
S A H D | A H S;D
C Q F D | Q C D;F
R H P Z | H R P;Z
S Q X J | S X J;Q
Q E F X | X E F;Q
D E K A | D E A;K
R I Y U | R I Y;U
A N Q M | M A Q;N
A H G M | H A G;M
E D H A | H A D;E
P E H I | I E H;P
O T Q N | T Q N;O
L W U Q | W L Q;U
R C G L | R C G;L
P F W D | F P W;D
J N A Y | A N J;Y
F M W E | F E M;W
G R E W | R E W;G
M E L J | J M L;E
A Q D M | A M Q;D
V P J B | V J P;B
C P R X | C R X;P
E T R V | T R V;E
X V N I | N I V;X
C M T W | W M C;T
L Y Q U | Y Q L;U
J R F Y | J Y R;F
T Q N D | N Q T;D
N U W K | N U W;K
Z K P Y | K P Z;Y
G A H K | K A G;H
L S Q D | S D L;Q
P F W M | W P M;F
P K I F | F K I;P
S V K U | K V U;S
H E Q V | E H V;Q
Z X B Y | Y X B;Z
P J G S | G P S;J
J S I O | J S O;I
P A E N | A E P;N
L G I N | I L G;N
D F K Y | F D Y;K
Y J T Z | J Y Z;T
P O W R | O W R;P
Z O T J | J O Z;T
C O A E | A C E;O
V L M B | V L M;B
J L X H | L J X;H
O R H X | R O H;X
C P G D | P D C;G
J D I V | V J D;I
Q D W C | D W C;Q
X C O F | C X O;F
Q D L Z | Q D L;Z
Y Z Q X | Y X Q;Z
O N U T | O T U;N
T Y B I | I B Y;T
C H S Y | C Y S;H
Y E A C | C A E;Y
R J V L | J V R;L
A K R W | A W R;K
A P O B | A B O;P
U M W E | W U E;M
S M D Q | M D Q;S
I J S D | D S I;J
D M G R | G D M;R
U X V L | X U L;V
K J O T | K O T;J
E G P Q | P Q G;E
B M S D | M S B;D
E X S T | X E T;S
T A C E | C T A;E
V T H S | S T V;H
J H K I | I J H;K
T Z W V | T W Z;V
B H P T | H B P;T
T Y H I | H I Y;T
I K P L | I L K;P
D P E Y | Y D E;P
I H K U | U K H;I
F G S Q | S Q F;G
Z A Q V | Z Q A;V
C O Q E | E O Q;C
W D K Y | D W K;Y
T B X R | B X R;T
C D V W | V C W;D
J L M T | T L M;J
L T O C | O C T;L
L F E G | E F L;G
H K G W | G W K;H
N S C Y | Y N C;S
F Q E L | E F L;Q
O X M Y | X Y O;M
V L Q A | Q L V;A
J O M B | O B J;M
H S Y X | H S X;Y
M U W A | M W A;U
M P L S | L P M;S
D A Q R | Q R D;A
J T O L | O L T;J
B M O E | B M E;O
Y A F B | B F Y;A
L Z Y S | Z L S;Y
N T Z E | Z E N;T
W B A C | B A W;C
F X L Y | F L Y;X
V K J X | V J X;K
O D X F | D O F;X
L P D I | D L P;I
E S Z J | E S J;Z
M S G J | S G M;J
B N P R | R B N;P
P O D Q | Q D P;O
A U G Y | Y G U;A
E S A J | J A E;S
J L G X | L X J;G
C J G V | C G J;V
D B V U | V D B;U
X H N T | T X H;N
D S R V | D R V;S
L O T X | X L O;T
H G P Y | P G H;Y
S W M U | M U W;S
W H X E | W E X;H
B R L N | R N L;B
N F C J | J C F;N
B H W N | H N W;B
Q F Y I | I Y F;Q
Y F X E | E Y F;X
E D T L | T E L;D
B U H R | B U R;H
H D C T | H C T;D
N V D S | V D N;S
G Y B T | Y B T;G
U A S J | U S A;J
M R D Y | M Y D;R
Y M N L | M N Y;L
G P E N | P N E;G
X S Z T | X T Z;S
Y D C B | B Y C;D
X Y S I | X S Y;I
H B C J | C J B;H
G M X A | A G X;M
A F Q T | A T F;Q
J L R K | K J R;L
Y K B F | Y K B;F
W N P X | P N W;X
Y L C G | Y L C;G
P E L O | O P E;L
U O S Y | S Y U;O
E T G N | G T E;N
W H Y G | W H G;Y
Y R W L | R L W;Y
O H B A | O H B;A
Z T V X | Z T V;X
Z J K T | J K T;Z
G J H V | G J H;V
B Z N U | B N U;Z
T G J W | G T W;J
W G A S | W A S;G
G I B S | S B G;I
B E G U | B G E;U
R E D Z | R Z D;E
T I G E | G E T;I
R E H X | H X E;R
J O L P | L J O;P
S N V A | N A S;V
G B R E | B E G;R
N Z K G | G Z N;K
H R W N | R H W;N
F C N P | N P F;C
M T S J | M S J;T
G R Z M | G Z R;M
S E B Y | S E B;Y
H M G Y | Y M H;G
D O C H | C H D;O
Y W L G | G W L;Y
B C S U | B C U;S
D T Z V | Z V D;T
P Q S E | P S E;Q
K A H M | H M K;A
U B F D | F U B;D
D Q N G | N Q D;G
X N H W | H W N;X
E S V R | E S V;R
Q E C N | C Q N;E
A Q B Z | A B Q;Z
Y K F N | K N F;Y
E V K N | N K E;V
W I N J | I W J;N
H E Y D | H Y E;D
A I Q G | G A I;Q
A P U E | P E U;A
X G C Q | Q G X;C
P R G Z | R P Z;G
Z U J S | Z U J;S
K Y E X | X Y E;K
E O J W | E J W;O
J C P I | J P C;I
G N K M | K N M;G
L K U V | U V L;K
W T P J | W T P;J
R V M K | K R M;V
P A V C | A C P;V
P Y X H | P Y H;X
U K C M | C U M;K
P O Y C | P Y O;C
F U V P | P F U;V
D O N E | O N D;E
I U J P | J P U;I
M U X O | O U M;X
L O M W | L O M;W
A B K Z | Z A K;B
H U J Y | H J U;Y
R T N O | R N T;O
J Z R Q | Z Q J;R
O H X U | O X U;H
T A L Q | Q A L;T
H M R T | T M H;R
W A G Q | G Q W;A
M A N E | E N M;A
T S K Y | K Y T;S
R E K Y | K R E;Y
M B I X | B I X;M
V B O A | A V B;O
R M A E | A E M;R
W T H M | T M W;H
J F K A | K J F;A
T C A F | T C F;A
G E C L | L C G;E
Z Y G R | Y R G;Z
E Z P R | R Z P;E
L D M X | M X L;D
Q J G K | Q G K;J
P J I O | I O P;J
S D N P | S D P;N
U J C K | U C K;J
P N A Y | Y P N;A
K Q X C | C K Q;X
I R F Y | Y F R;I
G J V Q | V Q J;G
Z K S R | S K R;Z
I D B N | D N I;B
D W J P | P J D;W
E Q X L | Q X E;L
K U C O | O U C;K
B V Z S | S V B;Z
Y O W T | Y W T;O
A N H M | H A N;M
N V T S | T S N;V
S W D G | S W G;D
M D J G | G J D;M
G H W Z | H Z W;G
B D F P | D B F;P
K A B U | B U A;K
Q P G V | Q G P;V
E S P R | S E R;P
Q E J K | Q K E;J
J N E I | E J N;I
T A B R | B A T;R
Y D N K | N K D;Y
Z S C D | C S D;Z
H W L G | H W G;L
I U R G | I U R;G
I C J A | A C I;J
F M V C | C F M;V
P Q Y E | P Q Y;E
I W N E | I E W;N
O Z L H | Z L O;H
A L O F | L A O;F
S D A U | D A U;S
K I F N | F K I;N
N Y O K | O N K;Y
A U K E | E U K;A
O L R Q | Q O L;R
C D F P | D P C;F
L K X G | G K X;L
O Y K G | G O Y;K
N S A Y | Y N S;A
U J K O | J K O;U
U B A N | U B N;A
W R F J | F J R;W
Z E A D | E A Z;D
Z O U T | O U Z;T
P G E T | G E T;P
C U R H | C H U;R
M V Q N | V Q M;N
D P X J | D X P;J
P L X I | I X L;P
R D F B | F D B;R
Y C P K | P Y C;K
M K I J | J I M;K
O R E L | R O L;E
M W Y H | W M H;Y
M T Z S | M Z T;S
N I K M | K M I;N
J I T P | T P J;I
Y X R W | W Y R;X
H V F X | V H X;F
E F M N | E M N;F
S O A C | S O A;C
K B D J | D K B;J
D B H I | I H D;B
N P L A | L N P;A
I S V Q | I V Q;S
K B Z D | K B Z;D
M B K A | B K A;M
S A Y J | A J Y;S
T Z M H | Z M H;T
W M S F | M S F;W
F L Q Y | Q Y F;L
D Z J E | E Z J;D
U T E W | U T W;E
R I G Y | I Y R;G
Q D G E | Q E G;D
Z F N T | F N T;Z
D X L N | X L N;D
K Y L Q | L Q Y;K
I H B W | I W B;H
L T I X | X I T;L
Q S V L | S V Q;L
Q W B F | B Q W;F
S G Z D | G Z S;D
A Z Q B | B Q A;Z
D A S K | A D K;S
T V I F | T I F;V
G F Z O | Z O F;G
F T C Q | F Q C;T
U K L T | L T U;K
O V W P | P O V;W
A C Y I | I A C;Y
I Y T M | M Y T;I
D R U C | D U R;C
R A I K | I R K;A
P K O H | K P H;O
Q M L B | L B M;Q
V E D R | E R V;D
X S T C | T S X;C
N X F W | F X W;N
E O G V | E V O;G
G J H M | J M H;G
C B H Y | C Y B;H
N E H C | E C H;N
Y H B U | Y B U;H
U I T G | I T U;G
V L T O | T O L;V
Q V Y D | V Q D;Y
P Q D Z | Z P D;Q
K F V T | F V K;T
H X K M | X M H;K
Y W D V | W D V;Y
K G Z Q | K Z G;Q
Z N U H | H Z U;N
O I M B | B I O;M
P R Z V | Z V R;P
V L N M | M V N;L
K V G F | V K G;F
J W M R | M J R;W
B D Y F | D F Y;B
V H P B | B V H;P
H D M Z | H Z M;D
T P C X | C X T;P
U C Q V | V C Q;U
O X V Y | X O Y;V
C V X M | M C V;X
P Q O C | C P Q;O
L F M E | E M F;L
R Y F X | R Y F;X
V T C U | C T U;V
Y Z G X | Y X Z;G
G Q L I | G Q L;I
E Z T C | E T Z;C
A V Z J | Z J V;A
A M V C | M A V;C
Y V A N | Y N V;A
K I O Q | O K Q;I
F C E M | C F M;E
F T V N | V F N;T
M N G L | M L G;N
P I K V | I V K;P
K I O C | O K C;I
Y P O K | Y O P;K
H B L Q | B H Q;L
A J Y D | D A Y;J
D A T R | T R A;D
H W J E | E W J;H
J G S T | T J S;G
J C I B | B J I;C
M I S Z | S I M;Z
X A J R | J R X;A
R S P Q | P Q R;S
H Q F U | U H Q;F
N H U J | H J N;U
U V D P | V D U;P
E K F B | E K F;B
S A Q R | A S R;Q
W T S B | S B T;W
P V I F | V F P;I
X Q N Z | X Z Q;N
N A M D | N M A;D
I K D T | T K D;I
H W Z K | W Z K;H
Y S G X | X Y G;S
Y U I L | I Y U;L
D N Z F | D Z F;N
L O N Z | Z O N;L
Q L Z X | Q L Z;X
S Z Y P | Y S Z;P
E G W J | G W J;E
I Y S U | S U I;Y
B P Z L | P L B;Z
Z O M J | Z M O;J
N T F G | N G F;T
O W B P | W P B;O
X U K Z | U Z X;K
Z W O P | Z W P;O
G A I L | L A I;G
U R N S | N U R;S
O W U Q | Q O U;W
E G V T | T V G;E
K M R O | O R M;K
N Y C M | Y N C;M
J X P T | X P J;T
K W G P | W P K;G
S Y W K | K Y S;W
Z G O Q | O Q G;Z
P N X W | N W X;P
Q V B U | Q B U;V
C G W Q | Q G C;W
P R S U | U S R;P
Q X S Y | S Q X;Y
M U Y G | G U Y;M
I A E F | I F A;E
P R C Z | P C R;Z
V H Q C | H C V;Q
Y K U D | K D U;Y
J V R O | R J V;O
T V O M | T O V;M
Q M T I | M T I;Q
W C P O | C W O;P
W L A G | G L A;W
F G R N | N G F;R
M C S Y | Y C M;S
Y Z W E | E Z W;Y
J M O W | O W J;M
Q I P C | C I P;Q
P N T D | N T P;D
K V H C | C V K;H
V E K D | K V E;D
W O E P | W E P;O
T W B Y | B T Y;W
I N L Y | N I L;Y
L W K Y | W L K;Y
U Z P I | Z U P;I
C K P J | K J C;P
Y M N R | M N R;Y
U K C Q | U K C;Q
X I J P | X I J;P
O L P F | F L O;P
P W E R | R P E;W
E R M F | E M F;R
O V P W | V P O;W
F S A I | A F S;I
K T G Z | K T G;Z
D L J H | H D J;L
L G K T | T G L;K
O Z D T | O Z D;T
E I F T | F T I;E
S L R Y | S L R;Y
W S D V | S V D;W
T Y H S | Y S H;T
D X Y I | D Y I;X
N D A F | F A D;N
D B J F | J D F;B
V W O H | W H V;O
X Y R E | E Y X;R
V E T H | H E T;V
N C U L | N L C;U
G F P N | N F P;G
D G N A | N G D;A
D K Y N | Y N D;K
N X Q R | Q R N;X
H M A W | M H W;A
E P B W | P B W;E
S Y K O | Y O S;K
V A X S | A V S;X
X W L K | X L K;W
A T K I | T K A;I
D N C Z | C Z N;D
L H Y R | R Y H;L
R L T O | O R T;L
V O W C | C W V;O
V O B L | V B O;L
H G W R | R W H;G
G I J S | J G S;I
B K O M | K O M;B
R W X E | W R E;X
K W M D | D W K;M
F L S O | S L F;O
L A H M | L H M;A
H J M U | J M U;H
H Z G K | H G Z;K
P K R F | K R P;F
L X E Z | L Z X;E
Y G D P | D Y G;P
X Q V Z | V X Q;Z
L F G C | F C G;L
I G N E | I E G;N
C P S O | O S P;C
Q E D H | H D Q;E
F R X G | G R X;F
N E A F | E A N;F
C K S Y | Y C S;K
Z E R C | R Z E;C
D T K L | T L K;D
I M S V | V I S;M
I L S Y | I L Y;S
Y I E T | E I Y;T
Z H I L | Z H L;I
L I O F | L I F;O
S B L J | L B S;J
Y E J L | J E L;Y
Z J B R | B Z R;J
T U D V | U D T;V
Q R A S | R Q S;A
O Z F H | Z O H;F
N T Y C | T N C;Y
W N O Y | N O W;Y
V C T S | S T C;V
T L M S | L T S;M
I L M X | L M I;X
J B C Z | B C J;Z
G L C Z | C G Z;L
G K Y V | Y G K;V
O C D M | M O D;C
N U E R | E R U;N
A F V R | A V R;F
I T J C | J C I;T
W Q B K | B W Q;K
G R P W | R P W;G
L S M H | M H S;L
B L F M | M L B;F
T K F X | T X K;F
N X J E | J E X;N
I X M W | W M X;I
W C J E | E J C;W
W K F D | W K D;F
A H M D | M H A;D
V X I B | V B X;I
D M H Q | M D H;Q
X A L Q | X Q A;L
B J L E | J E L;B
F G Q O | G Q O;F
J W Y T | T J W;Y
P W J C | J P W;C
H Z X S | X H S;Z
Z I F A | Z F I;A
U W X Q | X W Q;U
S T M I | S I T;M
C R Q Y | R C Q;Y
D I A V | A I D;V
R E Y W | W Y E;R
L J W S | W L J;S
J S Z H | H J S;Z
O T E Y | Y O E;T
E O G S | S G E;O
N S V E | E S N;V
R Y Z X | Z R Y;X
J W T P | W T J;P
V O M K | K O M;V
W M V Z | Z W V;M
K G D H | G K H;D
Z E S C | C Z S;E
V Z O X | V Z O;X
N R X J | X J R;N
B A G T | T A G;B
P D Q R | P R Q;D
X Q L C | C Q X;L
H J X W | J H W;X
C H J G | G J H;C
I L R M | L R M;I
F P L G | F L G;P
G C S Z | Z G C;S
G N B F | F N G;B
J P Q A | P J Q;A
K I G Z | I G Z;K
D X G Y | Y X D;G
M B P J | J P B;M
M V E G | E M V;G
A T F I | A I F;T
F O G M | G M F;O
D Q J F | J Q D;F
W X H N | N H W;X
X W C B | B C X;W
M A I B | B A M;I
C G S Q | Q C G;S
D O V Y | O D V;Y
E C H I | I H C;E
Y U L Q | U L Y;Q
X Y A M | A X Y;M
L P Y T | L P Y;T
K O U Y | U Y O;K
P J E R | J R P;E
A J Q L | A Q J;L
E C O X | E X O;C
W A L Y | W Y L;A
H V K N | K H V;N
T R Z A | Z A R;T
X Y K G | Y K G;X
R B E Y | R E B;Y
S B O V | V B O;S
U X P J | P X J;U
L P Y W | P L W;Y
T Z L A | T A Z;L
Z S K Q | Q K S;Z
C N S H | C S H;N
G P V J | P V G;J
N O S T | N S T;O
B K P N | K B P;N
Q U V K | V Q K;U
I E F U | U E I;F
A B C I | B A C;I
F M I O | M I F;O
O M R C | C M O;R
P R C M | C R P;M
V T O I | O T V;I
F Q G M | M F G;Q
J Y P E | Y J P;E
L F J U | J L U;F
G H T M | T H M;G
M C F I | F C M;I
V Y U F | F Y U;V
K H J F | F K J;H
G Y M W | Y W G;M
Y C L T | C Y L;T
U K L B | L U B;K
C V G F | F C G;V
B Q L T | L B Q;T
O Q N V | N V Q;O
M Y S G | Y G M;S
B R I C | C I R;B
Z Q D A | Q D A;Z
E N O Z | O Z N;E
H F L O | O F L;H
F Z K P | K F Z;P
W T D Q | D W Q;T
D C Q O | Q O D;C
E R P L | L P E;R
R C T L | T R C;L
T Z R V | R T Z;V
V D G P | P D G;V
A Z O Y | Y Z A;O
W V O S | O W V;S
J L T D | T D J;L
H O S Y | S H Y;O
N D L T | L D T;N
R L G E | G E R;L
M O T X | T M O;X
I D R W | W I R;D
V R P J | V J P;R
Y A R G | Y R G;A
S G E J | E S G;J
R D F E | R E D;F
X R C Q | Q C R;X
W C E U | C U W;E
C N Q H | H N Q;C
D M Q K | Q M K;D
K Y X V | V Y K;X
F Z A Y | A F Y;Z
P N C A | C A N;P
X N V Y | Y V X;N
D Y H G | D H G;Y
L Z P F | Z L F;P
Y Q D U | Y U Q;D
F W K Q | F W Q;K
I C Z B | C B Z;I
R I V J | J V R;I
S B J R | S R B;J
Q P T Y | P Y T;Q
A V H G | H G A;V
L J F G | J G L;F
M W D I | I M D;W
F C I L | I F C;L
J M E B | B M E;J
S E M L | L S M;E
J D K W | D K W;J
W C G N | C N W;G
B M J R | R J B;M
P S X R | X P S;R
C F X T | T F C;X
B I R E | I B E;R
A M N B | A M N;B
A O P J | A P O;J
E F W Z | E Z F;W
S I Q C | C Q I;S
K L U X | X L U;K
Q B O C | C O Q;B
M X A L | M L A;X
I U E R | U R I;E
M G C V | V C G;M
X D L H | X D L;H
P O T J | J P T;O
E X D W | E D X;W
G M N W | G M W;N
E W K V | W K V;E
U L K I | U K L;I
D P C Y | C D Y;P
V N Y R | Y R N;V
V C L N | N V L;C
K E S H | E H S;K
M V O X | X O M;V
D Z L X | X L Z;D
V P S E | V E P;S
K F W Y | Y W F;K
A W Z P | W Z P;A
B Q I F | I Q B;F
B W H V | V W B;H
M Z X L | Z M L;X
G T V S | T S G;V
H B O F | H F B;O
A T V X | A X T;V
G Z V A | G V A;Z
P X E H | X P H;E
S X A B | X B S;A
J F A W | J F W;A
L H Q U | H U Q;L
R J V K | V R J;K
V K A U | K V U;A
F C A E | C A F;E
U N Z X | N U X;Z
F E I X | E X F;I
V L B M | B L M;V
W B Q L | Q L B;W
L H W Y | W L H;Y
J P S N | S N J;P
C F U R | F U C;R
X P B C | B P X;C
B L C F | B C L;F
O E V Z | Z E O;V
Y D X H | Y X H;D
Q C E F | C Q F;E
V Q P T | T P Q;V
U X Z M | Z U X;M
T X J L | X T J;L
A G D V | V D A;G
M X Y V | Y V X;M
K S P F | K S P;F
C G W F | C G W;F
H T B V | B V T;H
A C K Z | A Z K;C
M T J S | T S J;M
M S B V | V S M;B
Y X B P | Y P X;B
G A Q S | S Q A;G
W J Q U | W J U;Q
P L Y K | K P Y;L
S Z M B | B M Z;S
B L S V | S V L;B
R C N W | N C R;W
S Q H A | A Q H;S
E L D Y | L E D;Y
F G J Z | J G Z;F
M G X Z | M X G;Z
U B Q E | U E Q;B
S F W B | B S F;W
X E Q Y | Y E X;Q
Q D L X | D X Q;L
M U X T | X T U;M
Z Q J V | Z J Q;V
S N O J | O S J;N
J X C V | C X V;J
X V D S | V X D;S
R F Z P | P R F;Z
A J V C | J C V;A
K R C X | C K R;X
W D V H | D H V;W
A L B G | G L B;A
H M V B | V B H;M
T Z F G | G F T;Z
V T Q G | T V Q;G
S U H N | N U H;S
S R L H | H S R;L
Q O W M | M Q W;O
F T V L | L V F;T
B M A K | A B M;K
X H M Z | H Z M;X
N S O E | S N E;O
S J W Y | S J Y;W
V Z I R | I V Z;R
C R Z A | A C R;Z
H Y R N | N R H;Y
Q P A N | N A P;Q
B N Q T | N Q B;T
G I Q J | J Q I;G
O V R M | O V M;R
P U C X | P C X;U
O I F N | I F N;O
W J V C | J W C;V
C Y I B | Y I C;B
E O F G | O F G;E
T P W O | P O W;T
M H J G | M G H;J
M W G S | S G M;W
K F L S | F K L;S
T U J H | J T U;H
T Q A Y | Y A T;Q
P H Z U | H P Z;U
Y R S U | S Y R;U
K S I Z | I Z S;K
D L S M | S D M;L
G T Q R | T R G;Q
V P Q H | P H Q;V
D T L O | T D O;L
F D V X | D F V;X
T H Z B | H Z T;B
M C O V | M V O;C
N Q E S | E S Q;N
W P Q T | T Q W;P
B L T Z | B L Z;T
A Y T J | T A J;Y
N M O W | W N M;O
E C Y U | E U Y;C
B N G S | B N S;G
R G Z I | I R G;Z
H E A C | A H C;E
N A G O | A G N;O
L B G H | L H B;G
L N F J | F N J;L
Z C M R | M R C;Z
G J X F | G X F;J
G X I K | X G K;I
M B C Q | M B Q;C
H M Q S | H M S;Q
D E P N | N P E;D
Y N Q J | Q J N;Y
C M I K | K I M;C
K Y M J | K M J;Y
T O L I | L T O;I
P V C Q | C V Q;P
A K R Q | R Q K;A
R U D J | D J R;U
B H I S | S B H;I
R K Z C | C R K;Z
O B Y N | O Y N;B
U L K D | D U L;K
I Z U D | U I Z;D
T Y R V | T R V;Y
F Z G Q | F Z Q;G
R B A T | T B A;R
D H X M | H D X;M
U E D G | U E G;D
T S P G | P S G;T
K X N B | X N B;K
B N J E | B J N;E
P T C K | P K T;C
R A P N | N R A;P
D U O C | C D U;O
B M K U | U K M;B
Q G I J | I G Q;J
W R E B | B W R;E
D J G E | J G E;D
T R A S | A R T;S
K L Y J | K Y L;J
A D L Q | D Q L;A
O U J A | O A U;J
Y Q M U | Q U M;Y
I F Q O | O Q F;I
W D Y F | W F D;Y
B P V Q | Q V P;B
A I H B | B H A;I
Z O L H | O Z H;L
V H L W | V H W;L
R V T N | N T R;V
B J Q M | Q M J;B
K C G I | K C I;G
U S N Z | S N Z;U
B F G O | G O B;F
X G D O | X G D;O
L I C N | C I N;L
T I N E | T E I;N
K H V T | H V K;T
E A P W | E W P;A
A Z W B | B Z A;W
O N H Y | H Y O;N
W S J C | W J C;S
X B F U | X B U;F
Y T P B | T P B;Y
E P X N | E X P;N
V A N D | D V N;A
P N O X | X N O;P
J D S C | C S D;J
X S O B | S O X;B
X A D Y | D X A;Y
U C Y T | Y T U;C
U G N Y | G Y N;U
F W D J | D F J;W
C I H U | U I H;C
Q Z B F | B Q Z;F
R A X I | A X R;I
K M O J | M O J;K
Z J C M | C M Z;J
B D W K | K W D;B
F I G Z | F G I;Z
Z D Y N | Y D Z;N
V L H Y | V H Y;L
P K M V | K P V;M
E W J U | W J E;U
P M A E | M E P;A
N E G P | P E N;G
Z K R Q | K Q Z;R
G B C H | B H C;G
W D T B | B W D;T
J H D C | D J C;H
R U M H | M R H;U
F S Z V | V Z F;S
X R B J | B X J;R
T E X K | K X E;T
X L J U | L J U;X
U J M O | U J M;O
Z N C J | J Z N;C
D M S A | D M S;A
A F G K | G F K;A
Z Q R X | X Q Z;R
Y U I A | I U A;Y
S E K H | E K S;H
K B A Z | Z B K;A
M V W R | R M V;W
L S O C | L C S;O
D S G W | G D W;S
U B D Z | B D U;Z
D C R Z | Z C R;D
U P W G | W U G;P
H L N X | L N H;X
E D R F | R F D;E
C E S T | E S C;T
C V W N | C W V;N
K A L W | W K A;L
Z A C K | Z A K;C
G B M O | B O G;M
Y W E J | W J Y;E
M Q D S | S Q D;M
G A P R | G R A;P
X Y J U | Y X J;U
U F Z V | U Z F;V
C P Q Y | C Q P;Y
S N Q C | Q N S;C
A O P B | A P B;O
D W S Q | Q S W;D
M R Y L | Y R L;M
T C B U | T C U;B
J V S F | F J V;S
V J K Y | K J Y;V
I X S W | X I S;W
T V L G | T G L;V
C O L K | L O C;K
U F Z J | J U Z;F
D W X Q | D W X;Q
K H O Q | H Q O;K
P S B N | S B P;N
O Z H D | Z O H;D
U X N R | X R N;U
F L P C | L C F;P
D F R J | D F R;J
A Q J V | A J V;Q
Z T P U | T Z P;U
G B V W | G B W;V
L Y V N | N Y V;L
R L T B | B L T;R
B V Q R | Q R V;B
A C F O | F O C;A
X C M Y | M C X;Y
Z R N T | T N Z;R
T I O G | T G I;O
R Z Y D | R Y Z;D
Y M B H | Y B M;H
A Z O F | O A F;Z
G O Q H | O H G;Q
Z N B P | P N B;Z
B L S H | B L S;H
L Y C I | Y L C;I
Q W L Z | L Z W;Q
R I N H | R N H;I
Z H I B | Z H B;I
Q M J G | Q G M;J
B X Y F | Y F B;X
S J O A | O A S;J
Z X F K | Z F K;X
N U C R | N U C;R
P O U L | P O L;U
D K F H | F D H;K
W O N G | N W O;G
T O V J | V J T;O
J Z W Y | Z Y W;J
D H I M | I D M;H
A F I X | X I F;A
J S U P | S J P;U
A L H I | H L A;I
B O A N | A B O;N
S E I O | O S I;E
L J W F | W F J;L
Q L I Z | L I Q;Z
V Z N Y | N V Z;Y
S M H L | H M L;S
A L D C | L D C;A
H U Q L | U Q L;H
J I O Z | J Z O;I
E S K F | K E S;F
D X I R | D X R;I
T H N R | R H N;T
U W G J | U G J;W
Y L X V | L X V;Y
G D Y F | Y G F;D
K H I J | I K H;J
F W M P | W P F;M
S U R X | R X U;S
H D I G | H I G;D
N J D R | R J N;D
E I P H | P I H;E
V C U I | U C I;V
U Q K Z | Z U Q;K
O I V N | O N I;V
O Q A U | U A O;Q
Z N L O | O L Z;N
Q A B U | B U Q;A
J V W D | J V D;W
V R N J | R J V;N
H M T X | H M X;T
Q P E D | D E Q;P
R V E A | E A R;V
L B C H | B L H;C
H K W L | L H W;K
P U F J | J F U;P
K Y E F | E F Y;K
O R E F | R E F;O
T Q B A | T B Q;A
M O V H | O M V;H
I J V A | A V J;I
E U Y D | D Y U;E
R X S W | R S W;X
X E Z I | E Z X;I
S Z T G | Z S G;T
L K R Z | R Z L;K
N K W J | J W N;K
M Z O T | T O M;Z
D B I N | I D B;N
P V D S | S D V;P
A W K U | A U W;K
Z P A B | A Z B;P
T N I Z | T I N;Z
X T D H | H D X;T
I G C K | C K G;I
B P E Z | Z P B;E
G B H A | A H G;B
R D U W | D U W;R
O D I S | D S I;O
T X H E | E X T;H
G B D R | B G R;D
W B V N | N W V;B
V B U G | V G B;U
P V W Y | Y P V;W
L U Z V | V Z L;U
Z T S Y | Y S Z;T
E O K D | K D E;O
B E W H | W B E;H
F W O N | W O F;N
E V S D | V S E;D
H W P L | W P H;L
J L F I | L F J;I
N C W S | N S C;W
W L A O | L W O;A
A Q F O | A Q O;F
B H P N | N H B;P
U G Q P | Q P U;G
A R M Z | R Z M;A
W K X S | S W K;X
L T N Q | T L N;Q
Y E T A | A E T;Y
W S M Y | M S Y;W
E N B O | O B N;E
V Z N J | J Z N;V
W U I O | I U O;W
J K Y B | B J Y;K
B S A G | G A S;B
O U R V | O R V;U
Q C V W | Q V C;W
H L Z R | H Z R;L
K M C Q | M K Q;C
S A C U | A U S;C
J N V T | J V N;T
T A N R | R A N;T
L M C E | C L M;E
A M P S | M A P;S
J N X I | N I X;J
N I O X | O I N;X
C P K T | C P T;K
K A Y N | Y K A;N
R Y S B | R Y B;S
J X M I | I M X;J
V W T A | W A T;V
I M P S | P I M;S
C O Q Y | Y C O;Q
K J N Q | J K N;Q
E O X G | O E X;G
K A T C | T A K;C
Q O L H | O H L;Q
J K W A | A J W;K
N G O Y | O Y N;G
P F D V | P F D;V
Q E W N | W N Q;E
R I C B | R I C;B
B M L U | M L U;B
Z N P L | P N Z;L
X F T V | T V X;F
X I M S | X S M;I
D B O J | B O D;J
A N B Z | N A Z;B
A X C P | A X C;P
R K H Q | Q K H;R
T N H K | N K H;T
Y F W I | I Y W;F
I Y D N | I Y N;D
P Z G F | P G F;Z
E N B Y | E Y N;B
O R Q Z | Z R O;Q
N H L A | H L N;A
D V P H | H V D;P
B L Z G | G B L;Z
R A V F | A F V;R
A T Z W | W T A;Z
P F O M | F M O;P
X V Q K | V Q X;K
A P S G | S P G;A
J K Z I | J I Z;K
U Z V W | U V W;Z
Z P C O | P O C;Z
C M I Q | I C Q;M
B P D Y | P D Y;B
P Z L F | P F L;Z
C I A V | C A I;V
C Z B D | D C Z;B
N Z D O | N O D;Z
M V U W | V U W;M
L P G Q | P Q L;G
O S Q B | B S O;Q
Y S F M | Y S F;M
Q E J G | J G Q;E
V U F K | F U V;K
Y C F P | F P C;Y
Y F B E | B Y F;E
R I T K | R K T;I
B X Z R | R Z X;B
X T N Y | T N X;Y
O H T F | O F H;T
B G C E | E G B;C
P K V F | V F P;K
W O B S | W B O;S
D F U W | W F U;D
O Z K L | Z K L;O
R M O Q | O M R;Q
Q C O G | G C Q;O
S P A O | P S A;O
Z C L R | C R Z;L
Y T P U | T U P;Y
B I Q V | V B I;Q
T H M J | H M T;J
W I M N | I M N;W
C P G Z | C G Z;P
C N D M | N C D;M
C G Q P | P G Q;C
I O J T | T O I;J
K Z V U | V U Z;K
M F G B | M B F;G
E J K Y | Y K J;E
M C L R | C L M;R
D Q C E | D Q E;C
Q S N Y | Y Q N;S
U Y E H | E Y H;U
G J T P | J G P;T
Q R W U | W Q R;U
K A F T | F A T;K
L P F O | P L F;O
W U E Q | W E Q;U
P K B G | P B K;G
U W O M | M O W;U
Y I A T | T Y A;I
S L K O | S O K;L
R Q S T | T R Q;S
H A G B | B G H;A
P J Y B | Y P J;B
Z M F S | M S F;Z
R C Z H | H Z C;R
F B L O | B L F;O
N Y T F | T Y N;F
Q A Z X | X A Q;Z
U P Y O | O P U;Y
H U P V | P U V;H
Y W D I | Y W D;I
F X A D | F X A;D
C D E Q | E Q D;C
X U P T | T X P;U
L Q B E | E L Q;B
X J N Y | N J X;Y
K L A Y | Y K L;A
J H L W | H W L;J
D H V L | V D H;L
D Y E L | D Y L;E
F K Z T | K Z T;F
N Q X M | Q X M;N
D P E A | P D A;E
P H B G | B G P;H
Q G K S | K G Q;S
U D C G | G C U;D
B D R N | R D N;B
C K J X | X K C;J
T V L Z | T V L;Z
Y G R V | V G R;Y
T R V J | R J T;V
F L J T | F T L;J
L X B O | X B O;L
X J Q M | J X Q;M
U K H X | K X U;H
V P X R | V P R;X
I V N F | V F N;I
D L H Y | H L D;Y
Y T G H | G H Y;T
U Q M A | M Q U;A
Y L K Z | K L Z;Y
R V G A | G V A;R
W N M E | E W M;N
A N S Q | N A S;Q
R F C Y | R Y C;F
N S A Q | S Q A;N
H S R J | H J R;S
O X T S | X S T;O
P B U I | B U P;I
H T C Z | T C Z;H
E B Y P | E B Y;P
I P N L | P I L;N
S R X N | R S X;N
I T A M | M I T;A
L M F T | M T F;L
R F W Z | R W Z;F
D R G J | R D J;G
J A V O | J V O;A
X P Y V | P Y V;X
D W X P | W X P;D
D G V Q | Q D G;V
Q P U B | Q P B;U
B G Y R | R G Y;B
P V M Y | Y V P;M
S F B P | S F B;P
V F Z W | F Z W;V
N J Z T | Z T N;J
V I T S | S T V;I
S G W P | S G W;P
S H P U | H S U;P
W Z O M | W M O;Z
V B N R | B R N;V
G T L H | L T H;G
D P F H | F D H;P
H T D Y | D T H;Y
A G F N | A G N;F
N X W Q | N Q W;X
V M H U | V U M;H
V U K P | K P V;U
Z R W V | W Z V;R
H N K M | H N K;M
F Q T G | Q T F;G
T J I P | I T J;P
U M Z I | M U I;Z
J K S P | J K P;S
A R L Y | Y L R;A
Q O E R | Q O R;E
M Q P C | M Q C;P
H X G S | S X H;G
F K H L | F H K;L
U X Y Z | U Y X;Z
S H J E | H E J;S
H P T L | H P L;T
D T K G | G D T;K
H S V O | O V H;S
J O X P | X J O;P
Z B I Y | B Z Y;I
X S H W | X H W;S
L A P Z | P A Z;L
E H U L | L E H;U
I M J V | V J M;I
A J E D | A J E;D
X L Q C | X L Q;C
X Z P U | Z X U;P
X G S B | S G B;X
L B N W | N B W;L
J C L B | J B L;C
Q A M P | M P Q;A
Y U F G | G F U;Y
W F H K | W H K;F
Y K S F | K F S;Y
S L J E | J S E;L
W A M Y | M Y W;A
H P X M | X M P;H
F B Q K | Q F B;K
V N C A | A C N;V
Y F V N | Y F N;V
Y A S W | S A Y;W
Y Z M Q | M Z Y;Q
N I K Q | Q N K;I
N O S J | N J O;S
V Z D A | A V Z;D
N K I Z | N I K;Z
Q P I B | Q I P;B
Y U M B | M Y U;B
X P W I | W I X;P
F P I L | L I P;F
T Z H K | T H K;Z
P F O E | F E P;O
N M H B | B M H;N
I K A E | E A K;I
Y A M N | A N Y;M
J G R I | G J I;R
D O P Q | P Q O;D
M H W V | V M H;W
J L O U | L O U;J
E F O B | B F E;O
H Q U E | U Q E;H
H C Y B | C H B;Y
Y Z K U | K Y Z;U
K E W Q | E W K;Q
W D O N | W D O;N
N R E X | X R E;N
K C Z W | K W Z;C
K Q E I | K Q E;I
Q U B H | H Q B;U
Z Y E L | Y Z E;L
I E H F | F I E;H
Y P L D | Y P D;L
C Z Y O | Y Z C;O
E Q Y D | Q D E;Y
G R T L | T R L;G
C E U N | C U E;N
T W N S | S T W;N
X D C R | D R C;X
N K B Z | K B Z;N
W P C I | W P C;I
O F K J | O F K;J
K W L Y | Y W L;K
D C L V | D V C;L
Z O H D | H D Z;O
B A T S | B T A;S
T O M N | O M N;T
Q O M N | O N M;Q
S U P V | S U V;P
T M F K | M F K;T
E W J S | E S W;J
K L H V | V L K;H
C N A H | A C H;N
Q C N W | W N Q;C
A Y M Z | M Y Z;A
H T J M | J M H;T
R G F L | G L F;R
I M P S | M P I;S
C O H Z | H C O;Z
I J N K | K J N;I
T A V E | T V E;A
M I L V | M V I;L
Y R H A | Y A R;H
O A V S | A V S;O
K C X W | X K W;C
D F Q E | Q F D;E
I J W R | I R J;W
X F O H | O H X;F
Q J R Y | Y J Q;R
S N W U | U W S;N
E Z X O | E X O;Z
V M O T | M V O;T
V J H B | J V H;B
D B A M | B D A;M
Q U T S | S T U;Q
W P R S | S R P;W
M O C Z | Z M C;O
Q A U E | A E Q;U
O M F X | X M F;O
P A N H | P N H;A
Y X U N | U X N;Y
C H K A | K H C;A
D Q X I | Q D X;I
T Q S P | Q S T;P
Z M K X | K Z M;X
I U N W | I W U;N
Y P C L | P L Y;C
V H O S | H O V;S
D B X S | X D B;S
I M Z A | M A Z;I
I E N A | I E N;A
A S Z J | Z A J;S
R J Q U | Q J U;R
X L Y A | X A Y;L
M N E O | N O E;M
P N W Q | Q W P;N
E K A Y | K Y E;A
E X H L | E X H;L
D A C S | D S C;A
P O C Z | Z P C;O
N V L Y | V Y L;N
J H B M | M J H;B
A R F U | A R F;U
G V R C | C V R;G
Q R N L | L Q R;N
D U I R | U R I;D
Q Y I H | H Y Q;I
H X M S | H M S;X
E I Z D | E D I;Z
B P U S | P S U;B
X W H I | I H X;W
R F M H | H M F;R
C N V F | N V C;F
J U Z I | U I J;Z
A N G E | A G E;N
B F V D | F V D;B
D J O X | X J O;D
V Y W P | P Y W;V
J L F N | L F J;N
E D Q X | E Q X;D
W T Y H | H Y T;W
K Z Q R | Z Q K;R
W O C F | O W C;F
S X J U | X S U;J
L W E B | B E W;L
Z Q O G | O Q G;Z
I C J L | J I L;C
V Q G I | Q V I;G
G T O J | O J T;G
E Q H G | Q G H;E
F S V G | V F S;G
T D C X | X C D;T
Q O N F | Q F O;N
V B L K | V K L;B
B E D X | B X E;D
P N U L | N L U;P
J U S K | K U S;J
J G N V | J G V;N
C J N S | J C S;N
K X F H | X K H;F
Z T O Y | T Y Z;O
P C D N | D C P;N
G L I Y | L I G;Y
N R U H | U N R;H
X W R Y | X Y R;W
P H B C | C P B;H
W J I U | U I W;J
P F O Q | O Q F;P
O U F N | U F O;N
G W Z C | W G C;Z
Z S N L | N Z S;L
E C H U | U H E;C
S I K A | A I K;S
I J M K | M J K;I
A D U L | A L D;U
C W G P | W G C;P
F T Q Y | F T Q;Y
P E U R | P U E;R
H L C F | H F L;C
N M C I | N M C;I
Z S J A | J Z A;S
I Y Z L | I Y Z;L
V G K Z | Z G V;K
M B Z S | B Z S;M
C I A E | E I C;A
U M A X | M X U;A
O L K Q | K O L;Q
M W V N | W M V;N
Q U C D | U Q D;C
C E J P | P C E;J
D L E X | L X D;E
I X O H | O I X;H
H E Q V | Q H V;E
X H D F | H F X;D
M J C W | W C J;M
H I G E | E H I;G
B T J I | J I B;T
I Q V O | Q I O;V
Y Q N G | Y G N;Q
P N F H | H N P;F
P R T L | R P L;T
N G C H | N H C;G
X E T A | E A X;T
H U V W | U W H;V
Z X U E | Z U E;X
M I P H | H P I;M
S Q U H | Q S U;H
Q R S G | Q G R;S
G K E X | G K E;X
H J R E | H E J;R
A C N M | C N A;M
B I Y Q | B I Y;Q
N S J W | J W N;S
Z Q W S | Q W S;Z
M O X R | O R M;X
E T J H | E J T;H
E H I A | E I A;H
P O A E | A E P;O
Q V F U | F U V;Q
K G B W | B G K;W
K Y C B | K C Y;B
L R P A | L P R;A
W M P G | G M P;W
E J Z D | E D J;Z
V Z C D | D V Z;C
U D T Z | Z T D;U
W R U I | W U R;I
P E S X | S E X;P
E B O M | O B M;E
X T B Z | X B T;Z
D Z X N | N D X;Z
R G F Z | F R G;Z
A C G D | A C G;D
E C Z I | Z E C;I
M X L U | U L X;M
B K J C | C J B;K
L S O V | O V S;L
Q R E U | Q E U;R
T O M J | T O M;J
I X E R | X I E;R
P Z O S | Z S O;P
G R W H | R W G;H
W C G A | G A W;C
K H G A | A H G;K
L N U P | U L N;P
H U D K | D K U;H
R E T B | B E R;T
W P U L | L P W;U
F Q W Z | Q W Z;F
L H U C | H L C;U
G R T K | R T G;K
Q V A F | Q A V;F
M N S W | M S N;W
I T Z S | I S Z;T
V Q I G | Q G V;I
H R V C | H R V;C
N O T X | N T O;X
T B O E | B O E;T
Z B C J | C Z B;J
B F D N | B F D;N
S E M A | M E A;S
Z R H K | H Z R;K
U F X Y | F Y U;X
K A D C | D K C;A
K M S F | S K F;M
C U N R | U C R;N
Y Q F L | Q L Y;F
N C O T | N C O;T
W H S V | S V W;H
T W I Q | T Q W;I
S T Q P | T P Q;S
N J Z M | J M Z;N
R F I T | I F R;T
Y R W M | M R W;Y
Q W K Y | K W Y;Q
K C R T | T R C;K
R W V B | R V B;W
D P X K | D X K;P
B O L E | O E B;L
I P X N | N P I;X
E N O P | O P E;N
K V Q C | K C Q;V
H X U Z | Z H U;X
K L Q C | L Q K;C
Q S X O | Q X O;S
G N U O | U N G;O
L R O H | L O H;R
R B G C | R G B;C
Z Y Q K | K Q Z;Y
L T M Z | Z M T;L
Q U L X | Q U X;L
Q G P K | G K P;Q
V K Y S | Y V S;K
A F S Q | Q S F;A
B S C V | S B V;C
C V G N | G N C;V
D K V S | K V S;D
G F S O | O F S;G
B O K W | O K B;W
A I X Z | A I Z;X
I G H X | I X H;G
O A W D | O D W;A
F Z W P | Z P W;F
V T M X | T V X;M
F Y N T | N T Y;F
J G Z Y | J G Z;Y
I M G P | I P G;M
B F O E | E O B;F
N R O B | R B N;O
Z K P R | R Z P;K
V H C A | V H C;A
F N X Z | Z N X;F
H B K F | F B H;K
C J F T | J C T;F
A S P E | S E P;A
D X N Q | D X N;Q
E J Z D | D J E;Z
D U H W | H W D;U
X R T H | R H X;T
A H O S | S O H;A
S K J O | S J K;O
U D E G | G D E;U
A C X U | U A C;X
P S W Z | W S P;Z
A Y O S | S O A;Y
P S Y A | Y P S;A
O D A Y | Y D A;O
S M L X | X L M;S
O U B G | O G U;B
B X D W | B X D;W
E H I Y | E I Y;H
W D G F | W F G;D
O E P V | O V P;E
M T B Z | Z T M;B
U W S Q | W Q U;S
J Q U T | T Q J;U
Q E X D | E D Q;X
S D O Y | Y S D;O
A D X N | X D N;A
Z H C U | H C U;Z
F W X B | F X W;B
K E C D | D K E;C
Z K O X | X Z K;O
V B O U | V B U;O
M V Z G | V Z M;G
T B V C | V C B;T
L B V R | L V R;B
S L O E | L O S;E
W K L M | K M W;L
V E P W | E W P;V
I D U J | J I U;D
K O A H | H A K;O
Y X J B | J X B;Y
Z N P K | K P Z;N
U B R W | U W R;B
I H X Z | H Z I;X
E D Y X | E X Y;D
I W J Z | I W J;Z
Q B D O | B Q O;D
I E W M | E W I;M
C M J U | M C U;J
N U D J | D U N;J
K M C F | F K C;M
V A X D | X D V;A
P E R X | P E R;X
I X P K | P X K;I
P M X F | M F P;X
W M F G | G F M;W
Y E I T | I E T;Y
B P T O | T B P;O
E F Z U | F E Z;U
A S J G | A G S;J
C S U Q | S Q C;U
V O B I | B V I;O
O Y K H | H O Y;K
M T W D | W T D;M
U V L T | T V L;U
X R I F | X F R;I
D W G T | W T D;G
K G L T | G T L;K
J H W P | W J H;P
R D B P | B R D;P
D C Y J | Y D J;C
R E D W | D E W;R
B H Q S | Q H S;B
Y J S D | D S J;Y
S L W V | S W L;V
G B P T | B T P;G
L A E Z | L Z E;A
W J U Z | J W U;Z
R Z B V | V R B;Z
K U F G | F U G;K
Q Z A K | K A Q;Z
I O L Y | L I O;Y
U O I T | I O U;T
I M T Q | I M T;Q
K R M S | S M K;R
H F Y J | F J H;Y
C H R N | H R C;N
J Z X N | Z J N;X
C F K V | C V K;F
S P T I | S I T;P
F M A J | A M F;J
T U N W | T U N;W
A Z X I | A X Z;I
I C Q L | I Q C;L
T H W F | T W H;F
C O B T | C T B;O
R X C E | E C X;R
B F A Z | B A Z;F
H R B Z | H R B;Z
E R S Q | Q R E;S
W R K M | K W R;M
A V H Q | Q H A;V
D F J W | D W J;F
E I Z Y | Y E I;Z
Q P J X | J X P;Q
L T E V | L T V;E
Y C F M | Y M F;C
D T R V | R V T;D
S I X E | E I X;S
F R A Q | F A R;Q
D E M S | M S E;D
N Q C F | F C Q;N
D M N C | N C M;D
V J H C | C V H;J
J K C A | A C K;J
X Z U O | O U Z;X
X K O F | O K X;F
T W B K | T K W;B
Q D F E | E D Q;F
N B M T | N B M;T
G W O Y | G W O;Y
E W V K | W K E;V
Y G E F | E F G;Y
O D B V | D V O;B
W B F K | F K B;W
J O G N | J G N;O
F R H N | F H R;N
R H Y P | Y P H;R
H G P R | R P G;H
B L S P | L S B;P
T U I O | O U I;T
U E X N | U N X;E
H R K C | C R K;H
U K M V | U K V;M
C W S J | W J S;C
S I J B | B S I;J
B A C D | A C D;B
X D T C | X T D;C
U A M Q | A U Q;M
K J G M | K G J;M
I S W O | W I S;O
P K R U | R P K;U
P N H S | S N H;P
Z H N P | N P Z;H
C Q J R | Q R C;J
M B D C | D B C;M
F K T U | U F K;T
Q W M I | Q W I;M
C V B T | T C B;V
J E L W | E L W;J
Q R C Y | C Q R;Y
N G K F | K N G;F
T H L Q | H T L;Q
G A E F | F A E;G
H W Y K | Y H W;K
R E U I | I E U;R
C G X I | C X G;I
P X Q Y | X Y Q;P
O Y I W | I O W;Y
Z J H L | L H J;Z
Z N V B | N Z B;V
N M A P | P A M;N
T R S Q | R Q T;S
X V J W | X V J;W
T N J L | T J L;N
Y O N M | M O N;Y
B X G O | B X G;O
T C N Q | Q T N;C
M G F Y | G M F;Y
N A J K | N K J;A
I B W C | C B I;W
I V K L | K I L;V
A W S G | S G W;A
K V L T | L K V;T
S E Y N | Y N E;S
O X R M | R O M;X
C G A D | C A G;D
L F B S | L B S;F
P G K D | D G K;P
W A O M | O A M;W
J O Z X | X Z J;O
U G W R | R W U;G
V Y Z A | A Y Z;V
P C E R | R P E;C
F S E B | E B S;F
V B W E | W B V;E
V I S G | S I G;V
U P M J | U P M;J
C B S V | C V B;S
Z U E B | E B Z;U
K X U W | W X K;U
G M R Z | R M G;Z
M J Y F | Y F M;J
O H Q A | Q H A;O
E R Q N | R N Q;E
A J C B | J C A;B
L D S B | B S L;D
B G K M | B G M;K
W O J T | O J W;T
V C F T | F T C;V
P W G X | P X G;W
M T D V | T V D;M
I V J M | J M I;V
Q F G R | R Q F;G
I L P S | P S I;L
J E U O | J E U;O
U A C N | A C U;N
N D Y S | S D Y;N
P C R Z | P C Z;R
G E Z J | Z J G;E
K U E F | K E U;F
X M H C | H X M;C
D H X U | H U X;D
F L T I | T L F;I
T X S P | T S P;X
X J V D | J X D;V
U X L T | L T U;X
X G F C | F X G;C
A H F I | A I H;F
S P Y U | P Y S;U
W V T Q | Q T W;V
Q P N C | N C P;Q
Y K V L | Y L V;K
S X E Z | E X Z;S
Y V T N | V N Y;T
P L T X | L X P;T
T M Z U | U T Z;M
E A D Q | Q E A;D
V G L P | L P V;G
N H S X | S N H;X
M X R H | X H R;M
I C G L | I C L;G
J S X G | J S G;X
L E Z T | E L Z;T
P K X G | K G X;P
F A L X | L X A;F
K F I C | F C I;K
O C U T | T U O;C
P B Y K | B P Y;K
P K E A | K E P;A
K P E U | P E K;U
K F T R | R F K;T
H E D Z | E D Z;H
J N C F | N F J;C
U I A W | I U W;A
J V I G | G I V;J
N Q F A | N A F;Q
X A V S | V S X;A
C T A N | N C T;A
T C X I | C I T;X
T J B V | J B V;T
N G O Z | O Z G;N
N I P H | P N I;H
K B D W | W D K;B
J Z A I | Z I J;A
K O S P | S O P;K
E F R W | R W F;E
W B L Y | Y B L;W
L E Q U | U Q E;L
N L G U | U N G;L
P B L W | L W P;B
H R E L | E H R;L
Q E R U | R Q E;U
Y O S W | W Y S;O
O A T W | A W O;T
G Q W X | Q X G;W
Q E Z N | N Z E;Q
U Z B M | B Z U;M
F C B R | R C B;F
R Z S Y | Y S Z;R
O I U C | C I U;O
Y V U J | Y U V;J
X R G M | R X G;M
A K T E | T K E;A
M I Z S | Z I S;M
G C J Z | G Z C;J
H K N G | H K G;N
R K E G | E K G;R
L V D X | L V D;X
W J H P | J P H;W
X G W F | G F W;X
R M Y A | M A Y;R
U D X Z | Z X D;U
E A L O | E O A;L
N Z U O | Z U N;O
C B M O | C M O;B
H B N K | H K N;B
O S M Z | S O Z;M
N Z K C | Z N C;K
O S Q I | S O Q;I
U A D J | J D A;U
R M H F | H R M;F
O S Z W | O S Z;W
S C V Y | S Y V;C
L I A D | L A I;D
L M S F | L F M;S
S P K G | S K G;P
D Y R W | R W D;Y
F N Q I | Q N I;F
M V K S | M S K;V
G Q M J | Q J M;G
E H G X | X H E;G
N T O U | N O T;U
T V H E | H V E;T
Y U V M | M U V;Y
V Z S X | X S V;Z
P N W C | N C P;W
J B L T | J L B;T
A Q K T | K A Q;T
S A B C | S C A;B
J S L A | J L S;A
P Y Z B | B Z Y;P
L M B P | B M L;P
H U M T | M T H;U
N F S O | F N O;S
B O S F | O S B;F
W X L F | L X F;W
Q B O S | O B Q;S
W K U S | U K S;W
J L U R | R L U;J
F X T K | F T K;X
O Y I X | O X Y;I
M G W L | M L G;W
M Q D V | V D M;Q
H F D N | F D N;H
Y L M I | L I Y;M
Y B X F | F X B;Y
O L A V | L O V;A
Q K F B | F B Q;K
V D B M | B M V;D
N P R Z | R P Z;N
W K Y C | Y K W;C
A D E L | A L D;E
P B T W | P B W;T
C E U Y | C U E;Y
J B F X | F B J;X
C G T J | T C G;J
I L Y V | Y L I;V
A U T J | J U T;A
F U P W | W U F;P
K H N J | J H K;N
C M D K | D M C;K
B Z T U | Z B T;U
C I L M | I C M;L
Z X E G | E Z G;X
Z U N G | U G N;Z
Y S I Q | Y Q S;I
W A H J | A H W;J
O Q A R | O A Q;R
K N M I | N M I;K
K G Z R | R K Z;G
J A V I | A V I;J
G F W M | W F G;M
P B R L | L P B;R
F Q R O | O F Q;R
T Q V Z | T Z Q;V
C G V F | C V F;G
P U N J | U J P;N
X Z J U | U Z X;J
B Y G K | K B G;Y
Z W K J | Z J W;K
Z K F V | Z F V;K
U H Z R | Z R U;H
Y K S L | L Y K;S
Z X E G | X G Z;E
R G V T | G V R;T
M P R W | R M W;P
U R H M | R H U;M
H Z X B | Z X H;B
V Q G F | V G Q;F
E L A C | L A E;C
K G Y V | K G Y;V
W T X R | W R T;X
V K U L | L K U;V
I P C O | I O P;C
O G U A | G O U;A
L U S I | S L I;U
K Z T G | Z T K;G
T D G F | D G T;F
X N J P | X P N;J
C M R H | R C H;M
P N V I | I P N;V
A I W G | W I G;A
N U J A | J N U;A
V D G Q | Q D G;V
S W C Y | W C Y;S
Q B H T | T H B;Q
F V N C | F N C;V
J X K S | S K X;J
H N M Z | M H Z;N
G K L F | L G F;K
K J Y N | N K J;Y
B U D L | L D U;B
D S B C | D S B;C
W X R U | R W U;X
Y H N E | H Y N;E
S F J M | S M J;F
R Y L M | R M L;Y
S F N R | R F S;N
W D T Q | W D Q;T
B N O C | B O N;C
G Q C K | Q G C;K
Q H Z D | Q H D;Z
E R G P | R P E;G
Q I A C | Q I A;C
F Z S U | U F S;Z
Y X D S | D S Y;X
T L K G | L K T;G
C E D Y | C D Y;E
C T H P | P H T;C
H Y C V | Y H V;C
C Z S V | C Z V;S
G K D O | D K O;G
R L P B | P R B;L
E M Y G | Y M G;E
A H J U | U J A;H
D X Y C | D Y X;C
C K D N | K N D;C
S T K O | T S O;K
Q K T X | K X T;Q
Z O P X | O X Z;P
S R A N | R A S;N
Z C U X | U X C;Z
L K S I | I S L;K
N O K S | N K S;O
V I R N | I V R;N
V E N H | N V H;E
H U N Q | N H Q;U
T V J P | P J V;T
J Q L O | J O L;Q
J K W B | J B W;K
Q Z I E | Z Q I;E
C H R K | C R K;H
Z F D C | F Z C;D
G N U A | G A U;N
M F K O | M F O;K
S P I V | S V I;P
Y A C Z | C Z Y;A
U N O M | U O M;N
Q F S A | Q A S;F
B U E V | B E V;U
N U F A | N U F;A
U N F C | U N F;C
P E B D | E B P;D
Y V K T | T V Y;K
S B P I | I P S;B
A I R D | R I D;A
H K A W | W A K;H
A P G B | P B G;A
K Q S C | Q K C;S
D Q J V | Q J D;V
N X P G | X P N;G
Q E P B | B E Q;P
D U W A | D W A;U
M K R X | M K R;X
A M O T | M T A;O
F G Q K | K Q F;G
Y P M H | Y M H;P
Q L Y K | L Y K;Q
Q T H F | T Q H;F
A Y B F | F B Y;A
H E M N | M H N;E
J K B V | V J K;B
G Y N D | G D Y;N
O W R D | O R W;D
U W Y O | U Y O;W
K N U F | K U F;N
U W Z E | W U Z;E
Z F E H | H Z F;E
S J P X | P J S;X
K R O I | O R I;K
O B K G | O G K;B
M A S X | X A S;M
S I N A | N A I;S
Y F L T | T F Y;L
F Z G V | F G V;Z
O E N V | O N V;E
Y E O A | O E A;Y
V S Q M | V Q M;S
F O L J | J O F;L
M O P Y | P O Y;M
E R L B | L B R;E
H X P U | U X H;P
J P Q D | P J D;Q
J D O M | O J M;D
I C H K | C I H;K
F E B Q | B E Q;F
F T W G | W F G;T
B Q Y W | W Y B;Q
K E Y H | H K Y;E
B K T S | K T B;S
T Y M F | F Y M;T
W H I J | W I H;J
S Q K G | S K Q;G
L D B Q | Q L D;B
A R D U | R D U;A
Y G S C | C G S;Y
C K W P | W K P;C
P B N Z | P N B;Z
F J R P | P J R;F
G Z C X | X Z C;G
U H A R | R A U;H
C U A K | K U C;A
B O U X | U O B;X
U Z R M | R U M;Z
Q N Z O | O N Q;Z
Q J Z X | J Q X;Z
P A G C | A P G;C
L F G K | F K G;L
P L A W | L P A;W
G J B F | J F G;B
O F N V | V F O;N
B X Y A | X A B;Y
M I K A | K I M;A
X A K O | X K O;A
W G D N | N D G;W
O N M G | G M N;O
A Y M S | M S A;Y
S I U B | I S B;U
I M H B | I H B;M
C D U A | A D U;C
L U I G | G U L;I
E Y R C | R Y E;C
C X B O | O B C;X
M F K D | F M K;D
I G R P | P R G;I
Y J N R | Y R J;N
I U Q J | Q U I;J
U H O L | U O H;L
Z B S T | T B Z;S
A D B G | G D B;A
E W Z U | W U E;Z
Y S D M | Y S D;M
R Y N E | Y E R;N
Q I Y U | Q I U;Y
S U L O | S O L;U
P R G B | P B R;G
A G M V | V A G;M
P Q L B | B L P;Q
E P J K | J E K;P
E G B O | E B G;O
L V P G | L V P;G
D V Y R | D V Y;R
O Y K L | K L Y;O
G B Y K | K G B;Y
P T Q A | P Q A;T
T O B F | O F T;B
M H G J | M J H;G
R O Y X | O R X;Y
V S K Q | Q V K;S
N Q I D | Q D I;N
S A D V | V A S;D
R C T K | R C T;K
D C H T | D H C;T
E B R O | R E O;B
R Y X G | X Y G;R
U W D E | D U E;W
S B F P | P F S;B
Q S M Y | Y Q S;M
P G U X | X P U;G
F A U I | A I U;F
R M G I | I R G;M
U P M X | U M X;P
D Z U L | L D Z;U
Z W V B | W B Z;V
B W X E | W E B;X
C D F Q | D Q F;C
Z T S N | T N Z;S
D K X M | K D X;M
Q R P A | R A P;Q
Z Y I P | Y I P;Z
S M D V | M V D;S
U I O G | O U I;G
O Z Q G | Z G Q;O
Z Q P U | Q P U;Z
G Y J L | Y J L;G
K C O V | V K O;C
N W D F | N W F;D
Z G L Q | Z L Q;G
B C D G | B D C;G
R S U C | R C S;U
E H Z X | Z X E;H
T J X B | X T J;B
K U J S | K J U;S
N H Z A | Z N H;A
Q U G M | Q M G;U
J C B X | J B C;X
J S E Y | E J Y;S
C R I T | I T C;R
G I M E | I M E;G
C S V K | K S C;V
W G X O | G O W;X
F A P D | F P D;A
Z H W B | B Z W;H
O S A Y | Y S O;A
L M T Y | M T L;Y
R M W N | W N R;M
A L F B | A L B;F
T C V O | O V C;T
M B O U | M B O;U
A W X Q | W A Q;X
S B E M | M S B;E
D A X O | D A X;O
M P S U | M P S;U
J V T X | X J T;V
K B A H | K B H;A
N G B A | A N B;G
S K N F | S F N;K
G U K J | J U G;K
Z D S N | S N D;Z
L Q C B | C B L;Q
K S M W | W S M;K
C J A N | J N A;C
V I J K | I V K;J
B G M I | G M I;B
N H M D | H M N;D
Z I R H | Z I H;R
B U V O | B O U;V
G D K V | V K D;G
M V T R | T M V;R
M J Q F | J M F;Q
A I L G | I L G;A
R D A M | D M R;A
Y G K L | K L Y;G
Q R O V | R Q V;O
P U H W | P H U;W
N K M Z | K Z M;N
E O D Y | D E Y;O
K D A O | D A K;O
S K W D | W K S;D
R H O D | O H R;D
U C T X | U T X;C
M V H Q | H Q M;V
W B P S | B W P;S
S L I F | F I S;L
R M S Y | S M Y;R
K O H Q | O H Q;K
O Q D X | Q O D;X
V U N P | P V N;U
E U P R | E R P;U
E A O V | V O E;A
Q M G B | Q B M;G
L K Z N | L N Z;K
V A Y U | U A Y;V
Y J W E | J E W;Y
Y U C G | Y C G;U
U G V D | G D V;U
V B P N | B P N;V
W Z M L | W Z L;M
C G Z L | Z C G;L
M K Z F | Z M F;K
W E Y Z | E Y W;Z
S D R P | R P S;D
J F K V | J V F;K
T U Q D | Q U D;T
I B W H | W I H;B
K M V A | V K M;A
X I M F | F M I;X
H W E V | W H E;V
Z C N S | S N Z;C
N G B C | N G B;C
B C Y E | E B Y;C
A Y H N | Y H A;N
Y T X H | H Y X;T
G M T W | M G T;W
U R Z P | R P U;Z
R W B Z | B Z W;R
B U Y R | U Y B;R
L H V O | V H O;L
Y C D Z | D C Y;Z
I B F Q | Q B F;I
D R V Y | V R D;Y
V P T Y | P Y T;V
I Y Q C | I C Y;Q
K Q X F | X Q F;K
Z P V H | H V Z;P
A M R Z | A R Z;M
A F Q C | A C Q;F
B X U S | S B U;X
G N M S | M S N;G
V Z Y E | V E Z;Y
F L R B | L F B;R
D E Z B | Z B E;D
O R Y A | O A R;Y
A T S O | T A O;S
N D C K | D N C;K
D E U S | D U S;E
B I G Y | Y B I;G
R S V N | N R S;V
F Z J A | Z A F;J
X E F P | E P X;F
K G E J | J G E;K
F Y P H | P F Y;H
D S L C | C L D;S
P A G U | A G U;P
M F X A | F X A;M
M Y P H | H P M;Y
R D U I | I U D;R
B T D S | B S D;T
F X P G | P X G;F
C R U M | M U R;C
Z M P G | Z G P;M
B G Z P | P B Z;G
Y F I D | Y F D;I
T O G F | T G O;F
Z A K B | Z B K;A
S O Y H | H S O;Y
T P O J | O J T;P
E D T U | D T U;E
S G L D | L G S;D
R M E Q | Q M E;R
Y R D A | R A D;Y
I G Y W | I G W;Y
B N D K | K B D;N
Y R I F | I F R;Y
B G X U | B X U;G
Y D J Z | D Z Y;J
Y L T Q | L Q Y;T
I F X J | I X J;F
A G W D | W D A;G
H S V Y | S H V;Y
C F X J | F C J;X
K X M D | M K X;D
X B N L | L X B;N
I U H S | H U I;S
F A S J | J S F;A
O F U G | O F U;G
E S D M | D E M;S
W T S Q | W T S;Q
C I P T | C I P;T
P O G R | O P G;R
S O M B | B S M;O
Q I B M | Q M B;I
E U Q G | Q G E;U
U L T C | L C T;U
X Z F B | Z X B;F
X Q C O | Q C X;O
Q Y K O | Y K Q;O
T O H Q | H T O;Q
G B O K | O G K;B
I A V Y | I A Y;V
O B Q M | B M Q;O
E L J K | L J E;K
L G N K | L N K;G
G T C B | T G B;C
V N C D | C V D;N
W B E K | K E B;W
K R C U | U K R;C
D T I G | I D G;T
W U N R | U N R;W
A H C S | A S C;H
W Y R N | W Y R;N
A L Y N | Y L A;N
U S R G | G U S;R
C H F P | C F H;P
G R H T | H T R;G
N Q J W | J Q W;N
J F B V | F B J;V
O X H N | N X O;H
U H O N | O N H;U
D N U L | D L N;U
A P F E | F A P;E
N C Q V | N C Q;V
T M G U | G U M;T
V L S H | S H V;L
Z Q I R | I R Q;Z
C K B E | K C E;B
M P D A | D M A;P
I Z F H | F H I;Z
W N S G | N G W;S
D H Q Y | Q D Y;H
F Z W O | O Z F;W
N H Z V | H N Z;V
C X A Q | Q A C;X
X R U J | U J R;X
Z A M F | Z F A;M
V E C G | E V G;C
Z H T Q | H Q Z;T
E Q Z K | K Z E;Q
J H L T | T H L;J
S R M X | M X R;S
K O L P | O K P;L
T S Z O | T Z S;O
Z J M Y | J Y Z;M
V K A M | K M A;V
Q P B U | P U B;Q
C I E O | O I E;C
Y K R F | R K F;Y
T P S I | I T P;S
U G Q Y | U Y Q;G
L I U J | U L J;I
E U Q V | U V Q;E
E D Z O | D E Z;O
H V K Y | V K Y;H
Z L N Y | N Y Z;L
E M Y G | Y M G;E
Y I O R | R O I;Y
A O W C | O A C;W
J I M U | I J U;M
R C F X | X F C;R
U J F W | F U J;W
I K M J | K I J;M
O F I Y | F I O;Y
E R X S | E X S;R
R M A D | D A M;R
R S H D | R H S;D
Q W K F | W K Q;F
M J D Z | D Z M;J
B J A W | J A B;W
Q P H I | Q P H;I
G F K W | W F K;G
T H O L | T H L;O
O C X D | D C X;O
E U W Y | Y W U;E
F C X Q | Q F X;C
B S P Q | Q B S;P
K C Q O | Q K C;O
V K G Q | G V Q;K
E C K O | C O K;E
T R U Z | Z R U;T
K O J M | O M J;K
B W S X | B W X;S
M J R N | R J N;M
F U V A | V U A;F
M K D W | K M W;D
Y X M L | X L M;Y
G B O Z | Z O G;B
M L F C | F L C;M
H Z D B | H D B;Z
X S W T | T S W;X
K D M R | K R D;M
E U H P | P H E;U
N Z B P | Z B P;N
S U Z J | S U J;Z
J H U N | J N H;U
Q H X P | P H X;Q
T N Q Y | Q Y T;N
Z A W N | N Z W;A
N Q L H | Q N H;L
V A K E | K V E;A
M J I H | M H I;J
M E T G | E G T;M
D E U J | J D U;E
A J B S | A S B;J
Z G C E | C G E;Z
Q R C N | Q N R;C
K E F M | M E F;K
R Z F K | Z F K;R
Z F R W | R W Z;F
W C D N | N W D;C
H T B Z | T B Z;H
C N T S | N S C;T
E O J D | O J D;E
N L X O | X L N;O
D E U M | D U E;M
P V F H | V F H;P
A Q X O | A O X;Q
X E G N | E N G;X
L B C V | B C L;V
L K U A | U K L;A
B Q X T | Q X B;T
R L Q G | G L Q;R
S Q A T | Q A S;T
I Z B Q | B Q I;Z
U B H T | T U B;H
E D C Y | Y D E;C
D Y O I | Y O D;I
Y W L X | X Y L;W
X Q L F | Q F L;X
T P O L | O L P;T
Q W P H | Q W P;H
W P I L | P W L;I
V Z F D | Z V D;F
O F Y G | O Y G;F
T X N A | N T X;A
O K D M | K M O;D
W A I J | J I A;W
U N F L | F L N;U
Y M I N | I Y M;N
U E N T | E N U;T
F R M D | M D F;R
I Q K M | M Q I;K
Z K E F | Z F E;K
X K C D | K D X;C
Q S L V | Q L S;V
C N D T | D N T;C
H U O Z | H O U;Z
K A S J | A S K;J
E K Z C | E K C;Z
G E R M | G E M;R
N A W K | K W N;A
Y X T B | X T Y;B
E O X V | X E O;V
R J N S | J N S;R
E V B Q | Q E V;B
G U J Y | Y G U;J
X U T Q | Q T X;U
R W L D | R L D;W
S R C J | C R S;J
U A S K | U K A;S
L D R B | D B R;L
Y N W U | U Y W;N
G L W J | L W J;G
Y L O W | O L Y;W
B W I D | W D I;B
Y E R F | E R Y;F
Z W H M | W Z H;M
Z G S F | S F Z;G
P A N W | A N W;P
D S X Y | X D S;Y
B Q V R | Q B R;V
M Q R N | M R N;Q
I M E N | M N E;I
D P A E | D P E;A
O K Z H | Z K O;H
V A X H | X H V;A
C S L D | S D L;C
I P G Z | I P Z;G
P G K C | K G C;P
T P U R | U R T;P
P N K M | P K M;N
L T G J | T L J;G
V R Z B | V R B;Z
N K I R | K R N;I
Q T W J | W J T;Q
F H P X | P X H;F
Y K D U | K U Y;D
Z E B P | Z E B;P
Q X Y O | X Y O;Q
U V G Q | Q V U;G
D A Y Q | D A Y;Q
H S Q U | Q U H;S
Z U Y L | Z L U;Y
Y T A O | Y T O;A
D T K S | T S D;K
F G T Q | Q F G;T
M K Q G | G M K;Q
D B R O | B D O;R
U R E J | R E U;J
L N G W | N L W;G
Z C X U | C Z X;U
I W A T | A W I;T
F V R J | V F R;J
D E C Q | E D Q;C
T C S M | T S M;C
B G D X | G B D;X
Q G U V | V U G;Q
G H K Z | K G H;Z
A K P L | K P L;A
P M J O | J O P;M
J A G Y | Y J G;A
M Q W B | M B W;Q
K B Q Z | Z K Q;B
O Y U C | Y C O;U
R O Q J | J R O;Q
Z B F R | B Z F;R
L X O A | L A X;O
I K Z N | I Z N;K
Z Q V I | V Z Q;I
Z A O Q | Q Z A;O
Z M O V | Z O V;M
R J C F | R J C;F
B Q Y K | Q K B;Y
L W P A | L P W;A
K L X C | C L X;K
T H Q L | Q H L;T
I O A M | A M I;O
U W B Y | Y U W;B
V D K Q | K V Q;D
V A P X | P A X;V
Q R U X | X R Q;U
N Y S F | F N S;Y
G X A J | J G A;X
R Z D S | R S Z;D
E B F I | F I B;E
R F T P | T F R;P
H X T C | C T X;H
N E O T | O E T;N
Y U F O | Y U O;F
V X H W | H W V;X
G K I J | K I J;G
S N T E | S T N;E
U Y G O | Y G U;O
S L Y I | I Y L;S
D R Z J | R D Z;J
T F K G | K G T;F
N F X S | X N S;F
C W Q D | Q W D;C
A V X O | O X A;V
K T R S | R S K;T
G H E T | E T H;G
S N G O | G O S;N
K D P H | D K H;P
I N D J | N J D;I
X H L N | X H L;N
G V U P | P V G;U
C G U O | U C O;G
K R S X | K R X;S
T Y M G | M T Y;G
I P R A | A I P;R
D N C O | D N O;C
I Q R U | U R Q;I
H Q K A | K Q A;H
T O U B | B U T;O
G T U M | T U M;G
D C Q Z | D C Z;Q
D R Q M | M R Q;D
J Z D L | Z L J;D
R B U M | B U M;R
O R V D | R O D;V
G P Q M | G Q M;P
G R J L | R J L;G
I Y T G | I Y G;T
C P L X | P X C;L
W L Z S | Z S L;W
Z H T V | T V Z;H
V C B H | B C H;V
J I M Z | Z I J;M
T L S I | I T L;S
R J D O | D J O;R
Q H K N | N H K;Q
C F T U | C U T;F
T K D O | T O D;K
T H P M | H M P;T
E T J O | E T O;J
E R F T | E R F;T
T U V E | V U T;E
O P J Q | P Q J;O
N I Z K | Z N K;I
O U A T | O A U;T
D S Q M | D S Q;M
S B O Y | Y B S;O
H G P U | H U G;P
X I E V | V I X;E
P W N C | N C P;W
U X S C | S C U;X
W C S E | E W S;C
O B P J | P J B;O
E N M R | E R M;N
V M D K | D V K;M
K Y O N | O N K;Y
F R W K | R W F;K
Q L N P | L Q N;P
O E B W | O W B;E
G Y D X | X Y G;D
S V R Y | V Y S;R
P S E V | V E S;P
A V Z J | Z J A;V
O V B K | B O V;K
R C Z I | Z R I;C
R N Q U | N U Q;R
U E M Q | M Q U;E
B Y Q E | Q Y B;E
C B V O | C V O;B
R C I F | F C I;R
P X F J | J F P;X
P X T L | L P X;T
Z E T M | E M Z;T
Q J W H | H Q W;J
Z S X R | X Z R;S
I Q O V | V I O;Q
A C T B | A T B;C
L S V N | L V S;N
Q M K O | K O Q;M
Y O N U | O U N;Y
T W N G | G W N;T
H C N R | H N R;C
W U X O | U W O;X
Z V N E | Z E N;V
G L A I | G L I;A
H A Z U | Z U H;A
E I R U | E I R;U
R Y T Z | T R Y;Z
L E T K | T L K;E
Y D A V | V D A;Y
C E Z H | E C Z;H
X N W H | X H W;N
P O R Q | R P O;Q
P D N O | O P D;N
O U P V | U P V;O
V I J X | X J V;I
T X C F | X C F;T
T D I E | I E D;T
P O B S | B O P;S
J T N U | J N U;T
Q X J K | J K Q;X
L P K U | K U L;P
Z I V B | B V Z;I
W I E S | I E S;W
V O N M | M V N;O
F X Y P | P X Y;F
W Q S D | D Q W;S
Q R H X | Q R X;H
K G A O | O K G;A
Z O K F | O F K;Z
W H A X | X W H;A
F A Z P | A F Z;P
C T Q G | T Q C;G
I O Z N | Z O N;I
A E Z V | Z V E;A
C M Q L | L C M;Q
T Z N V | T Z V;N
A E I U | A E I;U
I Y P N | Y I P;N
P U T V | T P V;U
O S X A | A X S;O
T V C J | J C V;T
Q V B W | Q V B;W
Y J F Z | Z J F;Y
L C X Q | L X C;Q
E S R Y | S R E;Y
J Y E V | Y E J;V
A C X Z | X C Z;A
V I C L | V L C;I
X Z R Y | X R Z;Y
C A V W | C A W;V
W G J Z | Z W G;J
D T M N | D M N;T
T L G C | L C G;T
U E C P | P C U;E
C H R E | E H C;R
E I Q D | I Q E;D
R X B U | B R X;U
R M T A | R T M;A
E G M B | B M E;G
T U V M | V M U;T
O F U I | U I F;O
H L Z U | H L Z;U
B T K Y | T B K;Y
L K O W | L O W;K
K M W E | K M W;E
N K H I | N I H;K
E J I H | J H E;I
I K P R | R K I;P
O G P C | C G P;O
Z O U N | U O N;Z
L T K D | K T L;D
H V A L | H V L;A
B Q J K | J K B;Q
F L Q T | T Q L;F
T F H A | T A H;F
R B V F | F R V;B
S H G Z | G Z H;S
B E N U | N U E;B
B C W J | B J C;W
I O C Q | Q I O;C
E N P L | L N E;P
A Q I N | Q N I;A
H M D G | M H D;G
S A X I | A X I;S
R B T K | B R K;T
S T K Z | S T Z;K
I K U B | K I U;B
S A E Q | Q A S;E
Y T Z W | W Z Y;T
M U A E | U A M;E
S M V L | L M V;S
Q J H K | K Q H;J
J G L C | J L C;G
T V A P | V A P;T
C D T Q | D Q T;C
T I N E | I E T;N
J Z U B | J B Z;U
L O M D | M L O;D
M H E Z | M Z E;H
P O F D | D F P;O
D L O F | D O L;F
E H P R | E P H;R
D L G U | G U L;D
Q U P K | U P K;Q
C H R Y | H Y C;R
N H F G | F N H;G
H B J N | B N H;J
I G C B | G B I;C
Y V G Q | Y G Q;V
T U W Q | Q U W;T
U R M Q | M R Q;U
V W X R | W R X;V
V X M A | A X V;M
E F O B | F O B;E
Q D X K | D K X;Q
U K A Y | U A K;Y
J X O W | O W J;X
I R A G | A G R;I
Z S D O | Z D S;O
H R Q N | R N H;Q
F G Z I | I G Z;F
E C T X | E T X;C
M G P R | P R M;G
N X Y W | W X Y;N
Z N D J | N Z J;D
Z S L N | Z S L;N
S K L G | G L S;K
R Q N Z | Q N R;Z
X J R V | J R V;X
O J U H | U O J;H
V K T U | U K T;V
R T E X | X T E;R
W N Z X | N W X;Z
J H R U | U H J;R
I U C V | V C I;U
B I V Z | V B Z;I
I F A R | I A F;R
O C Q W | C O W;Q
I U H D | U I H;D
L I W Z | W Z I;L
S Q W U | Q S U;W
P T U S | U P S;T
K H A I | H A I;K
V H T L | L T V;H
P C H T | C P H;T
C Q X K | X C Q;K
W K F Y | Y W K;F
R P K A | K R P;A
T V P S | P V T;S
R L C D | C L R;D
D S M V | M V S;D
D X Z S | Z S X;D
N B L V | B N V;L
K L E T | T L E;K
E D K M | D K M;E
X Q V N | Q V X;N
Y J E A | E Y A;J
T H S Q | T Q H;S
T E Z D | Z E T;D
W V L X | X L W;V
L G V X | L V G;X
A O E R | A O E;R
N V P H | N V P;H
W E S O | E O W;S
M A Y Z | Y Z A;M
P O Y K | Y P K;O
D Z B A | A D Z;B
Q T U F | T F Q;U
C W N Z | N Z W;C
R N O E | N R O;E
U Y R K | R K Y;U
O M P Q | Q P M;O
Z K O F | O F Z;K
J O X A | J X O;A
A T P U | T P U;A
Z A W R | R Z W;A
L H Y U | Y U L;H
N B P C | N P B;C
W G L Z | L G Z;W
W M F G | F W M;G
Z D F P | F P D;Z
Y C R T | C R T;Y
R D X W | R X D;W
G Y Z R | Z G R;Y
L U M N | L U M;N
N K I P | N P K;I
T J G H | J T H;G
J P H G | J G P;H
A D H U | U H A;D
O I W L | W I O;L
N W B O | O W N;B
L J Z K | K L Z;J
M E L J | E L J;M
S P C V | C S V;P
L C K R | R L C;K
J T H W | H W T;J
M X Z I | X Z M;I
Q D S H | Q S D;H
D N J M | M J N;D
B U J W | B U J;W
C E Z T | C Z E;T
J M T N | T J N;M
W P H Z | H P W;Z
R T D K | K T R;D
Q V S M | S M V;Q
S G C N | N S G;C
Z B L M | M B Z;L
I A N U | A I N;U
R X Z J | J Z R;X
B N Y X | X Y N;B
Y D H B | D H B;Y
A D G Q | Q G A;D
I Z O Q | I Z Q;O
T B L R | B L T;R
J F M A | F A J;M
W F U Z | Z W U;F
O K Z C | O K C;Z
N B E I | E B N;I
E C A M | A E M;C
Z S K P | P S Z;K
L D T Q | Q T L;D
J A N G | N J A;G
M V W U | W U V;M
E Z P J | J P E;Z
C X Q P | P Q X;C
A D Q R | R A D;Q
G D S L | S G L;D
U B O Y | O B Y;U
U I B F | I U F;B
G L Q E | Q L G;E
Z M P F | F P M;Z
Z K S E | S Z K;E
G X C B | C B X;G
F L D M | M F D;L
S P E B | E S B;P
X D R Q | R Q X;D
C T R H | R H T;C
O K D P | P O D;K
C Z A G | C A Z;G
J K S V | J S K;V
E P S I | I P S;E
F O C P | P C F;O
T Z Q Y | Q Z T;Y
I F W G | F W G;I
Q X G D | G Q D;X
T B F K | T F K;B
Z F K N | N F K;Z
W B O T | W T O;B
B F Q K | K B Q;F
B A R M | R B A;M
L Y C G | L G C;Y
K J E O | K J O;E
C E B G | E C G;B
Z H D O | O Z H;D
L V O P | O L P;V
K U T M | U T M;K
V O N B | B N O;V
V M X Z | V M Z;X
O L M T | O T M;L
Q K A U | A Q U;K
R Z Y A | Y R Z;A
I C A J | I A J;C
D X W N | N W X;D
T G X D | X G T;D
T Q E F | F T Q;E
N W F A | A N F;W
C K A X | C K X;A
L N J B | N L B;J
K V X N | K X V;N
P Q V U | V Q U;P
F G U J | F G J;U
A D N O | N O A;D
G Q C O | O G Q;C
H J K R | J R K;H
Y S E V | V S E;Y
X Q P D | P X D;Q
O P L I | P O I;L
D R K V | D K V;R
O Q F B | B Q O;F
Z I W S | Z W S;I
Y S Z T | T Z Y;S
G S Z H | Z G H;S
I K S N | N K S;I
X N Q V | X N Q;V
U Z H D | D H Z;U
L A B J | L B A;J
M P W C | M P W;C
F U Z D | D F Z;U
W I G O | O G I;W
W K X T | W K X;T
I V J R | V R J;I
T J U H | T U H;J
Z J Y U | J Z U;Y
B C N E | E N C;B
Q I X M | X I M;Q
P Q V K | V P Q;K
L A E W | E A W;L
J G Z X | J Z X;G
L R W D | L W D;R
M A W O | W A O;M
B J K F | J F B;K
U K Y W | U K W;Y
J K F Z | J Z K;F
O M L K | K O L;M
L M T J | M T L;J
K Z R W | R K W;Z
Y O U K | O Y K;U
R J E F | E F J;R
U W O P | O P W;U
V O X Q | V O Q;X
H A R W | A W R;H
N Q U Z | Q U N;Z
T Y A S | S Y T;A
N S B P | S B P;N
A Z X I | I X Z;A
O G E D | G D O;E
K N D O | N D K;O
T X N I | N T I;X
E L J P | E P L;J
F I J R | I F R;J
K P Z G | K Z P;G
P G W K | K P W;G
M C L S | L S C;M
L C R M | M L R;C
L O A U | O U L;A
S C H G | G H S;C
G S Y O | Y S G;O
K N V B | V K B;N
U Y Q X | Q X Y;U
G H N T | N H T;G
H P M V | M P H;V
V B F Z | F B V;Z
L V S I | I L S;V
W A T M | M W T;A
C Z Q L | Q Z C;L
J P B L | L B J;P
Q J Y P | P Y J;Q
W V R M | M V W;R
W O U M | M W O;U
P M V T | V M T;P
M A O Q | O A M;Q
E M X P | E M P;X
B G Z H | B G H;Z
L V B U | U B V;L
Y T Z F | T F Z;Y
P O W Q | P W O;Q
R P G I | G R P;I
N S M Y | M S Y;N
N S L P | L S P;N
P T O L | L P O;T
I F R K | F K R;I
I N E A | N E I;A
W J A V | V J A;W
Q Z Y V | Q V Z;Y
R G P Q | R P G;Q
J D V N | J N V;D
A U X K | X U K;A
D R N W | D N R;W
K R H F | F H K;R
B F K T | B F K;T
K C N X | K C X;N
J Z I W | J I Z;W
E I M L | I M L;E
Q P U H | H U P;Q
D S V Y | S V Y;D
S O X W | S O X;W
S I A R | I R A;S
U K J V | V K J;U
H G V E | H G V;E
K H X B | B K X;H
S F T X | F T S;X
K Q T J | K Q T;J
L M Q S | L Q M;S
T O Q K | T Q O;K
I U G P | G P U;I
E O G J | J G O;E
E Z L G | Z G E;L
U M Q R | U Q M;R
P U Y V | Y V U;P
W I G Y | G I W;Y
M L Y N | Y L N;M
O S R J | O S R;J
H A R D | D A H;R
G D Z K | Z K G;D
R N Q G | G R N;Q
E I R Z | R Z I;E
H P G V | H G V;P
X P F T | P F T;X
M L R K | R K L;M
U F Z W | W U F;Z
K T B N | B N K;T
K D U S | U D S;K
K E I B | B K E;I
P I L X | L P X;I
Y F L Q | L Q F;Y
M J E Y | M J Y;E
C U E K | U C K;E
H C N T | H T N;C
H X R Y | H R Y;X
W P I Q | Q W I;P
T W N A | T N A;W
E U I W | E U I;W
Z M Y E | Y Z M;E
N C O H | H N O;C
V I C G | G V I;C
D I K X | I K X;D
J V I W | J V W;I
O Y P A | P O Y;A
K O Q N | O N Q;K
A X Z L | X A Z;L
U A B M | U A B;M
H U J C | H U J;C
U A R V | R V U;A
M N Q Z | M N Q;Z
W P H Z | Z H W;P
V I R U | V R U;I
E K W R | R K W;E
O W I V | W I O;V
E M W C | E M W;C
B D C L | D C L;B
A B R O | O B A;R
R B S P | B P R;S
Q R I T | T Q I;R
X B Z U | B Z U;X
X S H D | D X S;H
C P X Z | Z P X;C
J M L O | O L M;J
R M N D | R N D;M
L Y Q S | L Q S;Y
P B L N | P L N;B
F C S D | C F D;S
C T S A | A C T;S
V L I M | L V I;M
H Q B F | B Q F;H
P K J H | P J K;H
W V Y U | V Y W;U
X K E Q | E K X;Q
N K G B | N B G;K
C P K F | C K F;P
W E D K | D E K;W
U T M O | O U T;M
Z P F X | Z F P;X
A T J L | L A J;T
B X A P | P X A;B
B G P O | O G P;B
B G H N | G H N;B
Z X S K | Z K X;S
C Q J T | T J C;Q
U L F N | L F U;N
X Y W D | Y X D;W
S H K J | K H S;J
D N L F | L N F;D
X W Y Z | X W Z;Y
H C R Q | R C H;Q
C J P H | H P C;J
B T E X | T X E;B
V M Q E | Q M E;V
C X J V | X J C;V
Y F E S | Y E S;F
O Y J K | Y O J;K
C K T J | C J K;T
B U D J | D B U;J
W G K U | G W U;K
J H L E | L H J;E
W B M P | P M W;B
C F Z B | Z B C;F
W M H E | M H E;W
K P E M | E M K;P
B N Z J | Z N J;B
V W G B | G B W;V
S Q L G | L G Q;S
L B M G | B G L;M
D O G U | G O U;D
T O W X | X W O;T
J U F N | F N J;U
F Q S W | S W Q;F
M F J B | M J F;B
Z J H R | J Z R;H
J W E G | W J G;E
K T U H | H T U;K
E V F D | E D V;F
M S W Q | M W Q;S
Q M Y F | Q M Y;F
K A D O | O D K;A
H V A T | A H V;T
Y M A P | P A M;Y
T J N G | J G N;T
E J M G | G M E;J
P L C F | F P C;L
O P Y N | O P Y;N
N Z G B | N Z B;G
O Y E P | Y E P;O
G J Q T | G Q T;J
K H W Q | Q W K;H
Q O J M | J M Q;O
J Z A E | J Z E;A
X V J F | V F J;X
H A W Y | Y H A;W
Y O T J | T J O;Y
I Z U H | H Z I;U
W F T N | T W N;F
X F P E | E P F;X
E V R C | E V C;R
H L S K | L H K;S
G H U D | G H U;D
F K D O | D F O;K
G Y N F | F G N;Y
X I W G | X I W;G
M Q S J | M S Q;J
R Z C U | R Z U;C
U L Y V | L Y U;V
C S M O | S M O;C
W F N Y | Y W N;F
Q Y A N | Y Q A;N
Q W A R | W Q R;A
T Z F R | R F Z;T
V J G L | V J G;L
R L H T | L H T;R
F D O V | D O F;V
V H S N | V H N;S
H M K C | M H K;C
B R H K | R H K;B
U E V P | U E P;V
H J S Q | S J Q;H
H B T X | X H T;B
E F M C | E C F;M
Z H B F | H F Z;B
T P L N | N T P;L
Y V P E | E Y P;V
K A P C | C K P;A
C D E N | C N E;D
G I U R | I U G;R
H N V R | H N R;V
P U X N | N U X;P
Q M O U | Q U M;O
G H U O | G O U;H
V M W B | B M V;W
E R W O | R W O;E
F C J P | J P C;F
V A D R | A V R;D
Y G K W | Y K W;G
A H W I | W H A;I
P L I K | P K L;I
O B L T | B O T;L
I T Q V | I T Q;V
B E A N | B N E;A
S R M K | R M K;S
B T O H | O H T;B
D K I G | G K I;D
F B C W | C F B;W
K J Q L | K Q L;J
P T W S | W P S;T
Y Q H G | H Q Y;G
K M L S | M K L;S
P T K W | T P K;W
T D O M | M D T;O
X U J F | F U J;X
A F I X | F X A;I
D Z V J | D Z J;V
K A G Z | Z G K;A
Y H O U | H U O;Y
G V H P | H V P;G
P V E J | J E V;P
D X N G | D X N;G
W J Q O | W O Q;J
E L X D | E L X;D
O U G P | U G P;O
C F M I | F M C;I
G Y H F | Y F G;H
E T J X | X E T;J
F Q S R | R F Q;S
R W Z K | W K Z;R
P G F A | A F G;P
Y W D R | Y R D;W
X O L H | H L O;X
H K R J | J H R;K
O X Y M | Y M O;X
W H I F | W I F;H
L S D I | S D L;I
A O T P | O T A;P
Z S E V | Z V S;E
Q M T U | M T Q;U
F D G C | G F D;C
F O G Y | F O G;Y
B L T G | G B T;L
B N E M | B E M;N
R P E L | P R E;L
W J M U | M J U;W
T F V W | V F W;T
J B S Y | S Y B;J
I K S U | U I K;S
Z V Y O | Z O V;Y
M V A T | M A T;V
Z B M F | M F Z;B
O E P U | E P O;U
A Q K O | K Q O;A
A K O J | A J O;K
W Y D S | W Y S;D
E Z H U | Z H U;E
I C Q E | Q C E;I
J L B Z | L Z J;B
W Z A B | W B Z;A
S O I H | O S I;H
N H Y J | Y J H;N
L J R I | J R L;I
N F T W | N F T;W
L J S K | S J K;L
W H R X | W X H;R
D E U A | E D U;A
C K U I | I U K;C
C Y W P | Y W P;C
Z T U H | T Z H;U
G A F T | T G F;A
D Z L F | L Z F;D
G J Y U | G U J;Y
R Z C O | C O Z;R
T S N E | N E S;T
J X T S | T X J;S
G W Y V | V Y W;G
J K A Y | A K Y;J
J U S Q | S U Q;J
P I E W | I W P;E
K O S Q | S O Q;K
R S Q W | S W Q;R
J N W D | J D N;W
V N R H | R V H;N
B H I W | W B I;H
U R C F | U C F;R
O F L Z | F Z L;O
H R Q K | Q H R;K
E L U A | U E L;A
R B F L | L R F;B
Z P D I | I Z D;P
H A Q L | L A H;Q
M Z P J | M Z J;P
S U G F | F G S;U
S Z X A | Z S X;A
R I U W | R U I;W
Q E H F | H E F;Q
X O G Y | X G O;Y
W K L B | B L K;W
L S G Q | Q L G;S
L H E A | E A H;L
M I C H | I H C;M
H B C Y | C B H;Y
Y P T U | U T P;Y
N W D I | W N D;I
Q I C A | Q A C;I
T V S I | S T V;I
T L D P | L P D;T
N J R I | I R J;N
A O Z L | L O Z;A
L H G W | H W G;L
R Q H U | Q R U;H
G D C K | K G D;C
B P S F | S F P;B
E V R K | R E V;K
A G V E | A G V;E
Y B W R | Y W B;R
H E P M | P H E;M
E B H A | A E B;H
C H N Q | C H N;Q
G D Q P | Q P D;G
K C Q Y | Q C Y;K
V L X I | V L I;X
H A I M | I H A;M
C X O W | W O X;C
N K A Y | A K N;Y
Q N S K | Q K S;N
N Z A Q | N Q Z;A
B P D O | P O B;D
V G N W | W N G;V
C P S G | C S G;P
T D K H | K D H;T
Y T G A | G A Y;T
X O P K | X K P;O
K S Z B | S B K;Z
J O P X | P J X;O
Y J M D | M J D;Y
Y D Z H | H Z Y;D
Z D B S | Z S B;D
E Z K R | R E Z;K
W Y D H | W H D;Y
J F N T | J N T;F
V P L B | P B L;V
F A J L | A F J;L
M A Q U | U Q M;A
T Z Y R | R Y T;Z
U R A D | A R D;U
Z B M I | B I M;Z
H Q S L | S Q L;H
D I U M | M U I;D
T V O U | O U T;V
Z R Y M | Z Y M;R
J A Z R | J A R;Z
R U G F | U R F;G
T D U S | U S T;D
X I D T | D I T;X
U Y E X | Y E X;U
C H G U | H G C;U
U S C D | U S C;D
W Y P D | W D Y;P
Z X Q N | X Q N;Z
W E U D | E D U;W
W I E K | W E K;I
P M W O | P O W;M
N D Z W | N Z D;W
F L M B | L M F;B
Z M Y W | Z Y M;W
P M E C | P E M;C
N Y R B | N R B;Y
U A Q J | U A Q;J
L A C J | J C L;A
V A B F | B A V;F
B X I K | B I K;X
C R F E | E R C;F
O F V D | D O V;F
Y Q M P | Y Q P;M
E H U B | B H U;E
T N X A | A N T;X
I K O J | K J O;I
I M G T | T M G;I
M R N V | N M V;R
R Z X H | R H Z;X
N Q O Y | N Q O;Y
I Y G M | Y M G;I
C E L P | P C E;L
X Z D B | Z B X;D
U I Q R | Q I U;R
O C X L | X C O;L
M R G Y | R Y G;M
B F P G | P G F;B
P S J T | P T J;S
K B O I | O K B;I
T K Q P | Q P T;K
E C F L | L C F;E
U O R P | R O P;U
H B L K | K B L;H
B N E I | B N I;E
X O S P | O P S;X
H G C R | C R G;H
Q R E Z | Q E R;Z
N Y C T | Y N C;T
B A T J | B T J;A
V J M I | J I M;V
R P B F | F R B;P
L F M B | F L M;B
R C X T | C T R;X
Q S W Z | Q Z W;S
G P I W | P W I;G
M T X Q | T Q X;M
V O N G | N O V;G
F H P M | H P M;F
C G D X | X D G;C
I N G A | A I G;N
G X S E | E X G;S
O V M B | B V M;O
D I G P | P G I;D
I O T A | A O T;I
F G V A | F V A;G
W P F K | W K F;P
U Z K V | K Z V;U
U F J H | H U F;J
A R W Y | W R Y;A
W M F G | F W M;G
F W L I | W L F;I
C N L Y | L C Y;N
I Y M Z | Z Y M;I
N I R W | R W N;I
K V B S | V S K;B
L A X F | L X F;A
R Q O D | R D Q;O
S V R I | V I S;R
V E Q W | W V E;Q
R F W H | H W R;F
T K X C | X K C;T
A W Q S | S A Q;W
I K G Q | I K Q;G
H F E A | A F H;E
A E C V | A V C;E
C X E P | E X C;P
Z M W Y | Y W Z;M
P M W B | B P W;M
I H W D | W D I;H
U K S Q | S U K;Q
H O E N | N O H;E
F E U B | F U B;E
Q F E W | W F E;Q
G N C M | N M C;G
K M G V | V G K;M
W K Q X | Q W X;K
H K S I | K H I;S
E X K D | E D K;X
J X I K | X J I;K
L F V T | V F L;T
U G W R | U G R;W
O Z G B | O B Z;G
V T O E | E O T;V
W S T Y | T S W;Y
I B A U | B A U;I
T J Y R | R T Y;J
X Q N E | Q E X;N
K R X G | R G K;X
C O Z Q | Z Q C;O
O B M N | O M B;N
U V M R | R M U;V
H G O A | A H G;O
I C A T | T C I;A
U Y V H | V H Y;U
R Y O V | V Y R;O
V S J A | S A J;V
C S U V | U C S;V
U P M F | F M P;U
H N M Z | H N Z;M
P U C Y | Y C U;P
W D B T | T W B;D
L O Q G | Q L G;O
K T Z L | Z L T;K
J M E N | M N J;E
P O T H | H T P;O
B H R F | F H B;R
J V M B | B J M;V
S X B A | A B X;S
Z J D X | Z X J;D
U N S M | M U N;S
V O B C | C O B;V
A S E F | S E F;A
N K V R | R V K;N
E P Z I | Z P E;I
V P L O | P L V;O
A Y F H | H Y F;A
Z G V K | K Z G;V
M O B X | B X M;O
U L J H | L J H;U
V G N C | V C G;N
G T A R | G T A;R
E D Q M | D E Q;M
V K C E | V C K;E
I A F K | I A F;K
P W X V | X V P;W
A Q H D | Q D A;H
X J O U | X J O;U
B G E L | L B E;G
N Z U O | Z N O;U
A C M K | K C M;A
O M S C | C M S;O
K D L P | K L P;D
J X C N | N X J;C
T U V I | V U T;I
C U K W | C U K;W
Y Z Q N | Y N Q;Z
F Q A E | F E A;Q
J F A O | F J O;A
E S R V | S E R;V
B I S U | S B U;I
J P H Y | P H J;Y
P S I T | S T P;I
A U Z N | U Z A;N
J A U C | A C J;U
T V F S | F T S;V
J O E M | J O M;E
L V T W | L V W;T
W J R Y | R Y J;W
P U T Q | Q U P;T
W B R Y | Y W B;R
P C A E | C E A;P
C J P K | J C P;K
U N F W | W N F;U
Q F R J | Q R F;J
J Q O P | Q P J;O
A S U G | A S G;U
I E K S | I S E;K
Y L F I | F I L;Y
W E S G | W E S;G
U D E G | E D G;U
R E V Y | V R E;Y
I A R M | A M R;I
B Z F I | I F B;Z
K P T C | C P K;T
M O C B | O C M;B
S A U V | A S U;V
I J S G | G S I;J
R N F P | N F R;P
D N C P | N C P;D
H P R D | P D R;H
B I R E | B I E;R
M V A X | X V A;M
C H P Y | P C H;Y
A L V W | W A V;L
Y N W R | R N Y;W
X M B G | B X G;M
Q Y R G | Y R G;Q
O R X S | O S R;X
S T K U | S K U;T
P M R J | R M J;P
O P H D | D P O;H
S Z I F | S Z F;I
O I P U | P O I;U
L O W G | L O G;W
Y P Z B | P Y Z;B
G Y T D | Y T G;D
Q Z E M | E Z Q;M
V G C P | V P C;G
W Q D B | B D Q;W
N Y D T | N Y T;D
S X B F | F B X;S
M I A S | S I A;M
U Q S X | Q S U;X
I P Y F | F Y I;P
L M N R | N L M;R
K D O G | K D G;O
V G A I | V G I;A
N E U C | N U E;C
D P B M | B M P;D
N R X S | N S X;R
O K H E | H E O;K
R G F V | G R F;V
F U R L | F R L;U
V O J X | J X V;O
P B S F | P B S;F
K J Q S | S J K;Q
M T L C | M C T;L
W P Y L | W L P;Y
I J E K | K J I;E
Y K B F | F Y B;K
A W P Q | A W P;Q
X S H G | X G S;H
B N Y T | B N T;Y
G Y E D | D Y E;G
K E L D | E L D;K
G F J L | G J L;F
B S O T | B S O;T
Z F G O | O Z F;G
Z C O W | W Z O;C
F P H S | P F H;S
K I U F | I U F;K
G O U I | G U O;I
Z N A O | A O Z;N
O L R K | O L K;R
T L B M | B M L;T
K N A J | J N K;A
G R L K | L G R;K
Q X D U | X D Q;U
F G R Y | G R F;Y
V F D B | B F D;V
O E T P | T P O;E
O U N E | N O E;U
T X C K | T C X;K
J Y W Z | W Z J;Y
Z X Q C | X Z C;Q
X P A L | L A P;X
C F V A | C A V;F
I Z H J | H Z J;I
A P W L | L W P;A
X S C B | X S B;C
W K Q T | Q K W;T
L E B R | R L B;E
D B R X | X R B;D
L B Y N | N B L;Y
L E A K | E A L;K
F M S X | F M S;X
K C A S | A S K;C
X M T U | T M X;U
W D M P | W D P;M
Y M G O | Y M G;O
Z A X F | X F A;Z
G X F Z | X F G;Z
R S U M | S U R;M
M I O A | I A M;O
B V O R | B O V;R
T P F D | P F D;T
Z D N C | Z N C;D
E Z F N | E F N;Z
G X H Z | G Z X;H
S M P N | P M N;S
J K W A | K W J;A
V G B U | V G U;B
U J A F | F J U;A
W X Q S | X W Q;S
R H Q C | C H R;Q
Y M J P | P Y M;J
O B I R | O I R;B
L X Q G | X L Q;G
M U Q Z | Z M U;Q
J L V A | L A J;V
Z P J T | P T Z;J
F T C A | C T F;A
J V W Z | V Z W;J
E L P O | L O E;P
K R S Z | S K Z;R
O H Q X | Q H X;O
R Q N W | W N R;Q
O I X U | U X O;I
A W G X | G A W;X
V H A Q | V Q A;H
N R P S | S N P;R
G P C E | E C P;G
L T I D | T L D;I
X Q R Z | R Z X;Q
L H Y A | L Y A;H
G D V U | D V G;U
P L R A | A P R;L
S Z Q O | Q S Z;O
Y W P S | P Y S;W
A G Y L | Y L A;G
E O G S | S O G;E
Q S H L | Q S L;H
V F H M | H V F;M
B S X A | A S B;X
F T E W | F E W;T
V X W Q | W V X;Q
Q E A C | E Q C;A
Z L M Q | M L Z;Q
E C N X | E C X;N
N D L P | P D L;N
G S Y C | Y G C;S
H U Q X | X U Q;H
C A X E | A C X;E
X L P M | X L M;P
J I U X | J I X;U
Q Z X L | Q L Z;X
D Q K Z | D K Z;Q
Z D F L | L D Z;F
D Q Z P | P D Q;Z
B U M Q | U M Q;B
R N B H | R B N;H
W B Q U | U W Q;B
G U O W | G O U;W
T K R G | R T G;K
E Q I X | Q E I;X
D P N L | N L P;D
G I Y M | G M Y;I
K L B V | L K V;B
F S X E | E F X;S
V D F G | D V F;G
K G Z J | K G J;Z
M D P C | C M P;D
O T W B | T O B;W
N B P X | N P B;X
V S J Q | J S Q;V
U O N M | U M N;O
J E N B | B E J;N
E Q W R | Q W R;E
O J Z V | O V Z;J
O L E S | E O L;S
Y P J V | J V Y;P
J W G M | W J G;M
J E D C | E C D;J
R T L A | T R L;A
Q A H M | H Q A;M
C W O M | O M C;W
H B O I | H O I;B
Y T B U | B U T;Y
R I S L | S L I;R
C I U V | C I U;V
H N M I | H I N;M
X H C E | X C E;H
G D W N | N D W;G
U S J V | S V J;U
H Z J V | Z J H;V
D U M Y | U Y D;M
T F L Z | Z L F;T
W I A Z | I Z A;W
L D J E | E D L;J
I T S E | I E S;T
M Z G Y | Z Y G;M
Z J X V | X Z J;V
N Y C P | P C N;Y
S Q T H | T H S;Q
R O J U | R J O;U
B A V K | A B K;V
A B H K | B H K;A
J P O C | C P O;J
B I U N | U I N;B
A X D U | A D X;U
M W O R | M W R;O
M C R N | N R C;M
S Y N W | W N S;Y
X B M L | L M B;X
W V U F | W F V;U
T X O I | T O X;I
K Q X V | K Q X;V
P A Z Y | Y A Z;P
I V U F | I F V;U
Y F K Q | Y Q F;K
T L X W | L T X;W
Q S H B | B H Q;S
W P I O | P W I;O
Q C U B | U B C;Q
V A Y Q | V A Y;Q
B O D W | D O B;W
Y P I D | D I P;Y
E W U X | U X E;W
C T Y D | D T C;Y
Y V U D | U D V;Y
Y S N B | B N Y;S
B D V Z | Z B D;V
H N Q E | H Q N;E
A G W E | G E W;A
X Y U G | Y X U;G
C E X R | E R X;C
X G L W | W L G;X
F S Y U | U Y F;S
K Q S P | P Q K;S
Y B R H | R Y B;H
Y F A J | Y J F;A
F K Z W | F W Z;K
Z G M P | Z P M;G
G J H N | J H G;N
A L P W | W L A;P
K W U N | K W N;U
U T C S | U T C;S
H V K O | K O V;H
A W G M | G M W;A
T A Y N | Y T A;N
D M F V | V F D;M
Y Q E G | G Q Y;E
O Y Q C | C Q Y;O
S A C X | S X A;C
E Z Y M | M E Z;Y
Y P L A | Y L A;P
A R Y N | N A Y;R
T C N L | N C L;T
M T E P | T E P;M
G Y R U | R Y U;G
S L Z E | Z E S;L
U Q D L | U D L;Q
B L X M | L B X;M
X S O E | S X O;E
G J U B | J G B;U
B V E R | E B V;R
D R F K | R K D;F
T K F C | K F C;T
X V W B | W V B;X
H P Z J | P H Z;J
J S F X | F S J;X
H I U R | R H I;U
O V X N | X N V;O
Z K M R | K R M;Z
U O Z Q | Q O U;Z
V A R F | R F A;V
Y D I U | U D I;Y
S M P R | S M R;P
F H G R | F H R;G
X E D K | E K X;D
P Y M H | Y H M;P
Q A U I | U I A;Q
L M J P | L J M;P
Q X B Y | X Y Q;B
W V G R | W R G;V
L U V W | V L U;W
X P H B | X B P;H
I M X T | M I T;X
X M J N | N M J;X
V L B Z | B Z V;L
B D A H | B H D;A
Q T R O | Q T O;R
E M U D | M E U;D
R E F C | E R F;C
Q U T P | T P Q;U
A T K L | K L A;T
C H D Z | D C H;Z
P S Y G | G P S;Y
M W E A | A W E;M
H A Q S | A H S;Q
W H G E | W G E;H
V K C G | G K V;C
N I Z Q | N I Z;Q
B R G W | R G B;W
M R J Q | J R M;Q
Y S G B | G B Y;S
Q N V H | V Q H;N
W M K D | K W M;D
Z T M B | Z B T;M
R N P Q | R P Q;N
B O R G | B O G;R
U L M O | O U M;L
N F T Z | N Z T;F
M C R U | U R M;C
J F Z C | Z C J;F
C U I K | I K U;C
H E U J | J H U;E
F I C K | K F I;C
P J F Z | Z F P;J
D L G B | D G B;L
S U T M | U S T;M
L R A F | F R A;L
Z Y F L | Y L Z;F
H Y V R | R Y V;H
J V S U | U J S;V
U C F G | G F C;U
D L R N | D R N;L
O X K I | X O K;I
T V Q M | Q M T;V
H P L F | L H P;F
Y Q S I | Q S Y;I
R V P W | P R W;V
X N W B | X W N;B
I L M E | E M L;I
P M J L | L M J;P
K H E I | K E I;H
Y G K X | K X Y;G
A H L O | O A H;L
F W D J | W J D;F
V S N R | N R V;S
V B Y S | B Y V;S
N T S P | P N S;T
X Q V M | Q X V;M
I B X C | X C I;B
R F O V | R O V;F
R Q A M | A Q R;M
K M Q T | T Q K;M
Z U R N | U Z N;R
X B G I | G X I;B
K V R H | H V R;K
W U T P | U W T;P
Y O K S | S K Y;O
F A C T | T F A;C
A Y X Z | X A Y;Z
J S X L | S X L;J
M V U F | M U V;F
A I R T | A R I;T
G P C F | G P C;F
Q C X O | X C Q;O
C F G Z | G C Z;F
X J H L | J L H;X
K P O V | O K V;P
U T N F | N U F;T
Y K I X | K X Y;I
F Q B Z | B Q Z;F
Z E H G | Z H E;G
K B M I | K M I;B
D J K M | M J K;D
T A I Q | T I Q;A
D W N T | T D N;W
E C W Y | W Y C;E
R M A I | I A M;R
D C P K | P C D;K
A F E I | A I F;E
A S C Z | C A S;Z
G I V S | V I G;S
H R X W | W R X;H
M G K S | S G M;K
Y F N K | F N Y;K
Q H J S | Q S H;J
R E A C | R C E;A
W U N Z | W U Z;N
Z R S B | S Z R;B
U N L G | U L G;N
R D E U | D E U;R
J F Y T | J Y T;F
M S O E | S M E;O
U B K C | K B U;C
Q L T B | B L T;Q
S D O R | R O D;S
H C R Y | Y H C;R
L Y X J | J L Y;X
U B M K | M U B;K
G D L Q | G L D;Q
Q S G O | S G Q;O
V O R U | V U R;O
O V E H | H O E;V
R W T J | W T J;R
D E L C | E C L;D
Q W N O | Q N O;W
U D P J | J P U;D
O B S Z | B S Z;O
E M Z X | Z E M;X
D W H T | H D W;T
U W I H | I H U;W
H Z M X | M H Z;X
O K J S | J S O;K
X H P T | T H P;X
T U E A | T U E;A
P O Z M | P O Z;M
F L R K | L K R;F
Z H R D | H D Z;R
Y L S P | P S Y;L
G A J X | G A J;X
R L T P | L T P;R
L N C B | N C L;B
Y W O X | W X O;Y
B O V H | V O H;B
R L H S | H R S;L
L Q P G | Q P G;L
T O D H | T D O;H
A V W C | A W V;C
O W V Q | O W V;Q
U J O M | J U M;O
V Q U K | Q U K;V
X Q D V | Q V D;X
P R X E | R E P;X
I M L X | I L M;X
G K Q Z | G Z Q;K
K U Z F | Z K F;U
I M P X | I X P;M
U H E G | E G H;U
V P U M | M P U;V
F U V N | V U N;F
X Q I Y | Q I Y;X
J B O S | O B S;J
N L O P | P L O;N
U P K W | W U P;K
Y E A B | B Y E;A
F K G T | K G F;T
F B U Y | F B U;Y
A B R I | A I R;B
W Q T Z | T Z Q;W
Y O B C | Y O C;B
S V L Y | L V S;Y
D R W O | D W O;R
X M F V | V M X;F
K B H F | H B K;F
O J P A | O A J;P
M R W U | W R U;M
E T I W | W T I;E
B T Q Y | T B Y;Q
U M L T | M U L;T
B E L I | L B I;E
C V G T | V G T;C
Q Z K L | K L Z;Q
U V D T | D T U;V
N G Z R | G Z R;N
P M D L | L M D;P
N M Y E | N E M;Y
V Q G N | G N Q;V
Y F K A | A K Y;F
S X Z A | X A S;Z
B A Q D | B Q D;A
C L M U | M C L;U
A C F D | A F C;D
U Y R N | R N Y;U
N P F M | M F N;P
L D Q B | B L D;Q
Y F I V | Y F V;I
F M Z A | F Z A;M
A X R L | A L R;X
P D N O | O P D;N
Q C K A | K A Q;C
Q A B P | Q P A;B
B O U Y | Y O B;U
B Z J A | J A B;Z
H G C D | C D H;G
U L W A | U A L;W
Y L C N | C L Y;N
C O Q R | C O R;Q
F B K S | K F B;S
K T L R | T R L;K
G L R U | U L G;R
W O D P | O P D;W
B U A X | B A X;U
T F I Q | T I F;Q
L D U A | A L D;U
J H P C | C H P;J
J R E G | J E G;R
Z G Q S | Q Z S;G
E B W S | B W S;E
O L S Y | O Y S;L
E D V A | V A E;D
P O B U | O U P;B
P G J Z | Z J P;G
N Y D C | N D Y;C
G L H T | G H L;T
I X Y C | I C X;Y
H Z V D | H D Z;V
B Y A X | A X B;Y
G Y O Q | O G Q;Y
Q V L M | M V L;Q
B Y O G | G B O;Y
Z M Q X | Q M Z;X
P Q S Z | P S Z;Q
W B J D | D W J;B
R T N K | T K R;N
Y G I P | G Y P;I
T Y K R | K R T;Y
M T B H | M T B;H
I Z N X | N Z I;X
B K T Z | B Z T;K
H B Q R | Q H B;R
I X O V | V X I;O
X M I O | X I M;O
C M K L | L K C;M
I K J E | I K E;J
Z V W J | W V Z;J
B P M R | B R P;M
N B W E | W E B;N
E D Q X | D E Q;X
P J U Q | P Q J;U
W H M F | W M F;H
T E H G | T H G;E
M W J X | W X J;M
H C S K | S H C;K
B J Y U | B U J;Y
F X J K | J F K;X
N L V K | V K L;N
F P G Q | G P Q;F
V H L C | V H L;C
N J F R | N R J;F
T U Y I | U T Y;I
E W V Z | Z V W;E
Z V K G | V K G;Z
K M S T | M K T;S
F D J Y | Y D J;F
S R U Y | U R S;Y
K T Z U | K T U;Z
D I Y M | Y I D;M
E L A Q | E A L;Q
A P G E | P G E;A
V F A R | F A V;R
S J N U | N U S;J
W A F H | F A W;H
O H D M | D M O;H
T W B O | T W O;B
K P G J | P K J;G
B T X W | B T W;X
C M D W | W C M;D
W E V X | X V E;W
P H M R | H R M;P
W X F P | F W X;P
Z H P D | P H Z;D
X V J F | J V F;X
B X S K | B S X;K
R K B S | R B K;S
U I A Q | U I A;Q
N C T L | C T L;N
B H E G | E B G;H
A S Z O | A O S;Z
A G Y F | G A F;Y
C J I M | M C J;I
Y T H P | T H Y;P
S V R Y | Y R S;V
V G U O | O G U;V
A C O N | C N A;O
U G K E | G E U;K
F J V Q | F Q V;J
M P N R | N M P;R
K P F B | P B K;F
Z H E P | H Z E;P
P R Y M | Y M P;R
U C T S | C T U;S
A R S E | S A E;R
V D N B | B D V;N
U Y N R | Y R U;N
Z Y P H | H Y Z;P
Q L R U | U Q R;L
L F V M | V M L;F
A G H M | H G A;M
V T W L | T L W;V
L Z I U | L I U;Z
C S J Y | C Y J;S
O W F T | O W F;T
F V B J | B F J;V
C P W X | W X P;C
Q P O T | T Q O;P
R T J Z | J T Z;R
F O I Y | Y I O;F
C T A R | A R T;C
V M F B | B F V;M
V N U A | A U V;N
X G I P | I X P;G
U W V F | U F V;W
J D L U | L U D;J
K P G M | M P K;G
Y V N M | V Y M;N
V E G X | G V E;X
T V L P | L V T;P
O C Q Z | Q C O;Z
U V F N | U N F;V
O W Q R | W O R;Q
M P J D | J D P;M
T K Z V | T Z V;K
Y H G V | H V G;Y
C J V Y | C V J;Y
L P B X | X B L;P
V U J W | W V U;J
K N G R | N K G;R
S A L F | L A S;F
C S N G | S C N;G
K W Q F | K W Q;F
T O W L | T O W;L
N E Y A | N Y A;E
S C W O | W C S;O
R V M Z | R V Z;M
W Z M Q | Z Q W;M
Q U M R | R U Q;M
D B X R | B X D;R
J G N M | G M J;N
V I O J | I J O;V
A H G K | H K G;A
Y J F T | T F Y;J
D K Z T | D K T;Z
H M A R | M A R;H
C G T W | C G T;W
V Q B C | C B Q;V
K S J U | K U S;J
L V Y J | Y V J;L
O R M L | M R L;O
C J M V | C M J;V
W J O Q | J W Q;O
J R E M | R J M;E
A N Y E | A E Y;N
M P F Q | M Q P;F
E G H Z | E Z H;G
N U S K | U N K;S
A E P H | E A H;P
W B A Q | Q B W;A
V Z G W | V Z W;G
I C F L | L F I;C
K L P E | K L E;P
H S V X | H X V;S
U I K Y | U K I;Y
V Q S U | Q V S;U
X Q Y L | Y X Q;L
O J Y Q | Y J O;Q
G S Z D | G S Z;D
Y D G K | Y D G;K
A P X D | D X A;P
L Z R J | J R Z;L
U F K W | K U W;F
B K Q E | B E K;Q
G H R E | R E G;H
J R F H | F J R;H
A Q H E | H A Q;E
J I C F | J F C;I
V R A H | R H A;V
F O U Q | F U O;Q
W F Y B | W Y F;B
T Q P V | Q P V;T
N D E T | T N D;E
H O V E | V O H;E
Z A K D | Z K D;A
I Z E L | I E Z;L
Q X F Y | X Q Y;F
V Q P S | V S P;Q
E V N Q | E Q N;V
R P C W | P R C;W
T O Y W | T O Y;W
M D K I | D M I;K
F X R K | X F K;R
D K A U | A K U;D
L Z R Q | Z R Q;L
J E N C | C J N;E
M Y S J | M J S;Y
Q F P W | W F Q;P
D C P J | D C P;J
M P C U | P M U;C
T R Y C | C Y T;R
P H L Z | P Z L;H
L B V T | T V B;L
K W Z D | D Z W;K
W K B Y | B K W;Y
G L T U | T L G;U
A X V B | V B X;A
W O F I | O F W;I
B W F T | W B F;T
F B N O | F N B;O
Y R D C | Y C D;R
Z I N E | Z I N;E
M S Q N | N M Q;S
K W Q E | Q E W;K
Y C B G | Y C G;B
Y M N Q | N Q Y;M
P Z W B | B Z P;W
N B P O | N O B;P
K M V N | N M V;K
A I Z E | Z A I;E
E F C J | E C F;J
G T Y I | T G Y;I
O R A V | R O V;A
W M J P | P M J;W
D S T K | K S D;T
K X F Q | K X Q;F
T O S M | T M S;O
G I M A | G M I;A
V C P E | V P E;C
F J A B | A B J;F
V C J R | J V C;R
H L Q T | T H Q;L
S A O N | N A O;S
Y B Q O | Y Q O;B
U E N B | U B N;E
E Q W T | E T Q;W
M F U Y | F Y U;M
U J C F | F C J;U
O B P I | B O P;I
F B N C | N C B;F
I Z X Q | Q I X;Z
L O Y I | L Y O;I
N E Y R | R E Y;N
L P A O | A P L;O
P Q I R | R Q P;I
J D G A | J G D;A
X L B Q | L B X;Q
P Y F U | F U P;Y
T W G B | W T B;G
M V Q K | V K M;Q
J E O Y | Y O E;J
Q K A W | K A W;Q
Q L O E | E O Q;L
L N I V | I V L;N
W F A O | F A W;O
J O K C | C K O;J
J V H B | J V B;H
A K N U | N A K;U
W B T S | W B T;S
W I T B | W T B;I
F Q K W | F Q K;W
R S U D | R S D;U
S P V T | P S V;T
N B V W | W N V;B
P K Y M | Y K P;M
E B H M | B H M;E
Z O C Y | O Z Y;C
Q V Y O | Y V Q;O
E T P U | T P U;E
P G W Y | W G P;Y
Z G N R | G Z N;R
X C I Q | I Q X;C
P Z D I | I P D;Z
K T I V | T V K;I
J O K M | K J M;O
I H J X | I J X;H
O B C U | U O C;B
N V X T | N V T;X
L J E A | E L A;J
F N Q Y | Q F Y;N
Z J V A | Z V A;J
J B V P | B J V;P
Q I D E | E I Q;D
I W V N | N W I;V
Y Z C P | C Z P;Y
A B P D | A P D;B
T C N V | N C V;T
T I E H | T E H;I
E J M X | M J E;X
K Q P I | P Q I;K
L X N T | T L X;N
G N U C | C U N;G
Z F G V | F G V;Z
Q C Z V | V Z Q;C
L J D B | B J L;D
W L Q S | Q S W;L
P T N F | T F N;P
Z Q W R | Z Q W;R
H P M B | M P H;B
L K M O | L O M;K
F G P R | P F G;R
A L C P | C L A;P
B V D S | S V B;D
V S H U | U S V;H
M L Y K | Y M K;L
P Q E V | E Q V;P
Z B N V | N B Z;V
N W L R | N W R;L
A W B P | W B P;A
R E X W | X E R;W
U O T B | B O T;U
X I J C | X C J;I
Q X U Z | X U Z;Q
Z J S N | J Z S;N
W J E Y | J Y W;E
Q Z J P | Z Q P;J
M Z J E | Z M J;E
U K O Q | Q U K;O
Q S I F | I F S;Q
J H Y Q | Q Y J;H
J A U V | V A J;U
T E G O | G E T;O
B X O N | X O B;N
H L O P | H L P;O
L Z V U | L U Z;V
N Y R T | T Y R;N
K V I Y | V K Y;I
U Q M Z | Q Z U;M
T H A Q | H A Q;T
G Q Z B | G B Z;Q
M T W P | W M T;P
N M W T | W T N;M
O J L I | I L O;J
P R M K | K R M;P
N E Q U | E N Q;U
H V Y E | H V Y;E
K S J T | K J S;T
N S H A | A S H;N
X G E A | X A E;G
B K I P | I P B;K
U R W P | R W U;P
N P T I | N T P;I
M B P D | P D B;M
M W V G | M G W;V
G S U V | S V U;G
G L P A | P L G;A
P A U O | P U A;O
W M V O | W O V;M
G J U V | U V J;G
M N B R | R B M;N
G W Q T | Q T W;G
H P N D | H P N;D
I M S G | I M S;G
J W P M | W J P;M
Y P B U | Y P B;U
D G I O | O G D;I
J R Q F | J R Q;F
Y G R P | R Y G;P
H P U F | H U P;F
F M Z I | I M F;Z
G N H F | F G H;N
W D N B | B D N;W
T F I E | F E I;T
S L Q B | Q B S;L
B C N Q | C N B;Q
N M I G | I G M;N
Q E N Y | Y Q N;E
D B Z Q | Z B D;Q
V B A T | B T V;A
Y J F Z | F Y J;Z
B L Z W | B W Z;L
S D Y W | W D Y;S
V M P T | T V M;P
A K M Y | Y K A;M
K M Q S | K M Q;S
X W L R | R W L;X
C I T H | C I T;H
T G E L | E L T;G
D Y E T | T E Y;D
A R H C | C A H;R
E X Q U | E U X;Q
I L J S | S J I;L
S M P C | C M P;S
W M O V | V M O;W
O H K I | O H K;I
O H Y U | Y U H;O
K X W O | O X W;K
Y I X N | X N Y;I
B J D U | B D U;J
F T G O | O G F;T
B G H J | J B H;G
Q A D R | R A D;Q
U M L T | M L U;T
P N C U | N U P;C
Z L V W | Z W V;L
V J R O | O V J;R
Q T H X | Q H X;T
L B Q S | Q S B;L
T W Q E | Q T W;E
G X M W | M X G;W
M N S W | W S M;N
L F U I | U I F;L
S A D H | S H D;A
U G O Q | O Q U;G
Z L T E | E L T;Z
Z T Q W | W Q T;Z
L F G K | L F G;K
M T O K | T M O;K
B V C N | N B V;C
H J S Y | S H J;Y
V F A E | A V E;F
T W J K | T K W;J
T P F O | O P T;F
F I T H | I F T;H
T U E R | T U R;E
V N L D | V D L;N
A K J Z | J Z K;A
B N H Q | H B Q;N
O G E U | U E G;O
Q I L D | D I Q;L
V A E Z | V A E;Z
H I A J | H I A;J
I C J B | C I B;J
J B K H | B H K;J
B O X K | B O K;X
C N K Y | C K N;Y
O D S X | S D O;X
P O A T | P O T;A
V E H U | U H E;V
Y L Q R | Y L R;Q
L J U Z | Z U J;L
P T L N | N P L;T
M I N G | N G I;M
W I T V | W I V;T
B R L A | B R A;L
E V G J | E J G;V
A C G D | C D G;A
U Z T R | T U R;Z
M G J Z | J M Z;G
Z T Q Y | T Q Y;Z
I N R T | N I T;R
W M N J | J M W;N
S K Z D | Z D S;K
S K O M | K M O;S
Q A V I | A Q I;V
B V Y W | B W Y;V
V R F X | V R F;X
X L S G | G X L;S
K H Y I | K I Y;H
F R J W | F R J;W
W L B C | B L W;C
Z G D B | Z D B;G
I C G J | I C J;G
U T P X | U X T;P
P O K A | P K O;A
A K T V | K A V;T
S E B U | E U B;S
V B C I | C V I;B
Y I C P | P C Y;I
A S Z W | S Z A;W
R Z Q V | V Z R;Q
Q R K N | N R K;Q
F Y X B | Y F X;B
L X V S | X L S;V
J K O F | F K O;J
K G U D | U K G;D
Z U V E | E Z U;V
E L W K | E L K;W
U V K I | V K I;U
J K S F | S F K;J
D B K I | K I B;D
F Z H K | K Z F;H
Z C J B | Z J C;B
Y D N P | Y N P;D
V Y L I | V I Y;L
M N J Q | J Q N;M
B E S O | E B O;S
O H D X | X O D;H
E T S B | S E B;T
I T B V | I T V;B
Z B C A | A B Z;C
L I B H | L I H;B
G Y J H | J Y G;H
F C D T | C F T;D
N Z D L | Z L N;D
K Y Z A | Z K Y;A
A D T U | D A T;U
J H Q W | W H Q;J
N S U W | S W N;U
W O L H | H L O;W
M Z N Q | N Q Z;M
U Z G T | Z T U;G
G A K R | R A K;G
B D J C | C B D;J
G O E U | G O E;U
R I J H | R H I;J
H M C K | H K C;M
D E Y N | N E D;Y
Z S R M | Z S R;M
Y J X I | X J I;Y
J R D Y | D Y R;J
E Q H O | Q E H;O
J H O Y | Y O J;H
Z M W L | M W Z;L
M D F L | D F L;M
E J O C | J C O;E
R D H U | D R U;H
X V G Y | G V X;Y
A P U R | U P R;A
X U J C | U J X;C
B G T J | T J B;G
Q E R A | A Q R;E
F R O A | F O A;R
S L T R | R T L;S
Y W R Z | W Z Y;R
X P D F | F X P;D
D R O E | D E O;R
B N O M | M B O;N
I A B U | A U I;B
U W G D | W D U;G
M H S E | E M S;H
K J A C | K J A;C
N P Z Y | P Z N;Y
K U D T | K T U;D
D F P S | D S P;F
H N O R | R N H;O
U C M R | R U C;M
J N Z P | N P J;Z
N Q U X | U Q X;N
J R B W | J W R;B
A S P N | S P N;A
Z M F H | M Z F;H
T Y B L | B L Y;T
M V Y X | Y M V;X
W K Y L | K W Y;L
S K F B | K S F;B
I Q Z G | I Q G;Z
X W N Q | W Q X;N
C G Z E | C G Z;E
S R K V | R V K;S
G W F N | W N G;F
N A L X | X L N;A
V P C X | V X C;P
V P S X | S X V;P
D X M I | X I M;D
F B G S | B S F;G
C D Q Z | D Z C;Q
O I G U | O I U;G
E B H F | B F E;H
N S A X | X A S;N
U P C W | U C P;W
L Q U G | G L U;Q
T D N Z | T D N;Z
P D O K | D O K;P
N Q O F | N Q F;O
Z Y P I | Z I P;Y
N H M G | G M N;H
M W K D | D W K;M
R V X Q | V R Q;X
N V F M | V M F;N
K O J I | O J K;I
Y G N X | G Y X;N
A Q S U | A U Q;S
K D B L | D B L;K
E H P S | P S H;E
X W E U | W X E;U
S J F V | V S F;J
H K M Y | M K H;Y
Y L D S | L S Y;D
T Q B N | T Q B;N
D M P W | M W P;D
L E O P | L E O;P
O C Q K | C K O;Q
K L T Y | K Y T;L
U S L V | U S V;L
P T B D | T D P;B
U Q K V | K Q V;U
D Z E V | Z V D;E
Z G N L | N L G;Z
Y L Z W | Z L W;Y
G O X N | X N G;O
U G A K | A U K;G
V H U X | V U H;X
Z D H M | D Z H;M
A Z Y L | A Z L;Y
X R P E | X E R;P
M T B D | T B M;D
L N K A | N L K;A
V B H L | V H B;L
