K O Q | Q K;O
V A Q | V A;Q
S X O | S O;X
T O Z | O T;Z
U K F | K U;F
G X V | V X;G
S I N | I N;S
L V E | V E;L
Q N J | J N;Q
S I J | I S;J
F O A | F A;O
W H T | W T;H
C G V | G C;V
C S F | F S;C
V X Z | Z V;X
T V Y | T V;Y
N I U | U N;I
K H G | H G;K
V B Y | Y B;V
D Y K | K Y;D
T A L | T L;A
H D W | D W;H
I N U | N I;U
D P F | P F;D
D Q J | Q J;D
W S Y | Y W;S
M I W | I W;M
G C M | G C;M
U D F | U D;F
B A K | A B;K
W I R | R W;I
L X R | X L;R
B Y I | I B;Y
H L N | L H;N
U E Q | E Q;U
S L K | L K;S
E X C | X C;E
F V Y | F Y;V
X D K | X K;D
E W T | E W;T
M T Q | T M;Q
C S Y | C S;Y
T J Y | J T;Y
T W V | V T;W
T J N | T N;J
B Y A | A B;Y
F J C | J C;F
W A Z | W Z;A
Y N B | N Y;B
U C X | U X;C
X K F | K X;F
J N T | T J;N
S I G | G I;S
M W Y | W M;Y
D O N | D O;N
G H V | V H;G
D M G | D M;G
S R N | R S;N
D R Q | D R;Q
D N W | N D;W
C I Q | Q I;C
B O J | B O;J
J X F | X J;F
M R D | R D;M
Q R Z | R Q;Z
B T N | T B;N
I K R | R K;I
E Z X | X Z;E
X C I | X C;I
M X Z | Z M;X
W M C | W M;C
N G R | N R;G
H J V | H J;V
F H T | F T;H
Z W C | Z C;W
G E R | G E;R
S I A | I S;A
N X G | N X;G
K H Z | Z K;H
N C K | K N;C
V K J | J K;V
G Z P | G P;Z
M P U | M P;U
N I C | C N;I
J H P | J H;P
Q W I | W Q;I
C N A | N A;C
W F I | I F;W
P L T | P L;T
E I W | I E;W
J D Z | D Z;J
G N R | G N;R
A I Q | Q I;A
Z R D | R D;Z
Z M P | P Z;M
W P C | P W;C
F P L | P L;F
G J U | G J;U
J S O | S O;J
M A D | D M;A
B P E | E B;P
I F X | F I;X
M C D | M C;D
D E O | E D;O
Q P X | P Q;X
F D O | O F;D
T N V | N T;V
R B I | I B;R
J I K | K I;J
W G K | G W;K
Y W T | T Y;W
H D M | D M;H
H C G | H C;G
Y K U | K U;Y
H M U | U H;M
P I G | I G;P
K S R | R K;S
D T S | S D;T
Y Z C | C Z;Y
Z N G | N Z;G
P G W | W G;P
Y G K | G K;Y
L X P | P X;L
Z S T | Z T;S
U Y W | W Y;U
U D G | D G;U
R T N | N R;T
Z L U | Z U;L
L K W | W L;K
O V J | V J;O
L J X | L J;X
Y G D | D G;Y
M E J | E J;M
W Y L | Y L;W
O Q N | N O;Q
G O D | G D;O
B D K | K D;B
E J W | J E;W
V C O | V C;O
C H B | B H;C
O A R | A O;R
V G T | V G;T
N P I | I N;P
H Y A | Y H;A
G K U | U G;K
A P Z | A Z;P
W L J | J L;W
T D L | T D;L
H B I | B I;H
Q E M | M Q;E
J S Y | S Y;J
X G I | G I;X
L A X | A X;L
W T Q | T Q;W
K J G | G K;J
I A J | A I;J
G L B | B G;L
D T R | T D;R
E W Q | E W;Q
L T W | T L;W
K C N | K N;C
Z B D | B D;Z
V M J | J M;V
V H N | H V;N
Z O S | S Z;O
L H Z | Z L;H
R V B | V B;R
R F Z | Z R;F
T Z V | V T;Z
G J N | G N;J
M F V | M F;V
M X B | B M;X
O W T | W T;O
J H G | H J;G
S M U | U S;M
O K T | T K;O
Y A D | D Y;A
E F M | M F;E
R L G | L G;R
F T I | T I;F
M D B | D M;B
A R Z | R A;Z
L Q W | L W;Q
W R B | R B;W
D E X | E D;X
L T B | T B;L
C D L | D C;L
K T Z | K Z;T
I K G | K I;G
Z D H | Z D;H
W E Y | Y E;W
Q K M | M K;Q
R L P | R L;P
S M F | M F;S
D S E | D S;E
Q G C | Q C;G
S T G | S G;T
Z R O | Z O;R
E C B | E C;B
B R N | B R;N
H N X | H N;X
L G F | G F;L
N E R | E N;R
V T B | V T;B
P H L | P L;H
Z L B | L B;Z
I C W | W C;I
D S W | S D;W
U Z W | W Z;U
T N S | T S;N
S I Q | S I;Q
X C Q | X Q;C
X W N | N W;X
O R Y | O Y;R
I J X | J I;X
V I X | I V;X
K V T | K T;V
Y R S | R S;Y
O Z E | O E;Z
O I S | O S;I
Y O V | V Y;O
M O L | L M;O
B U I | I B;U
R Y B | B R;Y
W M J | W M;J
C H G | C H;G
B E R | E B;R
H A Y | Y H;A
A T J | T J;A
N L S | L S;N
L O D | O L;D
E H R | H R;E
A C R | A C;R
V N F | F V;N
W B L | B L;W
F A B | A B;F
E N X | N E;X
P F K | K P;F
Y G L | L Y;G
H Q R | Q R;H
T N Q | T Q;N
P F Y | P Y;F
L Z A | A L;Z
Z A O | O A;Z
G V N | G V;N
Y D J | Y D;J
R G D | R G;D
N P C | P C;N
V M F | M F;V
A U C | U C;A
Q P Y | Y Q;P
H V W | H W;V
A J Z | A Z;J
J C N | C J;N
I D C | C I;D
I E W | I E;W
H N P | N P;H
P S Z | Z P;S
T W R | R T;W
Z T E | E Z;T
F Q S | F S;Q
N H O | N O;H
O I N | N I;O
T S F | S F;T
W D H | H D;W
D W P | D P;W
Z R I | R I;Z
S E Z | E Z;S
R L H | H L;R
Z V T | Z T;V
T P N | P T;N
V Q P | Q V;P
N Y Q | Q N;Y
N G K | N G;K
X S J | X S;J
W H O | W O;H
V M E | M V;E
Y W X | X W;Y
E I J | I J;E
F A B | F A;B
F I X | F I;X
Q J D | Q J;D
E Y F | E Y;F
S W D | S D;W
P Y S | P Y;S
L D U | D L;U
K W U | W U;K
G T L | G T;L
W E T | E T;W
N P F | P N;F
B P T | B P;T
I M H | M I;H
F R U | F R;U
P N X | X P;N
K X P | P X;K
U F C | F C;U
H R M | R H;M
G D Y | D G;Y
M X J | M X;J
L P X | L X;P
T A C | A T;C
S M A | S M;A
Z G N | Z G;N
V G R | V G;R
E Y U | Y U;E
K G U | U G;K
P V X | V P;X
O C Z | O C;Z
Z O V | V Z;O
F P U | P U;F
B A M | B A;M
N B T | N B;T
Z S X | X S;Z
W M D | W M;D
Q M G | M G;Q
O M E | M E;O
O M T | T O;M
P T H | P T;H
X S G | S G;X
C R S | C R;S
Q C X | C Q;X
E K P | E P;K
D T M | D M;T
Q C E | Q C;E
C A J | J C;A
S B D | B D;S
N O C | C O;N
Q K X | X Q;K
B N K | N B;K
I C E | C E;I
Y L E | Y E;L
A M N | M N;A
W U F | W F;U
Y L D | D L;Y
S J Q | Q J;S
U T X | T X;U
M S U | U S;M
R P J | J P;R
B K H | K H;B
P Z C | Z P;C
F V K | V K;F
G S W | G W;S
A T M | M A;T
P B Y | B P;Y
Y W O | Y O;W
W N K | K W;N
L T Q | T L;Q
X J V | J V;X
E Y F | E F;Y
S D H | H S;D
I B J | I J;B
W N Z | N W;Z
E Y M | Y E;M
R E J | R E;J
B K Q | B Q;K
W T I | W I;T
G N Q | G Q;N
A S M | S A;M
B N L | N L;B
Z P U | U Z;P
M W B | B W;M
M E N | N M;E
C E V | C V;E
H Q K | Q H;K
I H M | H I;M
A C N | A C;N
C U J | J C;U
S N F | N S;F
A D R | D A;R
Z H U | Z U;H
Y V T | T V;Y
Q G R | Q R;G
P I C | P I;C
X N P | X N;P
Q B W | B Q;W
E V U | U E;V
Z K L | L K;Z
Q K E | E K;Q
B J Z | J B;Z
R F Y | F Y;R
D S M | D S;M
R Y X | R X;Y
V X G | X G;V
M Q V | V M;Q
D K X | D X;K
I Y S | S I;Y
P X R | X R;P
E P H | H P;E
R X U | U R;X
A R F | A R;F
X G F | F X;G
U D V | V U;D
I J N | N J;I
I J P | P I;J
B C Q | B C;Q
I M G | G I;M
X B G | B G;X
J V X | X V;J
Q W V | V W;Q
L U D | L U;D
Y F P | F P;Y
Q X N | X N;Q
I V K | I K;V
Z W C | Z W;C
G I V | G V;I
F S Z | F Z;S
R J L | R J;L
O M L | O L;M
A P Q | P A;Q
F T Q | F Q;T
S K M | K S;M
G Q U | Q U;G
U C F | U F;C
M U F | F M;U
V R M | V M;R
F H R | H R;F
H D F | D H;F
D C M | D C;M
Y K M | M K;Y
N F Z | N F;Z
B J H | B H;J
J B R | R J;B
A U N | U N;A
X J N | N J;X
O W K | K O;W
U M P | U M;P
U P R | P R;U
C P L | L C;P
S Q H | H Q;S
D F Z | Z D;F
I H K | H K;I
U B Z | B U;Z
D V C | V D;C
R C N | C R;N
R H G | G R;H
D F N | F N;D
U W G | G W;U
V G D | D V;G
E B Z | E Z;B
L H J | J H;L
F L U | F U;L
E O P | E P;O
V F M | F V;M
R L F | L F;R
N M E | N M;E
U S B | S B;U
S V T | T S;V
Q T D | D T;Q
K L N | N L;K
L N Y | N L;Y
O E K | K O;E
B G F | F B;G
K Q V | Q V;K
H S A | A H;S
W X F | X W;F
U P L | U L;P
C M J | J C;M
G L N | N G;L
A G E | E A;G
J G M | J M;G
S X C | C X;S
M S D | S M;D
E Q I | Q E;I
Q H P | Q H;P
I J L | J I;L
C B R | R C;B
B F N | B F;N
M K F | K M;F
S O Z | Z O;S
H P R | R P;H
L G W | W G;L
M C E | M C;E
B G V | G V;B
O K L | K O;L
M N A | M N;A
E T P | T E;P
U W V | W V;U
K N D | K N;D
X L O | X L;O
X R U | U X;R
D P J | P J;D
B M L | B L;M
P C K | C P;K
U O V | V U;O
Y E Z | Y E;Z
D L I | D I;L
T S K | K T;S
B M N | B N;M
S E W | E W;S
J V M | V J;M
J V R | R J;V
P A D | P D;A
X I W | I X;W
B I C | B I;C
I J L | J L;I
X J S | X J;S
D I A | D I;A
G H U | H U;G
W K S | S K;W
Y H P | P H;Y
E X Z | E Z;X
M L Y | M Y;L
S T N | T N;S
A P L | A L;P
A V D | D V;A
D V X | D X;V
P V U | P U;V
P X O | O P;X
T K Z | K Z;T
Y G F | Y G;F
X R B | X R;B
X S P | P X;S
Z W M | W M;Z
B S V | V S;B
I Q P | I P;Q
P H Z | P Z;H
D R U | U R;D
W M F | F M;W
W K I | W I;K
D B T | T D;B
S X C | C X;S
M T F | T M;F
E R G | E G;R
I K J | K I;J
C V W | W C;V
J F W | F J;W
Y I D | I D;Y
P Z H | Z P;H
B C F | F C;B
X Y Z | Y Z;X
H O P | O H;P
J C S | C J;S
Y P Z | P Z;Y
R Y L | R Y;L
J B T | T J;B
C V M | C M;V
K Q Z | K Q;Z
Z O K | O K;Z
D Q E | Q D;E
Q P F | Q P;F
B N Q | N B;Q
Z S G | S Z;G
P T H | T P;H
Q J B | J B;Q
M G X | G X;M
X D O | D O;X
C H P | H C;P
Q Y M | Y M;Q
L C W | L C;W
K O T | K O;T
J C K | J K;C
N S A | A N;S
V N X | V N;X
T D K | D T;K
F G J | F G;J
T V P | V P;T
J E G | E J;G
M Z X | X Z;M
J A C | J A;C
L H Y | Y H;L
U V E | E V;U
T Z O | Z O;T
E T O | T O;E
Y T Q | T Q;Y
O N F | O F;N
O N R | N O;R
W S H | W H;S
D X C | X D;C
I J B | B I;J
Q H X | H X;Q
Y H T | T Y;H
M D L | M D;L
K Z R | Z K;R
J E Z | Z E;J
N U H | H U;N
H P K | P K;H
C J R | C R;J
D B R | R D;B
V T Z | Z V;T
O Y F | F O;Y
D Y A | D A;Y
O Y G | O Y;G
L B T | B T;L
B U W | U B;W
P D Q | D Q;P
V K D | D V;K
M A E | A M;E
E K T | E T;K
X Q V | Q X;V
F G J | F J;G
O D V | O V;D
S Y R | R Y;S
D K N | N K;D
M F E | E M;F
Q N E | E Q;N
Q E J | J E;Q
R X S | R S;X
A S D | A S;D
Y V X | X Y;V
N Z P | N P;Z
O P X | X O;P
G D V | V D;G
A H N | N H;A
J L K | L K;J
D E U | D U;E
Q D I | D Q;I
Q L Z | Q L;Z
U S H | U H;S
D E T | D E;T
E A S | A E;S
W A D | D A;W
T K J | T J;K
A M B | B M;A
F B V | V F;B
W R L | R W;L
X B W | X B;W
Y E N | N Y;E
Y F Q | Q Y;F
D I B | D I;B
X W M | W M;X
V N U | U V;N
K Y R | R K;Y
V X R | V R;X
Y O F | O F;Y
Q D P | D P;Q
V O K | O K;V
O L S | S O;L
U E J | U E;J
G J A | G A;J
G C D | G C;D
J X H | J H;X
M I S | I M;S
P F U | F P;U
E F U | E F;U
Q J F | F J;Q
S A H | H A;S
E Z W | E Z;W
F S X | S F;X
I M T | T M;I
J Y O | J O;Y
I R W | R W;I
O J E | J E;O
M T U | M U;T
I Q T | T I;Q
J G X | J G;X
K B G | K G;B
M L Q | L Q;M
B O E | O E;B
M C O | O C;M
Q T J | T Q;J
C A N | C N;A
G R T | R T;G
C X H | C H;X
Q F G | F Q;G
M H O | O H;M
Z E B | B E;Z
K P H | H K;P
N T Z | N Z;T
G J O | G J;O
W J B | J B;W
T V B | V B;T
C E F | E C;F
A Y M | Y M;A
M L I | I L;M
M V E | E V;M
H Y G | Y G;H
X O S | O S;X
Q U G | G Q;U
E S F | E S;F
N U G | N G;U
T X F | F T;X
X O F | F X;O
L A T | A L;T
Z P Q | Q Z;P
O R B | B R;O
R T M | R T;M
T U E | U E;T
C R S | R S;C
H N Q | Q N;H
B R N | N B;R
V S T | V T;S
T C Y | Y T;C
Q T C | Q C;T
D O F | O F;D
B D Z | B D;Z
S U J | U J;S
Y V R | V Y;R
R B S | S R;B
P Z S | S Z;P
L A I | I L;A
J E K | J K;E
B L G | B L;G
H S C | C H;S
D R U | D U;R
Y W N | W Y;N
Q M S | M S;Q
O B W | B O;W
V X C | X V;C
T K Z | K T;Z
D P J | D J;P
R A O | R O;A
C K S | C S;K
B Q X | X B;Q
E B Y | B Y;E
Y K G | Y K;G
E P V | V E;P
X G L | L G;X
Q V M | Q V;M
I F W | F W;I
P Q K | K P;Q
P C S | P C;S
A H Y | Y A;H
A B L | B L;A
J S V | J V;S
J N C | J N;C
F Q Z | Z Q;F
J Q E | E J;Q
M Q N | N Q;M
D N B | D B;N
Y D M | M D;Y
H V J | V J;H
D T M | M T;D
N P L | P L;N
F H T | F H;T
L K Q | L K;Q
G D Q | G Q;D
U Z C | U C;Z
E O C | O C;E
E A D | A D;E
L I R | L I;R
N R Q | Q R;N
Q R E | R Q;E
R M O | R O;M
W D J | W D;J
C W K | C K;W
Q B D | Q D;B
J U F | J F;U
S V A | V A;S
G A C | C A;G
F R A | F A;R
A Z T | A Z;T
I N B | I N;B
O R Z | R O;Z
H D I | D H;I
N M P | P N;M
A K V | V K;A
E W A | W A;E
H K V | H K;V
B J R | J B;R
L J K | K J;L
Q B M | Q M;B
E H K | E K;H
R B D | D R;B
Y S B | Y B;S
U N V | U N;V
S B X | X S;B
Z Q R | Z R;Q
J P D | J P;D
E C P | E P;C
A I X | X I;A
Q C L | C Q;L
Q J C | J Q;C
P L U | U P;L
E C D | D E;C
F O I | O F;I
V G B | B G;V
U I F | F I;U
Y C U | Y U;C
D H U | U H;D
B L O | B O;L
D H M | D M;H
C P F | F C;P
B C K | C K;B
T Q V | Q V;T
U B S | S U;B
G V Q | V G;Q
I A E | A I;E
S G Z | G S;Z
L Z G | Z L;G
F V Q | F V;Q
H G U | H U;G
K I D | K I;D
Q R B | R B;Q
W Y N | W Y;N
G R Z | G R;Z
O U K | O K;U
J W S | S J;W
S L F | L S;F
H R Z | Z R;H
Z X C | C Z;X
E R F | F E;R
I J R | J I;R
E U N | E U;N
J M K | K J;M
S U Y | Y U;S
I Y C | C Y;I
Y K L | K L;Y
G R S | S R;G
O K T | O K;T
Y C A | A Y;C
F Y R | R F;Y
V P K | K P;V
L Y E | Y L;E
J W I | I J;W
W H E | W H;E
V S B | B V;S
E S Q | Q S;E
F N Z | N Z;F
Y V H | V H;Y
Z Y S | S Y;Z
A E G | G A;E
N J B | N J;B
B F C | B F;C
F C V | V C;F
I Q G | G I;Q
W V T | T V;W
T F P | P F;T
U V D | V D;U
Y J F | Y F;J
F M R | M R;F
X I F | X F;I
M O W | W O;M
V X T | T V;X
S Z X | Z S;X
V N P | P V;N
U J F | F J;U
J D N | J N;D
U T D | D T;U
B Z C | C B;Z
G H S | S H;G
H M F | H M;F
E D M | D E;M
S L Q | S L;Q
B F S | F B;S
I P R | R P;I
H Z D | Z D;H
E W S | W E;S
L W Q | L W;Q
W I X | I W;X
Z K U | Z K;U
C E S | E C;S
F N O | O F;N
U F O | F U;O
F H Q | H F;Q
X H B | X H;B
L O A | L O;A
K Y D | K Y;D
K F N | N K;F
H A N | A N;H
S R J | S J;R
X E H | H X;E
R Y K | K R;Y
K A S | K S;A
X U V | X U;V
F Y X | F Y;X
V Z Q | V Q;Z
T K A | T A;K
G C R | G R;C
R D J | D J;R
Q J S | S Q;J
X B K | X K;B
Z X C | C Z;X
G S H | G S;H
M N T | N M;T
Q C X | X Q;C
Y J X | J Y;X
O D N | O D;N
T X V | X V;T
U I O | O U;I
S V O | V O;S
Y G A | A Y;G
B C G | B G;C
D N J | D J;N
A O I | I O;A
Y L A | L A;Y
T E J | J T;E
A N S | A N;S
T W X | X T;W
G Z V | Z V;G
R E G | E R;G
A C S | A S;C
U I Q | I U;Q
J G C | C G;J
E L O | E L;O
Q V J | J V;Q
X Z N | X Z;N
F X U | U X;F
Y U V | U V;Y
Y L M | M L;Y
T Q M | Q T;M
N K C | C K;N
A V X | V X;A
G E S | S E;G
X O J | X J;O
J B A | B A;J
U G J | J G;U
I D X | I X;D
D Y E | E D;Y
M K Q | M Q;K
H C X | H X;C
U K I | I U;K
X Z T | Z T;X
U C R | U C;R
K X A | A X;K
H O V | V H;O
I X A | A X;I
R F M | R F;M
W R A | W A;R
J N X | J N;X
L X Q | Q L;X
E S X | X E;S
H Z G | G H;Z
Q W R | Q R;W
Z N L | N L;Z
L I M | L M;I
F I W | F I;W
O D Y | Y O;D
N M V | M V;N
F E Y | F E;Y
M Q G | Q G;M
A U W | A U;W
L K B | K L;B
F O J | O F;J
R F O | O R;F
H O L | L H;O
K Z S | S Z;K
I Z U | U Z;I
A Y S | S A;Y
X S O | S X;O
B V J | V B;J
Q Z S | Z Q;S
T G L | L G;T
X V A | V A;X
C D Y | C D;Y
U C J | U C;J
Z R U | R Z;U
Q V R | Q R;V
O F D | D O;F
J C B | B C;J
E Q I | E I;Q
X Q W | X W;Q
U J K | K U;J
S O U | S U;O
X C U | X C;U
H Y V | H Y;V
K N T | T K;N
Q I A | Q A;I
I G E | G I;E
I T G | I T;G
F B H | F H;B
Z A T | Z A;T
P K J | J P;K
R S D | S R;D
Q K D | Q D;K
H Q W | H Q;W
U B A | B A;U
L J V | J V;L
A Z N | Z A;N
B R Z | B R;Z
K B T | T B;K
A R J | J A;R
G V K | V G;K
S H Y | S Y;H
T X C | C T;X
G F T | T G;F
X D J | X D;J
M O P | M O;P
L H A | L H;A
X V W | X W;V
I S R | R I;S
W I H | W H;I
V R Z | R V;Z
T C M | T C;M
I L P | P L;I
N M A | N M;A
Z Y X | Z X;Y
R G H | R G;H
S K U | K U;S
W N M | M N;W
J Z R | R J;Z
I K S | K I;S
K A C | C K;A
U E I | I E;U
N Y H | Y N;H
S E J | E S;J
V O E | O E;V
J M I | M I;J
I S D | D S;I
V S A | V S;A
T C I | I C;T
W A G | A W;G
W R O | O W;R
Z G Q | Z G;Q
O M A | A O;M
P Z N | P N;Z
Z P A | A Z;P
E G S | E G;S
J D V | V D;J
H T O | O T;H
D Q G | D Q;G
T B C | B T;C
B O V | O V;B
W E Y | E Y;W
A V B | B V;A
F D G | D F;G
I L S | S L;I
C T G | T G;C
N T U | U T;N
H Z W | W H;Z
N I Q | N I;Q
H D B | D B;H
D U Q | Q U;D
M B I | I M;B
N T B | N T;B
I F K | K F;I
Z T N | T N;Z
O L F | F L;O
K Q S | K S;Q
D Y O | O Y;D
J Y W | Y J;W
L B H | L B;H
O E B | B E;O
X Q U | Q X;U
W B O | B O;W
F D I | I D;F
L G W | G W;L
J V D | V J;D
D Q W | D W;Q
O L X | L X;O
H M T | H M;T
A J X | A J;X
K M D | K D;M
B I T | T I;B
Y L S | Y L;S
S O Y | Y S;O
V T Q | Q T;V
P F O | P O;F
X R I | X R;I
N S V | V S;N
G S L | L S;G
Y X P | P X;Y
W Q M | W Q;M
T F N | F N;T
C G Q | C Q;G
F L Y | L Y;F
H G I | H I;G
N V I | N V;I
K P G | G P;K
R T H | H T;R
M W K | W K;M
V K C | V C;K
M G Q | Q M;G
M T H | T H;M
W E Z | Z W;E
R F A | F R;A
B O A | O A;B
W G E | W E;G
D E B | B D;E
Z Y N | Z N;Y
I J K | K J;I
Q J I | I Q;J
B Q K | Q K;B
P W Z | P Z;W
T C V | V T;C
Y O W | Y O;W
H V B | B V;H
Y J U | U Y;J
N E L | L N;E
E I P | I E;P
C F T | T F;C
I E M | M I;E
L I R | I L;R
M X H | X M;H
E P Q | E P;Q
Y X P | P X;Y
I K Y | I Y;K
Y G N | G N;Y
U C O | U C;O
J N V | J N;V
A I F | A F;I
A B W | A W;B
O K Y | Y O;K
M D A | M D;A
M I Q | I M;Q
Y U K | Y K;U
F L Q | Q L;F
M W E | W M;E
U V J | J U;V
S H J | H S;J
T N R | R N;T
E L O | O E;L
D U J | D J;U
B D P | B P;D
V R W | R W;V
Z H J | H J;Z
Z N W | Z W;N
U J E | J E;U
Y G S | S Y;G
D I Z | Z D;I
Z L G | G L;Z
Z G H | H Z;G
X A K | A X;K
N M Q | M Q;N
B G Z | G B;Z
Y P K | P Y;K
S D Q | S D;Q
P T Y | Y P;T
Z T L | Z L;T
U L P | P L;U
Q X H | X Q;H
N M R | R N;M
H V C | H C;V
W A N | W N;A
A U N | U N;A
Q K E | E K;Q
O N X | X N;O
F H M | M H;F
V J P | P J;V
Q R B | B R;Q
V D Z | V Z;D
Y L K | L K;Y
H G S | G S;H
H W P | P W;H
Z M P | Z P;M
O H D | O H;D
O Q F | F Q;O
B G R | B G;R
Q R A | Q A;R
V G E | V G;E
J S G | S J;G
K B U | B U;K
W F I | W I;F
Q O P | P Q;O
L K Z | Z L;K
C O F | F C;O
G C P | P C;G
B J W | B W;J
K H J | K J;H
T F P | P F;T
V Y J | J Y;V
G B O | B O;G
D O X | O D;X
W I J | J W;I
A Z C | C A;Z
W F O | W O;F
P Y O | P Y;O
B C X | X C;B
K G R | R K;G
Y B H | Y H;B
F M N | N F;M
L A D | L A;D
A H S | H A;S
H Y I | I Y;H
G N Y | G Y;N
N X V | N V;X
N L R | N L;R
B J T | J T;B
Z L H | H Z;L
D A U | A U;D
Y Q S | Y S;Q
W A X | X W;A
M I B | M I;B
C N R | R N;C
K Q G | G Q;K
O A G | G A;O
F I U | I U;F
P E H | E P;H
U A D | U A;D
G T Y | Y G;T
C O L | L C;O
H D N | D H;N
B Z O | Z B;O
R E O | R E;O
I J L | I L;J
L W M | M W;L
K P Y | P K;Y
U Q E | E Q;U
A L B | B L;A
S C W | W C;S
H C U | U H;C
L P Q | P Q;L
U O H | O U;H
P N U | P U;N
A G B | B A;G
T S H | S T;H
K E Q | K Q;E
H Z F | F Z;H
M O Y | Y M;O
A I U | I A;U
C K P | K C;P
Z E W | Z E;W
B I E | I B;E
M G K | M G;K
X Z H | Z X;H
W O R | R O;W
J Q O | O Q;J
C T A | C T;A
F A C | F A;C
J F Z | Z J;F
H R S | R H;S
B Y F | F Y;B
B Q T | B T;Q
G T K | K G;T
B X Z | X B;Z
E O T | T O;E
Y B Q | B Y;Q
S P Z | Z S;P
E U L | L U;E
M G O | O M;G
E R I | I R;E
Y E C | Y C;E
T Z V | T V;Z
X T A | T A;X
Z K Q | Q Z;K
L Z H | H Z;L
X A K | K A;X
W F Y | Y F;W
E O S | S O;E
O B R | B R;O
W L C | C W;L
K C U | K C;U
Q N Z | N Q;Z
W U G | G W;U
N Q G | Q N;G
L R N | L R;N
N K W | K N;W
U N J | U N;J
X K A | K X;A
V W Z | V W;Z
F N L | N L;F
K I J | J I;K
W U K | W U;K
F Y Z | Y F;Z
M F L | M F;L
G X D | X D;G
T C M | M C;T
G P E | P E;G
U X F | X U;F
M H C | M H;C
X E K | K E;X
B X A | X A;B
S O L | L O;S
B U N | B N;U
K S H | K H;S
A F L | A F;L
G P F | F G;P
H X N | N H;X
L M Z | Z M;L
N X R | X R;N
A E Q | A Q;E
Q C D | C D;Q
H A X | X H;A
M L W | W L;M
Z O F | F O;Z
N O Z | Z O;N
Z K X | Z K;X
L E Z | E Z;L
I A N | N A;I
D L E | L D;E
C F E | E F;C
Z J N | Z N;J
C L V | L C;V
L U B | U B;L
H M F | F M;H
U Q W | Q W;U
Q K E | E Q;K
P C Z | P C;Z
C L P | P L;C
F W D | F D;W
T G J | T J;G
D T Q | D Q;T
M B T | T B;M
G X Q | Q G;X
W L P | L W;P
L D F | L F;D
A E P | A P;E
F L I | I L;F
E O C | O C;E
L I A | I A;L
I Y N | I N;Y
S Y I | Y S;I
Y Z K | Y K;Z
L R Y | L R;Y
H Y N | H Y;N
M X R | X R;M
G C H | C H;G
U P E | P U;E
W P N | W N;P
A G Y | G Y;A
E X V | V E;X
J I C | J I;C
G C Z | G Z;C
A W M | A M;W
Z J T | Z J;T
I Z Q | I Z;Q
I S F | I F;S
S H M | S M;H
W V K | W V;K
X Y N | N Y;X
I F N | N F;I
N P G | P G;N
Y S T | S T;Y
Q F R | Q R;F
X Y M | M X;Y
F V P | F P;V
E D T | D E;T
J R L | R L;J
L Y A | A Y;L
I Y Z | Z I;Y
Z J H | J Z;H
P D X | P D;X
F S E | F E;S
F C E | C F;E
L R H | L R;H
D K Z | D K;Z
K M X | X K;M
I F Y | F I;Y
R T G | R T;G
N W U | W U;N
S I Z | Z I;S
M G F | G F;M
T F Z | Z F;T
K C N | C K;N
Y A L | L A;Y
V U B | U V;B
E S W | E W;S
K W F | K F;W
W T Q | Q T;W
N Q I | Q N;I
R S I | I S;R
R J C | J C;R
A Q V | Q A;V
T D M | M D;T
U Q T | Q U;T
F T U | U T;F
Q T G | G Q;T
Q E D | E Q;D
P O C | P O;C
H B C | B H;C
I D Y | D Y;I
I T K | K T;I
V Z I | I V;Z
O S C | C S;O
Q F Y | Q F;Y
M K H | K H;M
W S X | S X;W
X R P | P R;X
V Z C | C Z;V
W O S | W S;O
V O A | V A;O
I B M | B I;M
R U W | U R;W
K Z B | B K;Z
N E F | N F;E
H V C | C H;V
D E L | D L;E
X S E | S E;X
V K W | W V;K
C E W | E C;W
O G U | O U;G
W U X | X W;U
I Z S | S I;Z
C H I | C I;H
Y A I | I Y;A
U P J | P J;U
J F M | J F;M
R I V | I R;V
J O K | K J;O
A K S | A K;S
H X E | X E;H
H S W | H S;W
I U F | U I;F
N M E | N E;M
Q G L | L Q;G
A C D | C A;D
U C F | F U;C
E L R | R E;L
V W F | V F;W
H J Z | J H;Z
B Z L | Z L;B
L Z B | Z L;B
M T X | M T;X
G V B | G V;B
Z D Y | Y Z;D
W B C | W B;C
N F W | W F;N
F A Y | Y A;F
Z R G | Z G;R
I Z S | I Z;S
F O T | T O;F
W A H | A H;W
X A E | X E;A
T H V | V T;H
L Q Z | Z L;Q
V U L | L U;V
B S Q | S Q;B
W K L | L K;W
M A Q | Q A;M
W S U | U S;W
M V L | M L;V
D Q U | D Q;U
T N O | O N;T
B W Z | B W;Z
B Z R | B Z;R
U D N | U D;N
R G U | G U;R
M U O | O M;U
H K Z | H Z;K
W L J | J L;W
A I G | A I;G
Q A N | N Q;A
C F W | F W;C
F S P | F P;S
A O Q | A O;Q
H T K | K T;H
G Q I | G I;Q
F G A | A G;F
Y C R | R Y;C
D L F | F L;D
B G T | B G;T
Z V N | Z V;N
W Z I | I W;Z
Y M P | M P;Y
O B I | I B;O
M E R | R E;M
F G Y | F G;Y
A C N | A N;C
K O J | O K;J
Z L O | O Z;L
W S M | M S;W
F K X | K F;X
N T L | T N;L
Q X A | X Q;A
Q I O | Q O;I
W G D | W D;G
E C P | C P;E
U L T | L U;T
Y H D | Y H;D
Q C B | C Q;B
F T P | P F;T
M S U | M U;S
L G N | G N;L
L U S | L S;U
B W V | W V;B
O Y E | O Y;E
F Q J | Q J;F
X W B | B W;X
H G B | B G;H
W O U | W U;O
M T W | M W;T
T F I | T I;F
M C I | M C;I
A R O | A O;R
V H U | U H;V
E C A | C E;A
B S N | S B;N
O Q G | G Q;O
R F N | R F;N
Z L I | Z L;I
K I Q | K I;Q
D T W | W D;T
G S X | X G;S
H E N | H E;N
U Q B | B Q;U
R S Q | S R;Q
I U K | U I;K
U B E | U E;B
W U H | H U;W
C G H | H G;C
V Y C | V Y;C
W D K | W D;K
M U O | U O;M
N T R | T R;N
M O B | O B;M
M K C | M K;C
E Q G | Q G;E
Y I U | U Y;I
I K C | C K;I
X I G | X G;I
D X Q | D X;Q
Y M W | Y M;W
D S U | S U;D
U S W | W U;S
W F A | A W;F
K I M | K M;I
J D Y | D J;Y
G O X | O G;X
M C S | C S;M
X U P | P U;X
S G E | E S;G
I D M | M I;D
Z O C | O C;Z
S B D | B D;S
E F L | E F;L
K T V | K T;V
C J O | J C;O
N Q K | Q N;K
H D I | I H;D
U I C | C U;I
N A U | N U;A
M H T | T H;M
Q U S | U S;Q
D E U | D E;U
A W U | W U;A
U H D | U H;D
H E V | H V;E
Q G V | V Q;G
H V M | H V;M
E N K | K N;E
G Q T | G Q;T
U O G | U O;G
B V R | R V;B
A E P | E P;A
E M V | E V;M
W G N | N G;W
K F R | F R;K
X F G | F G;X
U P N | P U;N
P V W | W V;P
M O S | S O;M
O L A | L A;O
H D R | H R;D
G B L | L B;G
O Q D | O Q;D
S Q E | E S;Q
H N F | N F;H
K D T | D K;T
F B N | N B;F
R P I | P R;I
D W G | W D;G
A O S | O S;A
F T D | T D;F
B Z D | B D;Z
S L B | B L;S
V L U | L U;V
E N X | N X;E
S M H | H M;S
V F Z | Z F;V
Z G A | A G;Z
L N Z | L N;Z
H T F | H F;T
C Y X | C Y;X
G Q S | G Q;S
H P V | V P;H
Z C Q | C Q;Z
Y P E | P Y;E
S Z T | Z T;S
G Q D | G Q;D
F P G | F P;G
A R W | R W;A
M O Z | M Z;O
U R K | U K;R
R A Z | R Z;A
O Z T | O Z;T
J Q N | N J;Q
X K L | L X;K
Z T L | L Z;T
W D J | D W;J
P Y M | P Y;M
Q W N | Q N;W
X S Y | X Y;S
Z D W | Z D;W
R C Z | Z C;R
T H O | H O;T
Y G K | K Y;G
Z H U | U Z;H
C Y P | Y P;C
C H A | A C;H
W X B | B X;W
H U C | U C;H
Y I C | I Y;C
R Y T | Y T;R
U F S | F S;U
Z A F | Z A;F
I Z G | I G;Z
J E F | J F;E
M H W | W H;M
P R M | M R;P
K U T | U K;T
R I Q | R Q;I
W B H | H W;B
D R G | D G;R
S Q T | Q S;T
B Z I | B I;Z
N Y W | N W;Y
Q J C | Q C;J
X T K | K X;T
J A D | A J;D
Y M X | M Y;X
D W B | W D;B
Q D J | J D;Q
Y H V | V Y;H
H X U | U H;X
R F H | H R;F
U Z S | U S;Z
N M X | X N;M
F U C | F C;U
X O Y | Y X;O
Q L B | Q L;B
Q F E | F Q;E
O W V | W O;V
S C G | S C;G
L V N | L V;N
F O N | O F;N
W Z M | W M;Z
M G Z | M Z;G
H M V | V M;H
A J U | J U;A
C O P | C O;P
O C H | C H;O
B S O | O B;S
A R Q | A R;Q
U Z R | U Z;R
V Y M | M V;Y
Q P U | Q P;U
X O F | O F;X
Z W L | L W;Z
Q X A | Q X;A
B A N | N A;B
R W U | U W;R
Y X V | X V;Y
M I E | I M;E
A B Y | Y B;A
O D I | D I;O
L I K | I L;K
L I F | F I;L
J T K | T K;J
V K Q | Q K;V
Y P T | T P;Y
E V T | E T;V
Q V B | Q V;B
P O S | O P;S
C X J | C X;J
V L G | L V;G
S Q J | J Q;S
D R B | R D;B
J B D | D B;J
X V B | B X;V
H V T | V T;H
X J F | J X;F
I H O | I O;H
Y K Q | Q Y;K
X M T | M T;X
P S H | S P;H
L K J | K L;J
R T J | J T;R
S K W | K S;W
B E J | B E;J
E M T | E T;M
T O G | G O;T
D N F | N D;F
G L F | F L;G
Y R W | W Y;R
Y Z T | T Z;Y
G A L | L G;A
U L B | B U;L
H L D | L D;H
K O N | N O;K
J U N | J N;U
B S P | S P;B
Y O G | O G;Y
X A T | T X;A
S D K | K D;S
T U B | B T;U
C O E | C O;E
J S V | V J;S
I N C | I N;C
D V F | V D;F
C S Q | Q S;C
F K S | F S;K
N X R | R N;X
D W J | D J;W
P H Q | P H;Q
X G Q | Q X;G
F X D | X F;D
R S C | S R;C
D U X | U X;D
U D A | D U;A
R H Y | R Y;H
C L D | D L;C
G V U | V U;G
F N U | F U;N
H Q G | G H;Q
X D U | D X;U
C Z X | C X;Z
K N D | N K;D
Y G T | Y T;G
C W E | E C;W
U B S | S B;U
L W G | G L;W
S J F | S F;J
E F Q | E Q;F
O T X | X O;T
P I R | P I;R
Z N C | N Z;C
B Z F | Z B;F
B Q U | U Q;B
H O M | O H;M
O D Q | D Q;O
W N F | N W;F
N M W | N W;M
V N X | X V;N
X S Y | S Y;X
Q W P | P W;Q
S W Q | Q S;W
E H U | E H;U
M Q L | Q M;L
R A N | N R;A
Q A L | A Q;L
J H Q | H J;Q
G W R | G W;R
G O V | G O;V
Z A P | Z P;A
I N P | N I;P
D A J | J A;D
Y P D | P D;Y
K O E | E K;O
W L Y | W L;Y
C R P | P R;C
C D H | D H;C
H P M | P M;H
K C M | K M;C
T C D | C T;D
W I C | C I;W
S Q V | Q S;V
J W O | O W;J
H L V | L H;V
I Y F | Y I;F
B A J | A J;B
J H R | H J;R
J G X | G X;J
U Z Q | Z Q;U
V G N | N V;G
T E W | E W;T
I J F | F I;J
B A F | B F;A
F U B | B U;F
O B E | O B;E
V X R | X R;V
E Q A | A Q;E
A B U | A U;B
X F J | X J;F
N U V | N U;V
F S M | S F;M
X N C | X N;C
Q C W | C W;Q
C N X | C X;N
S M T | S T;M
E K Z | E Z;K
N Y R | N R;Y
D U K | K U;D
R Q N | Q N;R
G D V | V G;D
J W U | W J;U
K A Z | A Z;K
R Q B | Q B;R
I M W | M W;I
N F M | M F;N
W K Y | W Y;K
N C X | N X;C
Z Q U | Q U;Z
Q C G | C G;Q
L A X | A L;X
T R K | T R;K
N T V | N V;T
T F O | T O;F
S J A | S A;J
I F S | F I;S
H W V | V W;H
D K S | D K;S
A W Q | W Q;A
J H N | H J;N
Y U C | Y C;U
E A L | E A;L
L Q X | X Q;L
I N U | N I;U
N X Q | X N;Q
Y B S | B S;Y
D P Y | P Y;D
X Q Y | Y Q;X
E G K | E K;G
I B M | M B;I
M T W | M T;W
M X A | X A;M
F G K | G K;F
P U R | U P;R
Z F A | A Z;F
M C I | C I;M
O W J | J W;O
L J H | L H;J
Y Q K | Y Q;K
F A U | A F;U
Y J H | Y H;J
L C B | B L;C
K T D | T K;D
Y K Q | Q Y;K
J U A | J U;A
C J U | U C;J
W H Y | W Y;H
P A C | A C;P
X I M | I M;X
M K L | L K;M
N Y X | X Y;N
Q X V | V X;Q
J R V | J R;V
N O C | C N;O
G E D | G D;E
A Z V | V A;Z
A Q N | Q N;A
U P T | U P;T
M Q I | M Q;I
I J C | C J;I
D O V | D O;V
C Z J | J C;Z
D B U | B U;D
T J L | L T;J
R O Q | O Q;R
T W I | W I;T
L O F | L F;O
C D N | C D;N
V I T | V T;I
I A U | U I;A
P J O | O P;J
B R M | R M;B
S T Q | T Q;S
D P O | O P;D
I F K | K I;F
R H G | R G;H
Y P L | P Y;L
A C R | C A;R
V G N | V N;G
L N S | S L;N
K R D | D K;R
N X K | N K;X
U E D | U E;D
J G Z | G Z;J
G J P | G P;J
K C H | H C;K
F Z R | Z R;F
L G X | X G;L
V G Y | V G;Y
B T A | T B;A
D W P | W P;D
J K D | K J;D
U P X | X U;P
O P B | O P;B
C L R | C L;R
B G E | G E;B
E D P | E P;D
J X Y | X Y;J
Q M D | Q M;D
V D H | D V;H
K U E | E U;K
W L U | L W;U
I V Z | V I;Z
G N B | N G;B
G V J | J G;V
Q F P | F P;Q
F Y Q | Y F;Q
D A C | A C;D
Q T O | T O;Q
H K N | N H;K
X B C | C B;X
M N V | M V;N
E R C | E C;R
Y M Q | Q Y;M
T O Y | T O;Y
T I R | T R;I
P Q K | Q K;P
M S P | M S;P
X W K | W X;K
H Z Q | Z H;Q
L N B | B L;N
O D U | U D;O
S U Z | U Z;S
W H E | H E;W
V N F | V N;F
Q I F | I Q;F
Y C T | Y T;C
A J I | J A;I
Y O A | A Y;O
G X J | J G;X
B E A | B E;A
L Z D | L Z;D
L Y B | L Y;B
S A Q | A Q;S
I A S | I A;S
G C R | C R;G
Z F O | Z F;O
M T Y | Y T;M
Y W B | Y W;B
L V F | L V;F
J N C | C N;J
W T Z | Z W;T
B O X | X O;B
C Q P | P C;Q
H C T | H T;C
W D H | H D;W
S M A | A M;S
W O K | K W;O
I L N | N L;I
Q T W | W Q;T
F R J | F R;J
P B I | B P;I
B Z W | B W;Z
M Q K | K Q;M
Y I E | E I;Y
L P C | L C;P
I J Z | I Z;J
P B D | B D;P
Q Z L | Q Z;L
Q U J | J U;Q
A S G | A S;G
J D U | U D;J
D W J | D J;W
A X B | A B;X
F W X | F X;W
U X F | F U;X
H C M | H M;C
K I W | K I;W
D J M | D M;J
L H O | O L;H
D T P | D P;T
Y B J | Y J;B
Y N F | Y N;F
X W Q | Q X;W
D S V | D V;S
X C A | A X;C
P N M | N P;M
G N S | S G;N
T Y H | H T;Y
S Q J | S J;Q
M E W | E M;W
C H A | C H;A
P A Q | Q A;P
W I L | W L;I
R C O | C O;R
U Q G | Q U;G
R I L | I R;L
U A X | A U;X
H Z L | Z L;H
F L X | F X;L
L D F | D L;F
T U S | T S;U
H V B | H V;B
B N W | B N;W
R M G | M G;R
H V N | N H;V
X Q J | J Q;X
A T V | T V;A
Q M V | Q M;V
D F R | F R;D
K D V | D K;V
D K B | D K;B
V L U | V U;L
T Y X | X T;Y
P T O | O T;P
K I L | K L;I
R F O | O F;R
I F Q | Q F;I
S B P | S P;B
X I A | X A;I
L B R | R L;B
O Z K | O K;Z
U M B | U B;M
C X D | D X;C
J A M | M J;A
V I B | B V;I
V G K | G V;K
P R F | F P;R
M O Y | M O;Y
D W N | N D;W
I C X | I X;C
V G B | G V;B
V K Z | K Z;V
B M I | B I;M
D K T | T K;D
P B X | P X;B
S F D | S D;F
F J H | F J;H
L S P | L P;S
H Y Q | H Y;Q
I K L | L I;K
F W N | N W;F
G Y Z | G Z;Y
B X P | X B;P
X U B | B X;U
B P V | B P;V
O I U | O I;U
H Q B | B Q;H
L Z W | L W;Z
A M P | M A;P
I X V | X V;I
W R G | G W;R
G I P | G I;P
F A D | D A;F
Q R Y | Q R;Y
N H Z | H Z;N
G E N | E G;N
D I H | I H;D
F X M | X F;M
A O Q | Q O;A
F R P | F P;R
Z Q M | Q M;Z
F L W | F W;L
R U H | H R;U
K O Q | K Q;O
U J Q | Q U;J
D H M | M D;H
L T R | T L;R
N B F | B F;N
K H W | W K;H
N V M | M N;V
Z D R | R Z;D
N F Y | F Y;N
H K T | K T;H
L Q C | Q L;C
T J C | T C;J
H G J | J G;H
Q F A | F Q;A
C V G | C G;V
W E F | W E;F
G U W | U G;W
B M C | C B;M
Y A M | A Y;M
K I Z | K I;Z
R M K | M R;K
U C R | C R;U
W K F | K F;W
H W O | H W;O
Z W N | W Z;N
D T B | B T;D
Z C K | C K;Z
Z Q K | Q K;Z
W Q G | G W;Q
K N Z | K N;Z
J D V | J V;D
T Q J | T Q;J
N L T | T N;L
T B K | T B;K
P B Z | Z P;B
D O K | D O;K
J V A | V A;J
Z I R | I R;Z
L C W | C W;L
Q H L | H L;Q
W T X | W T;X
N D M | N D;M
Y L X | X L;Y
C K W | C W;K
B M K | K B;M
Q O L | L O;Q
M P B | B P;M
J M U | J U;M
J B S | S B;J
L O J | J O;L
H F Z | Z F;H
G X D | D X;G
P Y Q | Q Y;P
C Y G | C G;Y
C P L | L P;C
G F O | G F;O
Q U C | C U;Q
T X E | E X;T
X I N | I N;X
Y L H | H Y;L
S Z H | S Z;H
B Z G | G Z;B
O W G | W G;O
E U M | M E;U
F W Z | Z F;W
Q G H | H Q;G
M A W | M W;A
N J B | B J;N
A S J | J S;A
O A I | I A;O
B Y U | Y U;B
U S M | U S;M
M W T | M T;W
X L Q | Q L;X
Y M C | Y M;C
K H D | H K;D
V T N | N T;V
I E S | E I;S
K J Z | Z K;J
L D A | L A;D
S J A | A S;J
Y V W | W V;Y
S O Q | S Q;O
U D X | X D;U
N A M | N M;A
L F P | L P;F
K F N | N F;K
Z N G | N Z;G
N S Y | Y N;S
I B D | D B;I
C M N | N C;M
D F V | F D;V
M E C | E C;M
H K C | H C;K
P C A | C A;P
T I A | I T;A
W N D | N W;D
Q M B | B Q;M
V S L | S L;V
Y F K | K F;Y
D F E | F D;E
Q Y P | Y Q;P
F Q W | F W;Q
P J M | P J;M
D N R | N D;R
M P A | P A;M
S A Q | A Q;S
T R P | P T;R
Q X I | Q X;I
A Q E | Q E;A
W C A | W C;A
K X M | K M;X
S U A | S A;U
E D C | E D;C
B U V | V U;B
J Q E | J E;Q
I E U | I U;E
W L U | W L;U
D A N | D A;N
S J T | T J;S
D G W | W G;D
O Z P | O P;Z
B A S | A S;B
V Z M | Z M;V
N M F | M N;F
B X Y | X B;Y
Z D L | L Z;D
K M D | K M;D
O D I | I D;O
U Z L | L U;Z
E L N | N L;E
M I B | I B;M
F M A | M F;A
M P U | M P;U
L F A | L A;F
B T R | R B;T
U R A | A R;U
K P Q | Q K;P
O J E | E O;J
F W U | U F;W
Z M T | T Z;M
K P S | P S;K
H K E | K H;E
W L F | L F;W
X H P | X H;P
W T G | T W;G
D R F | D R;F
J D Y | J D;Y
K R D | R K;D
V H J | H J;V
T A Y | Y A;T
E L T | L E;T
W K V | V W;K
G O R | G R;O
M O B | B M;O
D A N | N A;D
P L D | L D;P
A Z H | H Z;A
B T S | T B;S
C H X | X H;C
J P S | J P;S
Z P Y | Y Z;P
O R I | O R;I
V F D | D V;F
D V N | D V;N
A R O | A O;R
W Z O | O Z;W
C H J | C J;H
T H O | T O;H
H T W | H T;W
K P I | I P;K
E P V | P E;V
B F L | B L;F
O U N | U N;O
P D G | G P;D
I R V | V I;R
D A V | V A;D
Y T J | T J;Y
R C D | C R;D
D Z Q | D Q;Z
T X Z | X Z;T
N I R | I N;R
J Q D | Q D;J
J E Z | J E;Z
Y Q D | Q Y;D
W P R | W R;P
K P O | K O;P
P U B | B U;P
A L D | L D;A
Y S O | Y O;S
M F J | M F;J
Q R T | R T;Q
Q K F | F K;Q
L S F | L F;S
K L P | K L;P
O D H | O D;H
Q Y T | Q Y;T
U G Q | G U;Q
P X D | D X;P
Z F T | T F;Z
F X I | I X;F
S R I | R S;I
M H Q | Q M;H
V G H | V H;G
K U N | U N;K
S D E | E S;D
L U P | U L;P
B F C | F B;C
H X J | X H;J
L I S | L S;I
Z Y U | Z U;Y
U H E | E H;U
R T P | T P;R
T I H | T I;H
R F H | R F;H
P A T | P T;A
D T W | W T;D
F C D | C D;F
V Y L | V L;Y
M X F | F M;X
X W G | X W;G
R U H | R H;U
L K S | K L;S
K R C | C K;R
F I V | F I;V
D O Y | D Y;O
T N L | T L;N
O H M | H M;O
U E X | E U;X
V L H | H V;L
I M U | M U;I
V M W | V M;W
G J M | G M;J
G K F | K G;F
Y Z C | C Z;Y
Y W P | P W;Y
H U C | C U;H
P M T | T M;P
R D O | O R;D
Q M K | M Q;K
B N M | B N;M
A G S | A G;S
W T G | W G;T
M F W | M W;F
I X G | G I;X
L A F | L F;A
Y J R | R Y;J
N P L | N P;L
O T F | O F;T
B Y E | E Y;B
M K Z | M Z;K
A N M | M N;A
H L A | A H;L
O H M | O H;M
R Z O | Z R;O
A N Z | N A;Z
I P Z | P I;Z
F E W | E F;W
M Z K | M K;Z
T M N | T M;N
L Z H | L H;Z
Y Q J | Y Q;J
P B S | B P;S
N K L | N K;L
Z W U | Z U;W
B M X | X M;B
Q V J | V J;Q
J O Q | O Q;J
Z W M | Z W;M
H V Q | V Q;H
U V D | D U;V
B L U | U L;B
C T L | C T;L
C V D | C D;V
A P C | P C;A
R B W | W B;R
P V N | P V;N
M U I | I U;M
C W L | L C;W
J W I | J I;W
B O V | B V;O
G E X | E X;G
P L V | L V;P
B Q D | Q B;D
Z T X | Z X;T
J H T | H J;T
G R V | G V;R
N T S | N S;T
D Q O | O Q;D
C I G | C I;G
M B R | M R;B
W F J | F J;W
R O P | R O;P
K T F | F K;T
K U Z | U K;Z
Z O A | O Z;A
J E H | H E;J
V L G | V L;G
S B Y | S B;Y
D N R | R D;N
I L A | I L;A
A R Q | R A;Q
W C Q | C W;Q
Q H N | H N;Q
Y F S | Y F;S
T H P | P T;H
C N U | N U;C
T E K | T K;E
K V E | V E;K
L Z U | U Z;L
P E C | P C;E
A L I | L A;I
C L T | L T;C
P F N | P F;N
S G X | G S;X
C B T | C B;T
O F D | O D;F
Q D L | D Q;L
Z P W | Z P;W
V B E | E V;B
G N F | N F;G
M Q K | K M;Q
U Z N | U Z;N
D R I | R D;I
J A N | A J;N
N U A | A N;U
I W P | I P;W
N L R | L N;R
T E S | E S;T
Y X W | W X;Y
C B X | B X;C
M A Y | M Y;A
K D C | K C;D
H G V | H V;G
M N I | M I;N
U B O | O B;U
N Y L | Y N;L
C N Y | C N;Y
E Y D | Y D;E
U P T | U T;P
U P H | U P;H
U T C | T C;U
V P T | V T;P
V F X | F V;X
E U Z | E U;Z
V M T | V M;T
O X Z | Z X;O
P N M | M N;P
C Q N | Q N;C
J H F | J H;F
X B D | B X;D
A D U | D A;U
I Q T | I T;Q
A Q N | N A;Q
Z N I | Z N;I
T K A | T K;A
J F U | J U;F
U R D | R D;U
H T C | H T;C
C W L | W C;L
Q N D | D N;Q
Z B G | B G;Z
I Y D | D Y;I
T B J | T B;J
M P C | C P;M
T V L | L V;T
E Y D | D E;Y
R H W | R H;W
J S U | U J;S
M F E | E M;F
H O U | O H;U
V J P | V J;P
C V P | P V;C
L W V | W L;V
V N O | N V;O
N H W | W N;H
M R A | M A;R
N J M | N M;J
W A Y | Y A;W
T L S | T S;L
L V I | L I;V
Z B V | B Z;V
L A F | F L;A
J X Z | Z X;J
Z N X | X N;Z
Q A D | D A;Q
Z H I | H Z;I
P Q W | W P;Q
U L F | L U;F
T Y S | S T;Y
X E V | E X;V
L V Q | L Q;V
P F I | P I;F
N W A | W A;N
O G N | N O;G
K L V | K L;V
E A C | C A;E
L X W | L W;X
P W N | P N;W
N Z T | T Z;N
B G T | T G;B
V M N | V N;M
F C U | U F;C
R M W | W R;M
W L T | L W;T
K P D | D K;P
Q I A | Q A;I
F J T | F T;J
T Y N | N T;Y
Y B X | X B;Y
M O E | M O;E
W O F | F W;O
J T S | J T;S
N R S | S N;R
O L F | F O;L
H U X | X H;U
A C Y | A C;Y
Y S K | S Y;K
D J C | D C;J
R V L | R L;V
G C H | H C;G
R Z N | N R;Z
A H K | H K;A
I R D | I R;D
F L O | O L;F
Q P F | Q F;P
I D K | D K;I
P H C | P C;H
C O N | N C;O
N F U | U F;N
U A D | A D;U
C M W | W C;M
X L M | L M;X
K Z V | V K;Z
D E W | E W;D
U P Q | U P;Q
F U L | F L;U
M L O | L O;M
B C H | B H;C
Z T R | T Z;R
L U N | N L;U
I E B | B E;I
F R G | R G;F
J M K | K M;J
L Z H | Z L;H
D C H | H C;D
U E O | U E;O
D Y K | Y K;D
N K I | K N;I
L S U | L U;S
W D I | I D;W
G T F | T G;F
U X T | T X;U
A E Z | A E;Z
M J H | J H;M
E S K | E S;K
C G V | G C;V
D U O | O U;D
T R A | T R;A
V X K | K X;V
V W G | V G;W
M W X | M X;W
X D C | X D;C
L W Y | L Y;W
X W Y | Y W;X
S R F | F S;R
C I K | C I;K
J Z Y | Z J;Y
F R Z | R F;Z
K I O | O I;K
S B H | H B;S
Z P I | Z I;P
K M C | C M;K
Y C Q | Y Q;C
C D K | K C;D
Z B V | B V;Z
R X H | X H;R
C U P | C U;P
P Z S | Z P;S
Y M J | M J;Y
C R O | R C;O
H O F | H F;O
S G K | G K;S
S A U | A S;U
G P E | G P;E
L O E | L O;E
I E D | I E;D
K T S | T K;S
O F J | J O;F
U S W | U S;W
R Q A | Q R;A
I X O | I O;X
Z C O | Z O;C
X J N | J N;X
S M V | S V;M
E S C | C E;S
H D U | D U;H
A T Z | Z A;T
O M Y | O M;Y
O S Q | Q S;O
G T C | G C;T
F I C | F C;I
K D Y | Y D;K
C T F | T C;F
L T Y | L Y;T
F M X | M X;F
H S M | M S;H
H B K | B H;K
W T A | T A;W
M L J | M L;J
E X O | E O;X
Z Q F | F Q;Z
H Y X | Y H;X
S T Z | S Z;T
R M C | R M;C
K V Y | Y K;V
J D R | J D;R
A U S | A U;S
Y J U | U Y;J
K T J | T K;J
Y K T | K Y;T
S V F | S V;F
Q R E | Q E;R
S L Q | L S;Q
M R H | R M;H
P N K | N K;P
W O U | O W;U
X Y B | B X;Y
S I C | C I;S
G C Z | G C;Z
T L Q | T L;Q
Y N Z | Z Y;N
D A B | A B;D
H N S | S N;H
V K H | H V;K
P J R | J R;P
N X Y | X N;Y
V S K | S V;K
Y N H | Y H;N
R S H | H R;S
G Y B | B Y;G
M S X | S M;X
U N M | M U;N
P E H | E H;P
M N D | N D;M
H X N | H X;N
W D F | D W;F
H C Z | Z C;H
H K W | H W;K
M S H | M S;H
M P E | P E;M
S M F | F M;S
H F M | F H;M
I P N | N P;I
Y R W | W R;Y
T J K | T J;K
W C R | W C;R
I E D | I E;D
P B J | B J;P
V J M | M J;V
C O A | O C;A
H Z X | X Z;H
C D T | T D;C
S O C | C O;S
S O A | O S;A
H J P | H P;J
Q Y L | Y L;Q
M W G | W G;M
H A O | A O;H
V Q R | Q R;V
C W I | C I;W
X H R | X H;R
Q T W | T Q;W
X V H | H V;X
F O U | O U;F
I Y H | H I;Y
K W H | W H;K
T W D | T W;D
X P N | P N;X
A Y E | A Y;E
Q B M | B Q;M
P J Q | J Q;P
H N Q | N Q;H
S O N | S N;O
Y N D | Y D;N
I L J | J I;L
M I J | M J;I
H I S | I H;S
Q L G | Q L;G
L Y B | B L;Y
I R U | U I;R
Z M U | M Z;U
T M U | M T;U
H P Z | P H;Z
R L H | H L;R
K U S | S K;U
E Q O | E O;Q
T H C | H C;T
X B C | X B;C
S P U | U S;P
L G U | L U;G
M P A | P M;A
X E L | X L;E
J Z K | K Z;J
A E Z | E A;Z
E C Y | Y C;E
Y Z E | E Z;Y
P M X | P X;M
T E D | E T;D
D X K | D X;K
E T X | E X;T
R O A | O R;A
B L P | B L;P
T P N | N P;T
M A F | F M;A
A O S | A S;O
R J B | J R;B
B U S | B U;S
G M N | G M;N
L R C | L C;R
H T Y | Y T;H
G Y H | Y G;H
B S R | R S;B
N X B | N X;B
P O E | O E;P
X W R | R X;W
W D B | D B;W
X C E | C E;X
A H D | A D;H
M P L | L P;M
I O A | A O;I
Z K O | Z K;O
P Q F | P F;Q
E N L | L E;N
V D E | E D;V
R A J | A J;R
R H Q | H Q;R
H W P | P H;W
H F J | F J;H
U Y H | H Y;U
X A M | A M;X
P L U | U L;P
Q W V | W V;Q
O W C | C O;W
G T P | P G;T
L M R | R M;L
T H Z | Z H;T
J D S | D J;S
J O E | O E;J
O A R | R O;A
I F R | R I;F
I C L | C I;L
C M F | F C;M
O K V | O K;V
M Q T | T Q;M
K O H | K O;H
S Z U | Z S;U
U B W | U W;B
V Y M | Y V;M
V H O | O V;H
W U T | U W;T
Z Q W | W Q;Z
H Q W | Q W;H
L N G | L G;N
K Q U | U K;Q
Z A C | C Z;A
B J L | J L;B
A P E | E A;P
O T Z | Z O;T
L R M | R M;L
X R S | X R;S
N P M | M P;N
B C H | B H;C
J G U | U G;J
V A M | M A;V
Z L F | L Z;F
J M W | M J;W
D X S | X D;S
M J V | J M;V
V E G | V G;E
R Q W | Q R;W
Q K T | Q T;K
D N C | D C;N
A R E | E R;A
S L U | S U;L
C W P | P W;C
B I Z | Z B;I
Y R Q | R Y;Q
E K Y | E Y;K
C S P | S P;C
A I G | I A;G
O A T | A T;O
Z O M | Z M;O
C R A | R C;A
J K E | K E;J
R T G | G R;T
F R C | C R;F
M T Z | Z M;T
P Y T | T P;Y
L Y O | Y L;O
O P Z | Z O;P
A Y P | P Y;A
Q N S | N S;Q
Z I W | I Z;W
D F M | M D;F
E N O | O N;E
D F H | D F;H
L M E | M E;L
H I O | H I;O
U L W | W L;U
R H S | H R;S
U V E | U E;V
I Q T | Q T;I
L N P | N L;P
Y B S | Y S;B
S Q M | S Q;M
M H Z | H Z;M
E K N | K N;E
M G X | G M;X
O S L | O L;S
G J K | K J;G
H I F | I H;F
F R D | D F;R
Y R H | R Y;H
A E S | A S;E
B N Q | B N;Q
M V G | V M;G
J K H | H K;J
X B J | X B;J
F S C | S F;C
X O S | O X;S
S U J | U J;S
K U W | U K;W
X J P | J X;P
C J U | J C;U
F Z U | Z F;U
N O E | E O;N
N O U | U O;N
H I P | H P;I
A V Z | A V;Z
T Z R | T Z;R
I K H | I K;H
B T K | K B;T
Q F L | Q F;L
D K H | K H;D
Q M N | N Q;M
C H O | H C;O
T E B | T B;E
L H O | O H;L
X A L | L X;A
L Y W | L Y;W
D S R | R D;S
U L S | L S;U
I E C | E I;C
X P V | P V;X
E S L | E L;S
W A V | A W;V
C T P | P T;C
O P F | P O;F
R U Z | Z U;R
M V P | M P;V
C F R | C F;R
Q L J | L J;Q
Z D R | R D;Z
S M R | R S;M
W S U | W U;S
F G S | G F;S
Y K C | K C;Y
F D V | V F;D
D P U | U P;D
P T V | T V;P
Y J G | J G;Y
P H W | H P;W
C D L | C D;L
I Q T | T Q;I
Q P G | G Q;P
C P X | X C;P
J Q C | Q J;C
R B P | B P;R
K E U | E K;U
O Y H | Y O;H
Y R K | K Y;R
F Y M | Y F;M
W O Z | Z W;O
Y E M | E M;Y
T F A | T F;A
E K H | K E;H
X M C | X C;M
S P L | L P;S
D Z Q | D Z;Q
C S Z | Z S;C
W R C | C W;R
F Z L | Z F;L
J U R | R U;J
K L D | K D;L
U O E | O E;U
V J Q | V Q;J
J O G | O G;J
T A Z | A Z;T
O P I | P I;O
X J L | J L;X
Z P K | Z K;P
I Q W | Q W;I
N Z V | V Z;N
B W M | M W;B
I R W | R W;I
H Q J | Q H;J
X Q D | X Q;D
F I B | F I;B
D T W | D T;W
F S K | S K;F
M V L | V L;M
K Q S | K S;Q
B T S | T S;B
X L Z | Z X;L
A E X | E A;X
I A K | A K;I
F K G | K F;G
F G D | D F;G
M D R | M R;D
V Z J | Z V;J
E S T | S T;E
L D T | D T;L
K N F | K F;N
A F M | M F;A
O D A | O A;D
C B M | M B;C
D E O | E D;O
W X C | C X;W
M G Y | G Y;M
D U L | L D;U
M G Y | Y M;G
P X E | E P;X
C T O | T O;C
K N R | N K;R
X M R | X M;R
T P W | P W;T
A G Q | A Q;G
D G N | N G;D
W R Y | W Y;R
B T K | T K;B
F T G | F T;G
X L J | X L;J
F A K | A K;F
J E D | J E;D
J R Z | J Z;R
F P C | P F;C
Y H A | A H;Y
S J T | T J;S
Z M A | A M;Z
T V U | V U;T
V N E | N E;V
W U V | U W;V
Y H U | U H;Y
V Z M | V Z;M
E D M | M D;E
B Q U | U Q;B
P M R | P M;R
I L G | G L;I
U P I | U I;P
Y L I | Y I;L
M C X | X M;C
D S N | D N;S
X U K | K X;U
U L V | L U;V
I H O | H I;O
W T S | T S;W
X K R | R X;K
M P R | P R;M
I B Y | B I;Y
T Z N | T N;Z
F N I | F I;N
A S K | K A;S
T A W | T A;W
X O K | X K;O
F B N | N B;F
A O S | A S;O
R Q F | R Q;F
Z V Q | V Z;Q
F I X | X F;I
C H G | C H;G
T L P | P L;T
P M G | P G;M
J H U | J H;U
C S L | C S;L
E C P | E P;C
B R W | B R;W
C L R | R L;C
M W K | W K;M
F Z U | Z U;F
I E J | I E;J
J P Z | P Z;J
H W X | X W;H
J H U | J H;U
A L Z | L A;Z
K V J | V J;K
Z K G | G K;Z
I F L | L F;I
M B A | A B;M
L R S | S L;R
B S X | B X;S
T C L | C T;L
K E W | K E;W
R Q P | P Q;R
Z L Q | Z Q;L
S F H | H S;F
C B Z | Z C;B
H K Y | K H;Y
U M D | M U;D
C S I | C I;S
W P S | P W;S
I A L | L A;I
R N C | R C;N
U J N | J N;U
P I B | P I;B
T D G | G T;D
E B Y | B E;Y
M K J | M J;K
F E N | N E;F
F D P | D P;F
S X I | I X;S
K C D | K C;D
J T E | E T;J
P B A | P B;A
H W P | W P;H
B L O | L B;O
T H U | H U;T
M X N | M X;N
K G E | E K;G
D X C | D C;X
M W S | M W;S
A P F | A P;F
N F E | N E;F
X C T | X C;T
X D S | S D;X
M G D | D M;G
N O C | O N;C
X M E | E X;M
H I P | I P;H
Y A H | Y H;A
L E W | L W;E
T F R | R T;F
N Z W | W Z;N
F S C | C S;F
E P L | L P;E
R W A | A R;W
E W Q | Q E;W
R B J | R J;B
U H T | U T;H
C Z N | N C;Z
V N W | V W;N
G P H | G H;P
V A Y | A Y;V
J E F | E F;J
Q Y A | Q A;Y
T G F | F T;G
S A C | C A;S
K T D | K T;D
S X U | X U;S
E N J | N J;E
T N L | N L;T
D S Q | S Q;D
Y D T | Y D;T
A E L | L A;E
P B J | B P;J
Y S K | Y S;K
C F H | C H;F
S Z D | S Z;D
W G I | W I;G
T A D | D T;A
V P L | V P;L
X C I | X C;I
S X B | S B;X
J I B | I B;J
E I A | E A;I
X G L | G X;L
D M K | D M;K
T K Q | Q K;T
Z V X | V X;Z
R Z X | X Z;R
C K H | H K;C
G C D | C D;G
W U E | W U;E
J I S | S J;I
Q R Z | R Z;Q
G L X | L G;X
E B U | U E;B
D K S | S K;D
F H K | F K;H
E H F | E F;H
Y G W | Y G;W
J T R | R J;T
U Z C | U C;Z
Q P E | Q E;P
W B E | E W;B
Q M T | T M;Q
B R U | R B;U
O H W | W H;O
R S Y | Y R;S
T Q K | T Q;K
F A C | A F;C
J V P | V P;J
S B M | M B;S
O N L | N O;L
O H T | O T;H
O E L | O E;L
H V I | V H;I
O G V | O G;V
X M F | X F;M
B X Z | B Z;X
L B H | L H;B
F X E | X E;F
Q K P | K P;Q
T L C | L C;T
V F Q | Q V;F
G V E | V G;E
K N E | E K;N
S A F | A S;F
C Q Y | Q C;Y
M A X | X A;M
I R Q | Q I;R
R E J | J E;R
J V B | V J;B
J B A | B A;J
U X O | U X;O
N B S | B S;N
G W X | W X;G
I T X | I X;T
V S N | N S;V
J K G | G K;J
K G L | G K;L
M A E | M E;A
C P V | P V;C
O V B | B O;V
U O I | U I;O
N F P | F N;P
I F T | T F;I
R I E | E R;I
R G I | G R;I
E J H | E J;H
F D R | R D;F
T E R | T R;E
Z Q Y | Z Q;Y
U B S | U B;S
C G T | C G;T
C O Y | O C;Y
E R I | I E;R
U H T | U H;T
F Y D | D F;Y
K M Z | K Z;M
N H E | E H;N
W Z X | Z X;W
G A D | A G;D
U P B | U B;P
N Q A | Q A;N
R G Z | G R;Z
S M J | M J;S
R Z P | P R;Z
S Y X | Y X;S
O U N | O U;N
U D Z | D U;Z
D W P | D W;P
N C J | J C;N
T I Z | I Z;T
Q A M | Q A;M
X G E | X G;E
H A M | M A;H
N L I | N L;I
C I A | A I;C
D Z E | Z D;E
N U R | R N;U
D B F | D B;F
R W K | R K;W
C K T | C T;K
M G U | M U;G
P D A | P A;D
K F J | F J;K
F J D | F J;D
E B A | B A;E
C L W | L C;W
R V M | V R;M
K P L | K P;L
V K N | V K;N
M X A | X M;A
S N A | A N;S
A P F | P A;F
W H S | S W;H
B C D | C B;D
U N L | L N;U
P B I | I P;B
L N W | N L;W
S E M | S E;M
O K R | K R;O
D P I | P I;D
F M P | F P;M
Q A L | A Q;L
J I D | I D;J
M F H | F M;H
Y L R | L Y;R
S T C | S T;C
N H T | H N;T
L T R | R T;L
W N L | L W;N
K I J | I K;J
S O W | O S;W
U J F | J F;U
L C N | L N;C
C S N | C S;N
A Z J | A J;Z
N M T | N M;T
H E D | H E;D
V N C | V N;C
F U R | F U;R
S J M | S M;J
V S G | G V;S
D P T | T D;P
T Q X | X T;Q
M A T | M A;T
X C T | X T;C
X D Y | X D;Y
L X W | X W;L
J Y V | J Y;V
D B K | K D;B
W R P | W R;P
X S P | P X;S
Y G S | G Y;S
C O A | O A;C
T M V | M V;T
J I Z | Z J;I
N A R | A N;R
W M I | W I;M
J B D | J B;D
U P M | P U;M
V E Z | Z E;V
I Z L | I L;Z
Y X S | X Y;S
A I D | I A;D
N I W | W I;N
L F Z | L Z;F
G O S | O S;G
C Y Q | Y C;Q
Z L G | L G;Z
O V X | X O;V
L R K | R L;K
S W J | W J;S
K U H | U H;K
S C J | C S;J
A X C | X C;A
F T Y | T F;Y
R Y D | Y D;R
V W M | M W;V
W L H | W H;L
U A Y | U Y;A
Q F Y | Y Q;F
J M E | J E;M
V F O | V O;F
I A Z | A Z;I
A N C | N A;C
O N A | N O;A
I V E | V I;E
B M S | S M;B
A N R | N R;A
R A Z | Z R;A
F L U | L F;U
J I L | L I;J
D G K | G K;D
G Z E | Z G;E
E L B | B L;E
R Q K | Q K;R
I O Q | I O;Q
O G Z | G O;Z
J S D | J S;D
Z H D | H D;Z
S P E | S P;E
D K F | F D;K
B R Z | B R;Z
E T P | T P;E
B Y T | Y T;B
Y E F | F E;Y
J T G | G J;T
L Q I | L I;Q
A N G | A G;N
P Z I | P Z;I
A W M | A M;W
A L V | L A;V
Q E Y | E Y;Q
E C A | A C;E
B P N | B P;N
Z T O | O Z;T
U G W | W G;U
I E W | W I;E
V Z C | V Z;C
R W M | R W;M
M S R | R S;M
T G O | G T;O
C Q W | Q W;C
N D I | N D;I
M Q Z | Q M;Z
S U P | S U;P
P D O | O P;D
Z I J | J I;Z
X N M | N M;X
K Z D | K D;Z
I E P | P I;E
E S Z | E S;Z
I L P | L P;I
Y H N | Y N;H
V P U | V P;U
J T B | B T;J
M L R | R M;L
A G F | G F;A
K C S | K C;S
H Y N | N H;Y
C E Z | E Z;C
G D V | G D;V
V B A | V B;A
J C R | C J;R
B V N | N B;V
V E U | E U;V
D R Z | Z R;D
Q Y V | Y V;Q
X V W | W V;X
A T Y | T A;Y
T X B | X T;B
R Y K | Y R;K
S Y O | O S;Y
H W N | N H;W
N I P | P N;I
Y V U | U Y;V
G K D | D K;G
G P I | I P;G
T F N | N T;F
D J A | J D;A
Q T L | Q T;L
H G I | I G;H
R E M | E R;M
M A L | L A;M
P V Q | V P;Q
U B G | B G;U
F K D | F K;D
X A K | A X;K
U Y S | S U;Y
S Z T | S T;Z
D Q Y | D Y;Q
V C W | W V;C
X V A | V X;A
I W E | I W;E
E F Q | E F;Q
U V J | U J;V
N R U | N R;U
X C L | L X;C
W U H | U W;H
C H W | H W;C
S Y Z | Z S;Y
E A H | H A;E
X U L | X L;U
L U H | H L;U
X O S | O X;S
G R L | G R;L
K E F | K F;E
Z U N | Z N;U
J U Y | J U;Y
B Q W | Q W;B
L M A | L A;M
Z Q K | Q Z;K
K T G | T K;G
M K O | M O;K
U K B | K B;U
D O G | D G;O
R V T | T V;R
P E I | I E;P
X Y L | Y X;L
D R J | D J;R
E M Z | E Z;M
E Y W | Y W;E
K A E | K E;A
F R D | R D;F
D X U | U X;D
R Z J | Z J;R
I K G | G I;K
G W T | W T;G
O E P | O E;P
I Y S | I S;Y
A I F | I F;A
H I Z | I H;Z
E N V | N V;E
Y B G | Y G;B
G D O | G O;D
A J U | J U;A
A U R | A U;R
O T E | E O;T
T Q K | T K;Q
S E J | J S;E
F S E | S F;E
Z J I | Z I;J
L E K | L K;E
A O M | O M;A
A T Q | T A;Q
E H R | E H;R
M N E | M N;E
W J B | W B;J
W V L | V W;L
O J Q | O J;Q
I K N | I K;N
N Y C | C Y;N
P N F | P N;F
X Y S | S Y;X
T N G | G N;T
Z K B | B K;Z
E S C | C E;S
J Z I | Z J;I
B Y C | C Y;B
J O L | J O;L
P Q F | Q P;F
N G I | N G;I
Z V K | K V;Z
Y U B | B U;Y
R M V | R M;V
E P Z | E Z;P
W P E | P E;W
F S A | S F;A
Y K X | K Y;X
D V P | D V;P
X K R | R K;X
V P I | I P;V
Y E S | E S;Y
P K A | A P;K
Y G X | G Y;X
Y G L | Y L;G
R O N | N R;O
E C F | C E;F
E G N | G E;N
P D M | P M;D
G A Q | A G;Q
A Q K | K A;Q
J D L | J L;D
Z X C | C Z;X
V Q K | Q V;K
S C V | C S;V
Y D R | Y D;R
T W C | W C;T
U Z C | Z U;C
B C V | V C;B
G I A | A G;I
Y O G | Y O;G
E L G | G E;L
K W U | K W;U
D N E | E D;N
E N U | U E;N
Y B R | R Y;B
L M F | F M;L
E V P | V P;E
Z Y P | Y P;Z
B J P | P B;J
L W E | W L;E
Y J Z | J Y;Z
M O C | C O;M
N W T | W N;T
S L K | K S;L
A M W | M W;A
D Q O | O Q;D
Y J V | Y V;J
J Q R | Q R;J
T X P | X P;T
D W N | N W;D
B C Q | C Q;B
X J L | L J;X
R L M | L M;R
T I C | T I;C
Y W O | O Y;W
Q Z B | Q Z;B
K A M | A M;K
N C O | C O;N
Z I F | I F;Z
C I W | I W;C
S J Z | S Z;J
D B L | D L;B
M S J | J M;S
B S X | X S;B
R U O | R U;O
L Q K | Q K;L
J P H | J P;H
V A D | A D;V
Q I G | Q I;G
E O H | E H;O
F L H | L H;F
C P F | F C;P
I P V | I P;V
C P S | S C;P
H U V | H V;U
U Y A | A U;Y
G B F | B G;F
Y K U | Y U;K
B D F | D F;B
W L F | L W;F
B J V | V J;B
A Y V | A V;Y
E D T | T E;D
Y D B | B D;Y
R X O | O R;X
H M P | M P;H
M L A | L A;M
G X H | H G;X
S B R | S R;B
Z F N | Z N;F
H F J | J H;F
Z U D | Z U;D
Q N Y | Q N;Y
E O A | O A;E
C A R | A R;C
O G Q | O G;Q
L F D | F L;D
O J X | X J;O
F T X | F X;T
J V D | D J;V
N W D | D N;W
H V N | V N;H
N Y G | Y N;G
G N J | N J;G
A V L | V L;A
E X N | E X;N
Y O Z | Y Z;O
Q A L | A Q;L
A O G | O A;G
V B H | V H;B
N I P | I N;P
U X P | U X;P
R V D | R V;D
X N D | N X;D
X P H | X P;H
P Q K | P Q;K
S D V | V D;S
H R K | H R;K
Y U V | V Y;U
Z E J | E J;Z
R X Q | Q X;R
O Y G | O Y;G
J Q G | G Q;J
R L M | L M;R
E G W | E G;W
T B D | T D;B
J M X | X M;J
H A W | W A;H
K R X | K R;X
S A K | A K;S
D O C | O C;D
B Z G | B G;Z
I G T | T I;G
W J R | J R;W
P T O | P O;T
W D J | D J;W
F B S | F B;S
Z P I | P Z;I
A F O | F A;O
G I F | F I;G
H C U | U C;H
S J G | G J;S
O T Y | O T;Y
O C Y | O Y;C
P V S | P V;S
F N W | W N;F
C M Q | Q C;M
I K P | P K;I
W F R | F R;W
W L G | W G;L
F R O | R F;O
O D E | D E;O
C R Y | Y C;R
H Y O | Y O;H
T I Q | I Q;T
H B R | B R;H
K I P | P K;I
A P H | P A;H
K T M | M T;K
O A U | O U;A
D Q U | U Q;D
D I Z | Z I;D
G A O | G O;A
Z B F | F Z;B
W A H | A H;W
V N Q | V Q;N
S Q B | B Q;S
U X I | U I;X
K A G | K G;A
G V P | P V;G
P W S | S W;P
Z H A | H Z;A
G I A | G A;I
K Z A | A Z;K
I V B | V B;I
O L J | J L;O
Z O Y | Z O;Y
R L M | M R;L
G M O | M G;O
L C G | C L;G
Y M W | M Y;W
G V B | G B;V
B D R | B D;R
O X H | H X;O
Y T B | B Y;T
R L E | E R;L
E O F | E O;F
I W L | L I;W
Q M U | Q U;M
L V U | L V;U
G B U | B U;G
M S R | R M;S
F N A | A N;F
V Q O | O Q;V
O D B | D B;O
N R K | N K;R
A H F | H F;A
Q I F | Q F;I
P K D | P D;K
X T I | T I;X
U D A | U A;D
Y P D | D Y;P
C I W | C I;W
H I Q | I H;Q
M X H | H X;M
O M H | O M;H
R X Y | Y X;R
M Y K | K M;Y
H T S | T H;S
O V Q | O V;Q
I B U | U B;I
K B Q | K Q;B
I M E | E I;M
E O D | O E;D
N X E | E X;N
X N D | N X;D
N M E | N E;M
E N G | G N;E
R Q O | Q O;R
R P I | R P;I
A X O | A O;X
V P E | V E;P
G C T | T C;G
P K O | K O;P
V R Z | Z V;R
N S Z | S N;Z
D B A | D B;A
A I N | I N;A
W J A | W A;J
W B Z | W B;Z
Q U X | X U;Q
X Z P | P X;Z
Q B Y | Q B;Y
O T B | O B;T
H A I | A I;H
P D O | O P;D
F H D | H F;D
M W P | M P;W
J Y O | J Y;O
B R I | R B;I
I B T | I B;T
G J M | G J;M
A S H | H S;A
C H Z | C H;Z
L N I | L I;N
C X G | X G;C
M K R | R K;M
V Z M | V M;Z
H W B | H B;W
R K B | B R;K
C W F | F W;C
L M R | R L;M
U D A | U A;D
H Q D | H D;Q
S K L | L S;K
O D X | D O;X
K X F | F X;K
F Q W | Q W;F
S O P | P S;O
D Y X | X D;Y
Y U K | Y U;K
Z F Y | F Z;Y
Z V D | Z D;V
C Y P | P C;Y
E I V | V E;I
A U R | R A;U
D S H | D S;H
X E C | E C;X
I J W | J I;W
P F O | F O;P
C A Z | Z A;C
S J L | J S;L
H O D | O D;H
E Y A | Y A;E
E L Q | L Q;E
X B Y | B Y;X
E R G | E G;R
K A W | W A;K
Z N V | N V;Z
B Q D | Q D;B
Y J G | G J;Y
R Y J | J R;Y
M T H | H M;T
F Z A | F A;Z
U M P | U P;M
B K E | E K;B
J E U | U J;E
A S Y | S A;Y
E V T | V T;E
W O P | P W;O
Q S K | K S;Q
N I O | I O;N
J D V | V D;J
I Z Y | Z I;Y
X N S | S X;N
K O W | O W;K
H Y Z | Z H;Y
Y N M | M Y;N
L U Z | U L;Z
I P Y | P I;Y
R A T | A T;R
O P Z | O Z;P
N A S | S A;N
C V M | V M;C
V Y L | V Y;L
X F E | E F;X
P D N | D P;N
X B R | R B;X
H D Y | D H;Y
D K W | D W;K
G M P | G M;P
F E V | E F;V
A L C | L C;A
F S X | X S;F
T V X | X T;V
E M I | M I;E
U V M | V U;M
Y E Z | Y E;Z
F P X | P F;X
U F G | G F;U
B S C | C B;S
O S F | S F;O
W R J | W J;R
I C V | I V;C
G K R | G K;R
K B Q | Q B;K
Q Y X | Y Q;X
W R J | J R;W
G U A | A G;U
E C O | O C;E
U Y X | U X;Y
U Z E | U E;Z
Y B J | B J;Y
C G A | A G;C
R F Q | F Q;R
K Q I | Q K;I
F O Q | O F;Q
A G Z | A G;Z
H O T | O H;T
J I F | J I;F
H I T | T I;H
S H D | S H;D
H K F | H K;F
N Z B | Z N;B
D P R | R D;P
L V J | L V;J
G T Y | Y G;T
O E R | E R;O
C Q X | C X;Q
V P R | V P;R
Y H K | H Y;K
R T V | R T;V
C H O | C H;O
O D A | D A;O
K U W | W U;K
D L V | D L;V
X S V | X V;S
W K B | B K;W
H U I | H I;U
R G U | U G;R
P N W | P N;W
Q I U | U I;Q
E H S | E S;H
P S K | S P;K
A L C | L A;C
C L I | I L;C
X O M | O M;X
O E P | P E;O
G M D | M G;D
W U T | T U;W
H N Q | H Q;N
X O J | O J;X
G C E | E C;G
N C U | U N;C
I E O | I E;O
N Y I | Y N;I
E L A | E L;A
A V S | A V;S
A U W | A U;W
T E N | N E;T
K N Y | N K;Y
R D Z | Z R;D
N M X | M X;N
Z E T | Z T;E
A Y F | Y F;A
V W B | B W;V
L S F | L F;S
X K N | X K;N
T M O | O M;T
X G S | S X;G
K T I | T K;I
F X L | F L;X
H J T | T J;H
T Q K | Q K;T
K E J | J K;E
Y J I | I J;Y
U S H | S H;U
N R B | B N;R
Z A P | A P;Z
J M N | N J;M
A F E | E A;F
E I M | I E;M
Z L T | T L;Z
M I J | I J;M
B U N | U B;N
G N P | N P;G
L W D | W L;D
U Y A | Y U;A
T P W | P W;T
Z M D | M D;Z
X E J | E X;J
G Y L | Y L;G
D K B | D B;K
X R O | O R;X
O J T | T O;J
U W T | W T;U
W K X | X W;K
F W D | D F;W
U H E | E H;U
Y R U | U R;Y
Y M O | O M;Y
J Y U | Y J;U
E N V | V E;N
Q Y A | Q Y;A
U K P | U K;P
Z P N | P Z;N
B H Q | H Q;B
F A H | H F;A
V W A | V W;A
O D U | D O;U
G X Z | Z X;G
E V Y | V E;Y
V Q Y | V Q;Y
W A Z | Z A;W
V K F | V K;F
T N E | T N;E
P X B | X P;B
N K L | L N;K
Q I M | I Q;M
Z U B | U B;Z
P A Z | Z P;A
E Z C | C E;Z
X T B | X B;T
L I E | L I;E
W S A | W A;S
K C Z | K C;Z
P S G | S G;P
K F T | T K;F
W X T | T X;W
Q C T | Q C;T
R U Y | U R;Y
C W E | C W;E
J P M | M P;J
A X Z | A X;Z
V O R | V O;R
D J T | J T;D
N J B | N B;J
H V Y | Y H;V
P N U | P U;N
N W B | B N;W
T P K | P T;K
Q O E | Q E;O
O Q I | Q O;I
Q K C | C Q;K
I F L | L I;F
Y Q A | Y A;Q
K M W | M K;W
V B Q | B V;Q
Q J U | U J;Q
S D L | S L;D
L T X | T L;X
R F C | R F;C
R W I | I R;W
F Y W | Y W;F
P Z T | Z P;T
V Q Z | Z Q;V
Y Z I | Z I;Y
Y U S | Y S;U
W F X | X F;W
S I O | S I;O
R B O | B R;O
A V P | A V;P
A F W | W F;A
O V C | C V;O
O C J | J O;C
G I L | L I;G
F B K | B F;K
M Q H | Q M;H
G Y M | G Y;M
G Z I | I G;Z
J S O | S O;J
H W R | W H;R
X L Z | Z X;L
Q X M | Q X;M
Y Q Z | Q Z;Y
G X L | G X;L
N J Y | Y J;N
W I P | P W;I
Y C J | J C;Y
Y P D | P D;Y
Z X U | U Z;X
X A U | X U;A
V C I | I V;C
E F Y | Y E;F
H B D | H B;D
C K Y | C K;Y
E N Q | Q N;E
V J L | L J;V
N V L | L V;N
K E I | E I;K
Q X Y | X Q;Y
L P X | P L;X
O R T | O T;R
W Z S | W Z;S
V T H | T H;V
J L N | N J;L
C O Z | C Z;O
Q K G | K G;Q
S P D | D P;S
F H X | H X;F
F G A | F A;G
X S R | S R;X
A X I | A X;I
P N L | N P;L
C E R | E R;C
L V I | I V;L
L H U | L H;U
W I U | I U;W
D I X | I X;D
G W I | I G;W
L X H | X L;H
I F X | I X;F
G U R | R G;U
R Y F | F Y;R
H C S | S C;H
L W V | W L;V
R G X | X G;R
V J Z | J V;Z
Q P L | L P;Q
L T A | T L;A
N Z F | N F;Z
W D I | W I;D
N C J | C N;J
V L Q | L V;Q
K N T | K N;T
B G Y | B Y;G
H T K | T H;K
Q S V | Q S;V
B V X | V X;B
Y U D | Y D;U
S J V | V S;J
D X I | I D;X
Y N O | O Y;N
P U Y | Y U;P
F S M | F S;M
Z Y G | Z G;Y
S R L | L S;R
D B F | B F;D
E D H | E D;H
B I N | I B;N
Q L S | L Q;S
T O V | O V;T
O Y K | Y O;K
G W V | G W;V
N Y O | N O;Y
C N U | C N;U
H U F | U H;F
H O X | H O;X
N D E | E D;N
H L R | R L;H
N W F | N W;F
O Q C | C O;Q
N J X | N X;J
G H M | M G;H
N R P | P N;R
X N R | N R;X
U R P | R U;P
J H T | J H;T
I U H | U H;I
D P N | N P;D
J B R | R B;J
K Y N | N K;Y
P B Q | Q P;B
P W U | P U;W
T S Y | T Y;S
X C A | X C;A
Q W F | Q W;F
P W A | P A;W
W P U | U W;P
N K Q | Q N;K
A M R | R M;A
Z N U | N Z;U
O F K | O F;K
Q Z K | K Q;Z
S N J | N J;S
Z S H | H Z;S
S N M | N M;S
V I P | I V;P
G P H | P H;G
V E I | I V;E
W P K | P W;K
F B K | B F;K
Q P E | E Q;P
P T Y | Y P;T
H W U | W U;H
G T J | G T;J
F V M | M V;F
T M P | P M;T
R K M | K R;M
K E L | K E;L
Q D N | D N;Q
O G C | O G;C
Z Q S | S Q;Z
P I Y | I Y;P
M K D | K M;D
S M Q | Q M;S
M Y X | Y M;X
E X N | X N;E
O L M | O M;L
P S L | S P;L
T S W | T S;W
T W C | C T;W
A P O | O P;A
N O D | O N;D
Q R E | E Q;R
N J D | J D;N
T P Q | P Q;T
J F Y | J F;Y
A I X | A I;X
X B D | X D;B
F O S | F O;S
S T P | P S;T
V H O | H O;V
T W O | O W;T
B M T | M T;B
U O B | B O;U
J T Q | T J;Q
X V C | X C;V
L I T | T L;I
G W Y | W Y;G
Z G R | R Z;G
Y C G | G Y;C
A E R | E R;A
K M P | K M;P
F V L | L F;V
I F V | I V;F
N D B | B D;N
W Z Y | W Y;Z
E I H | I H;E
Q M Z | M Z;Q
P V B | B P;V
G J I | J G;I
T F O | T F;O
E Z B | E B;Z
C A I | A I;C
V K O | K O;V
T Z R | T Z;R
L Y C | L C;Y
H I U | U I;H
K U X | K X;U
J O C | J C;O
W A Q | A W;Q
B M K | B M;K
L J K | L J;K
Z T U | T Z;U
B L Z | L B;Z
Z R E | Z R;E
J E W | E W;J
G S X | G S;X
R M G | G R;M
O X S | O X;S
X S O | O S;X
L U J | J U;L
L X Y | Y L;X
H V Q | Q V;H
K G F | F K;G
M V J | V M;J
N R D | N D;R
J D L | L J;D
W Y F | F W;Y
I K S | S I;K
P E A | E A;P
A F X | F A;X
N A G | A N;G
F D C | D C;F
M C Y | M Y;C
Q R S | R Q;S
J G T | J T;G
T W D | D W;T
R K P | P K;R
J W F | W J;F
L A T | A L;T
G W C | C G;W
S I C | S C;I
P M V | M V;P
A O K | O A;K
N F H | F N;H
N H L | N H;L
C U F | C F;U
W L Z | Z L;W
M R N | M N;R
R U O | O R;U
T R O | O T;R
D O E | E O;D
X W B | W B;X
P Y R | P Y;R
J B L | B J;L
P T S | T P;S
R T U | U T;R
K T Z | Z T;K
H I F | F I;H
C F Z | F C;Z
H B L | L B;H
F R A | A R;F
O M E | O M;E
Y Q Z | Q Z;Y
F T P | P T;F
N H R | R H;N
Y X A | X A;Y
Z A R | Z R;A
N I W | I N;W
O M Y | O Y;M
I W J | I J;W
E O B | E O;B
N I R | N I;R
K J W | W K;J
O K V | K V;O
Y R F | R F;Y
W Y Z | W Z;Y
N X L | X N;L
X O A | A X;O
F C X | X F;C
O G A | G O;A
V Q T | Q T;V
H I R | H R;I
B P Z | Z P;B
V O L | O V;L
J A Q | A Q;J
B W M | B M;W
A B D | D A;B
A L K | A L;K
S Z Y | S Z;Y
H Q E | Q E;H
I N E | I N;E
W K H | K W;H
C U T | U C;T
X C D | X D;C
R O U | U O;R
M R C | M C;R
G W V | W V;G
C W F | F C;W
X H L | X H;L
M J U | J U;M
P Q E | E P;Q
S K F | S F;K
W P U | W P;U
O X E | E O;X
Q L T | T Q;L
H K P | H K;P
J L C | J C;L
B A C | A B;C
S L X | S L;X
L Z D | Z D;L
B V Y | Y V;B
M N Q | Q M;N
L M D | D L;M
E N X | N E;X
A K N | K A;N
N T K | N K;T
T J K | J T;K
O M Y | M Y;O
M H K | H M;K
R K D | R D;K
Y F V | F Y;V
U Z L | Z U;L
N K S | N K;S
G N K | G N;K
R X D | X R;D
Y N W | N W;Y
F Q V | F Q;V
G Z F | F G;Z
U E X | E U;X
K M C | C M;K
U W E | E W;U
B N W | B N;W
M W C | W M;C
W N Z | W N;Z
I M N | I N;M
B Y H | B Y;H
D Q Z | Q D;Z
P K Z | K Z;P
U Q J | Q U;J
W Z M | Z W;M
L Y V | L V;Y
R A X | A R;X
D Q V | V D;Q
B U W | W U;B
B Z K | K Z;B
C U F | F U;C
G T B | G B;T
P X C | C X;P
I M A | A M;I
V H Z | Z H;V
K V E | V E;K
I J M | M I;J
O H C | O C;H
F N D | N F;D
H C A | A C;H
V F X | F X;V
H J E | H J;E
D H E | D H;E
Y I M | I M;Y
M S B | B M;S
U E K | U K;E
R B F | R F;B
C S K | S K;C
Y F U | U F;Y
A L B | B L;A
Q Y D | Y D;Q
J U O | U O;J
W K R | R K;W
Y Q T | T Q;Y
Q Z J | Q Z;J
R Y K | R K;Y
Z R V | R V;Z
F J A | A F;J
U N A | N U;A
D W S | S W;D
P U A | A P;U
Z J W | Z J;W
N B X | X N;B
Y K Q | K Q;Y
C G A | G A;C
F B C | F B;C
E D M | E D;M
O L H | L H;O
X U Q | X Q;U
R Q Z | R Q;Z
X Z R | X Z;R
G R O | O R;G
H G F | F H;G
A Q T | Q A;T
J S K | K J;S
M T U | U T;M
O B G | B O;G
H F D | D H;F
I K V | K I;V
C J T | J C;T
R H C | H R;C
G P L | P L;G
Q R S | R Q;S
V U B | U B;V
M H I | H I;M
U G Q | G U;Q
N J U | N U;J
B V I | I B;V
W F I | W F;I
O S A | A O;S
A E O | E A;O
S A B | B S;A
N C Y | Y C;N
M W A | W M;A
K J G | J K;G
X Z I | Z I;X
C H E | H E;C
N O E | E N;O
O K E | K O;E
G B Q | G B;Q
X L C | C X;L
H Q V | H V;Q
O A P | A P;O
N J P | P N;J
K J H | J K;H
F C M | F M;C
V A R | A R;V
Z O A | O A;Z
Y N T | N T;Y
P Z O | P Z;O
S Q X | X Q;S
A N G | G N;A
V D K | K D;V
X Y V | Y X;V
P E H | E P;H
J L Q | L Q;J
S O E | S E;O
J Q R | J Q;R
I G Q | I G;Q
E C O | E C;O
D C Q | C D;Q
S T H | T H;S
L U J | L U;J
N P U | P N;U
W V N | W V;N
H Z L | Z H;L
N F Z | Z F;N
P K N | P K;N
N S Y | Y S;N
P V O | V O;P
U G F | F G;U
Q I D | I D;Q
Y I W | W I;Y
G R A | A G;R
D R A | D A;R
G T F | T G;F
F Q M | M Q;F
F R C | C R;F
G S Y | Y G;S
K E X | E X;K
L Q V | V Q;L
Z O X | O X;Z
K G M | K G;M
B F G | B F;G
T D K | K D;T
J D Y | Y J;D
M F J | J F;M
R V T | T V;R
E B Y | B Y;E
Y Z U | U Z;Y
R Y L | R Y;L
D Q K | D K;Q
S X Y | Y X;S
R N A | N A;R
L N J | L N;J
I O Z | Z O;I
H Y M | M Y;H
G S N | N S;G
B V J | V J;B
H V U | H V;U
S U Q | U S;Q
W A L | L A;W
C A H | H A;C
C Q W | Q W;C
O K P | K P;O
L K N | L N;K
H L Z | H Z;L
Q F V | F Q;V
L C U | C L;U
J D B | D B;J
U Z Q | U Q;Z
N V Y | Y V;N
R S C | S R;C
I O Q | Q O;I
D T J | J D;T
T G Q | G T;Q
X H A | H X;A
K W Q | Q W;K
T U N | T N;U
F U D | F D;U
P R U | R U;P
S N I | S N;I
J N Q | Q J;N
M Y P | M Y;P
J X K | J K;X
H T Y | Y H;T
A Z Q | Q Z;A
W T B | W B;T
L K A | K A;L
H Q C | H Q;C
M S H | S H;M
H C D | H C;D
C X P | C X;P
R Z X | X Z;R
A H Z | H Z;A
V K Q | Q K;V
U X Z | U X;Z
U P R | P U;R
X V H | H V;X
U C D | U D;C
E S P | P E;S
F K C | F K;C
L M V | M L;V
A V Y | V Y;A
E L D | E D;L
G R Q | G R;Q
D E O | O D;E
D J M | M J;D
T S R | R S;T
F I M | I F;M
B Y I | I Y;B
E L A | A E;L
Q Z B | Z Q;B
T K J | J K;T
J M X | X J;M
O P T | T P;O
J D C | D J;C
P F U | P U;F
X O G | X O;G
J K H | K J;H
A N J | N J;A
G E U | E G;U
Y M J | J Y;M
M G F | F G;M
X O S | S X;O
T E P | P E;T
Q D R | R Q;D
T A D | T A;D
I G M | I G;M
D N U | N U;D
C P X | X C;P
K J B | K B;J
P D E | D P;E
V Y H | Y V;H
S P D | P S;D
W E S | W E;S
R C D | D R;C
V F C | F C;V
J U K | J K;U
T Y V | Y T;V
K B J | K B;J
B P W | P B;W
G I S | S I;G
L M Z | M Z;L
L Y F | Y F;L
J V D | V D;J
E O Q | Q E;O
R T Y | R T;Y
Y V L | Y L;V
Z K Q | Z Q;K
Q T K | T Q;K
H J W | H W;J
K Q L | L K;Q
C U E | C U;E
D W B | B D;W
Q S F | Q F;S
N Z B | Z B;N
V Y X | Y X;V
X Q I | I X;Q
U B O | U O;B
Y B G | B G;Y
L N R | R L;N
B K I | B K;I
X E I | E X;I
Y W N | W Y;N
W D Y | D W;Y
C V P | C V;P
K C R | C K;R
F W M | F W;M
Q R S | R Q;S
P E G | G E;P
I V L | I L;V
J C N | J C;N
Z B Q | B Z;Q
R S M | M R;S
U E V | E U;V
U Y S | U Y;S
A N E | N E;A
Q U O | O U;Q
N M G | G M;N
S B U | B S;U
C S K | S C;K
O K G | G K;O
M H I | H I;M
L B T | T L;B
V R P | V P;R
G F R | R G;F
J U P | J U;P
W V N | V W;N
C L H | C L;H
A D U | U D;A
E G T | T E;G
V L N | L N;V
L C X | C L;X
E K H | H K;E
G U O | O U;G
K S L | K L;S
A L F | A F;L
X B V | B X;V
C D L | D L;C
R O S | R S;O
V Y O | V O;Y
Z N K | N K;Z
Y D C | C Y;D
Y G U | G Y;U
V M W | V M;W
S J N | N J;S
A E D | E A;D
O P F | P F;O
A O Y | Y O;A
A R Q | Q R;A
D L Q | D Q;L
M N P | N P;M
V O C | O V;C
L A Y | A Y;L
P C W | W C;P
C L F | F C;L
J K R | R K;J
B N Q | Q N;B
Z Q K | K Z;Q
K G V | G V;K
R H A | A R;H
H E M | H E;M
Z L F | L F;Z
R U D | U D;R
K C N | K N;C
Y K G | Y K;G
F P O | P O;F
V A B | A V;B
O M H | O H;M
B J X | B X;J
W D Q | D W;Q
Y T G | Y T;G
C I A | A I;C
D S N | N S;D
I Q R | R I;Q
D N P | N P;D
D T R | R T;D
Y T F | Y F;T
E J M | M E;J
U I P | P U;I
E P L | L P;E
C R M | M C;R
B C S | S B;C
Z S P | S Z;P
K T C | K C;T
A H G | A H;G
V G H | V H;G
L M I | M L;I
C S P | S C;P
B O V | B V;O
D R Q | Q R;D
L K H | H L;K
E D Z | D Z;E
V N D | D N;V
F V G | G V;F
S L F | F S;L
G M B | M G;B
I Q K | K I;Q
M W A | M A;W
Y R N | Y R;N
K T Q | K T;Q
L D U | U L;D
W E F | F E;W
J Q W | J Q;W
F I G | I F;G
A X Z | Z X;A
B W N | B W;N
U K O | U K;O
P G J | G P;J
B C I | B I;C
Y L H | H Y;L
R C A | A C;R
V O M | O V;M
V D R | R V;D
O N I | O I;N
R O L | R L;O
W U A | A W;U
H R B | B R;H
Z Q C | Z C;Q
L E I | I L;E
R M Z | R M;Z
J M E | M E;J
A F I | I A;F
M C A | A M;C
J D Z | J Z;D
M T Z | M T;Z
Z K H | K H;Z
I J H | H I;J
E U R | R E;U
V B J | V J;B
K W F | W K;F
E A R | A R;E
M L H | M L;H
L S X | S X;L
P M W | W M;P
B S T | B T;S
X G Q | G Q;X
Z U G | Z G;U
Y T O | Y T;O
R I A | I R;A
M D T | D M;T
X A D | A X;D
W U C | U C;W
T L C | T L;C
S K Y | K S;Y
T N C | N T;C
L F C | C L;F
U T I | T U;I
N A I | A I;N
X B G | X G;B
T U J | T U;J
S L G | G L;S
S A D | S D;A
E B Q | E B;Q
W C V | V C;W
K Y X | Y X;K
N T I | N T;I
J Q D | D Q;J
M E V | V M;E
V S Y | Y S;V
U J T | U T;J
M E C | C M;E
L U E | U L;E
B Q A | B Q;A
G F M | M F;G
S V O | O V;S
L F A | A L;F
V C O | O C;V
V P I | P V;I
B R F | B F;R
B A J | J B;A
V C X | X V;C
N D B | B D;N
C X Z | Z C;X
Q O C | C O;Q
G U W | W G;U
V K S | K S;V
L J X | X L;J
O P B | B P;O
S N H | N H;S
I E N | N I;E
D N R | N R;D
L B P | L B;P
A W Z | W A;Z
K O I | I O;K
F O Z | F O;Z
K E H | E K;H
T Z P | Z T;P
J F I | J I;F
R H E | E H;R
B P G | P B;G
O F U | O F;U
J M X | M X;J
Y I X | Y I;X
M V J | M V;J
X D K | K D;X
U M S | M U;S
J O U | U O;J
R B H | B H;R
K J R | J R;K
F K O | K O;F
D B Z | B Z;D
A M Y | A Y;M
C D P | C D;P
R V J | V J;R
D A F | A F;D
O Q Z | O Z;Q
W Z F | F Z;W
P X R | R X;P
I U M | I U;M
G H J | G J;H
Y N S | Y N;S
F T X | X F;T
T N O | T N;O
W N X | X N;W
V M A | V M;A
N G T | N G;T
L A Q | A L;Q
E W O | O W;E
R P C | P C;R
C I S | I S;C
S F Z | S F;Z
U A C | A C;U
Y X F | Y X;F
M N D | N M;D
O M B | O M;B
D U G | D U;G
G S Q | G Q;S
M W F | M F;W
U Y F | U F;Y
J A X | X J;A
X P J | X J;P
X E R | E R;X
Q K W | W Q;K
A S I | S A;I
E P Q | P Q;E
R K P | P K;R
Z E B | Z B;E
E W D | W E;D
A S V | A V;S
H L A | A H;L
U I M | U I;M
K S M | S K;M
X I D | I X;D
N O Z | N Z;O
B L M | L M;B
J V H | H J;V
G U C | U G;C
W D G | G D;W
H W X | X H;W
A V W | W A;V
T A I | I A;T
D Z U | U Z;D
D F V | F D;V
Q O M | Q M;O
C G H | G C;H
X Q Y | Y X;Q
C S D | D C;S
N G C | C G;N
L N B | L B;N
P Z J | P J;Z
Z R L | Z R;L
B U M | M B;U
G Y P | Y P;G
O X U | X O;U
I B O | O I;B
R T B | R B;T
H Y Z | Z Y;H
K C A | K C;A
Q P U | U P;Q
H C V | C V;H
A T W | W T;A
I P R | P I;R
Y D O | O Y;D
G R Y | R G;Y
P T G | P G;T
V G W | W G;V
P B K | K B;P
Z K L | L K;Z
L G J | J L;G
Z Y R | Y R;Z
Y N L | Y L;N
V C H | C H;V
C L Q | L C;Q
Z M F | Z F;M
A U P | A U;P
Q G I | Q G;I
R Y O | R Y;O
Q H Y | Y H;Q
W F Q | Q F;W
X Q G | X Q;G
U K V | V K;U
U N Q | U N;Q
Y U D | D U;Y
S G U | G S;U
D C K | C K;D
C O M | O M;C
R P X | P R;X
J T Y | J Y;T
M Q X | Q M;X
G P Q | Q P;G
C I P | I P;C
E Z F | Z F;E
I U Q | Q U;I
P S N | P N;S
U I W | I W;U
H E I | H I;E
O M Q | Q O;M
L W U | W L;U
R A S | R A;S
P R T | T P;R
V N W | V N;W
L F X | L X;F
Z U W | U Z;W
R A C | C R;A
Y H T | T H;Y
P X T | T X;P
H O Z | Z O;H
B U I | B I;U
G X S | S G;X
M T F | T F;M
O V K | O K;V
M I P | P I;M
R F H | R H;F
I A X | X I;A
S K R | R K;S
E J H | H E;J
Z M Q | M Q;Z
M Y W | Y M;W
G M S | S M;G
H G J | G J;H
I U R | U R;I
H T P | P H;T
Q K U | K U;Q
Q Y S | Q S;Y
U Q C | U C;Q
S Q C | S Q;C
Y H X | Y H;X
Z R L | Z R;L
C X K | C K;X
W B X | X W;B
M N V | M N;V
K Q L | K L;Q
X Q A | X Q;A
D C G | D C;G
O I K | I O;K
H Z M | M H;Z
X G O | G X;O
S V T | T S;V
K A R | R K;A
W Z N | W Z;N
U O I | U I;O
C Q L | L C;Q
L T V | T V;L
X M S | X M;S
S R C | R C;S
Q N D | Q D;N
K A P | K P;A
R W Z | R Z;W
Z I U | Z I;U
A O W | O A;W
Q T K | Q T;K
U S D | D S;U
I H U | H U;I
V X J | J V;X
T X N | N T;X
X C D | D C;X
Z E V | E Z;V
Z V R | Z R;V
B Y U | U B;Y
Q C X | X Q;C
M Q W | M W;Q
R V M | R M;V
N M D | N M;D
W H E | W H;E
X A I | X A;I
W C V | C V;W
D S V | D V;S
U L E | L E;U
W J P | P J;W
I C K | C I;K
M O D | D O;M
A D L | D A;L
U J G | U J;G
V K O | K V;O
D Y U | Y U;D
Y P R | P Y;R
M X I | M I;X
K W X | W K;X
V X S | X V;S
K X Q | Q X;K
L J Y | L Y;J
L K S | K L;S
D K B | D K;B
K G U | U K;G
A R E | E A;R
E V N | V N;E
H W M | M W;H
P W K | K W;P
S U W | S W;U
A V C | V C;A
A B S | B A;S
Z R Y | Z R;Y
W H Q | H Q;W
C V T | T V;C
T X B | T X;B
V D N | N V;D
U C W | C U;W
C U K | U K;C
S N Y | N S;Y
I V R | R I;V
A L W | W L;A
F R W | F W;R
H N G | G N;H
Z A P | Z P;A
Q L N | N Q;L
Z Y O | O Z;Y
S C O | C O;S
U A P | P A;U
Z P X | Z X;P
B N L | B L;N
Q G C | Q C;G
L G H | L G;H
G Z T | Z G;T
Y R G | R G;Y
S X J | S J;X
M Q E | E M;Q
T G F | G F;T
M U K | U M;K
C S Z | S Z;C
Y W N | Y W;N
H R Z | H Z;R
C K I | I C;K
P B I | I B;P
B C Y | C Y;B
C J I | C J;I
P J E | E J;P
S P J | J P;S
V Y U | U Y;V
X B C | C X;B
P K Y | K Y;P
T N S | S T;N
T F N | F T;N
H I W | I H;W
X D M | M X;D
D M N | M N;D
E X F | E X;F
N Y U | U N;Y
T M C | M C;T
O S R | R O;S
Z X M | X M;Z
X L F | F X;L
V N H | V H;N
E A D | A E;D
Y A G | G Y;A
D K Y | K D;Y
X Q O | O Q;X
T L D | T D;L
R Q S | Q S;R
V M O | M O;V
W B M | M W;B
P U L | U L;P
A R H | H R;A
Y O F | O Y;F
O K I | K I;O
B Y E | Y B;E
Q X S | S Q;X
G O R | G R;O
A O Q | O A;Q
T G K | G T;K
I T Q | T Q;I
K W L | L W;K
Y E Q | E Q;Y
N G U | G N;U
E T I | T I;E
W I H | H I;W
O S A | S O;A
V N H | V N;H
G W D | W G;D
W U K | K U;W
O F I | I O;F
N U Y | N U;Y
D Z X | Z D;X
N F Y | F Y;N
C M D | C D;M
T F L | T F;L
Z Y U | U Y;Z
C R Y | C Y;R
F V Z | V Z;F
C X N | C N;X
I Q R | R Q;I
Y W N | W N;Y
O H I | O H;I
C O W | C W;O
V S K | S V;K
D Q T | T D;Q
K U M | M K;U
O K R | O R;K
V G M | G V;M
H S W | H W;S
U F M | F M;U
I S K | I S;K
I R G | I G;R
W Q O | Q W;O
V D L | D L;V
X W Q | Q X;W
K B W | K W;B
A R Y | A R;Y
J M P | M J;P
L S T | S L;T
C M L | L C;M
T L X | T L;X
H A N | A H;N
G X S | S G;X
L C R | L C;R
I K G | K I;G
P V Q | V Q;P
T R G | G R;T
A X V | X A;V
M O G | M G;O
N Q L | N L;Q
Z C Q | C Q;Z
O X U | U O;X
I Z L | Z L;I
F D G | D F;G
M U R | R U;M
U V L | U V;L
J T K | K T;J
S G R | S G;R
A J P | A J;P
G C X | C X;G
W Y Q | W Y;Q
B F C | B F;C
P C W | C P;W
G R M | G R;M
E Q Z | Q E;Z
D Z L | L D;Z
E Z N | N E;Z
N Z U | U Z;N
M S T | M S;T
Q J F | Q F;J
H D O | O D;H
K G Q | G Q;K
G Q I | G I;Q
X C V | C X;V
S P T | T P;S
V N C | C V;N
A G V | A V;G
F E M | F M;E
W B S | S B;W
K M Y | Y M;K
M H Z | H Z;M
C X B | C B;X
E X J | X J;E
A N J | J A;N
L H A | L H;A
S W G | W S;G
S F A | A S;F
A S G | G A;S
R T U | R T;U
D B N | B D;N
F O Z | Z F;O
P U E | U P;E
X Y V | Y V;X
M I K | K M;I
I W D | W I;D
X Y T | Y T;X
H X G | G H;X
I R N | N I;R
T Z H | H T;Z
Y O Z | Z O;Y
W K U | W K;U
L S J | L J;S
E V U | U V;E
W L M | M W;L
D O A | D O;A
V Z U | Z U;V
X H Z | Z X;H
P B J | J P;B
L T A | A L;T
P T Q | Q P;T
O D J | D J;O
X N V | N V;X
N W Z | W Z;N
G E F | G F;E
U B J | U J;B
G V E | E V;G
Z H S | H Z;S
S R E | E R;S
E X A | E A;X
S A D | S A;D
K E M | K E;M
O F C | F C;O
U G F | G U;F
L G K | G K;L
R T P | R P;T
M S G | S G;M
O N X | O N;X
V L D | L V;D
K C I | C I;K
J R E | J E;R
P G U | P U;G
R P D | P D;R
F R A | R A;F
V M S | S V;M
W A B | W B;A
T X A | T X;A
W B M | W B;M
R B T | R B;T
Y F G | F G;Y
S D M | S D;M
L H R | L H;R
X F J | X J;F
D S T | D T;S
X C N | C X;N
A S X | X A;S
B Z U | B Z;U
W U M | M W;U
I L J | L I;J
Q R S | Q S;R
X E Y | E Y;X
X U T | U T;X
S L B | L S;B
R G I | G R;I
N B O | B O;N
E O Q | E Q;O
A X M | M A;X
E N K | N E;K
W V X | X W;V
X G B | X G;B
X Q U | X U;Q
B W G | W G;B
Y L O | Y L;O
M O G | M G;O
R H J | H J;R
U X O | O X;U
D W G | W D;G
Y U G | U Y;G
I C L | I L;C
J I Q | I Q;J
H M D | D H;M
Q T M | M T;Q
A F K | K A;F
U E R | E R;U
R X Z | X R;Z
P T Q | P T;Q
J R D | D J;R
B U S | S U;B
U T G | U T;G
E O G | O E;G
