Y N J | N J;Y
R O Q | O R;Q
E Q D | Q E;D
G F H | G F;H
J U S | S J;U
S X D | X D;S
Q J X | X Q;J
I M G | G I;M
H R P | P R;H
D M X | D X;M
H W V | V W;H
H E X | H X;E
G T D | T D;G
I X M | X M;I
X O S | X O;S
I A H | H I;A
R H Y | Y R;H
I Y E | I E;Y
X K Y | X Y;K
X Z F | F X;Z
B I N | N I;B
F B T | B T;F
H N F | H F;N
T B H | H T;B
E R U | R E;U
M X D | M X;D
X J L | J L;X
I N V | I N;V
K T C | C K;T
X J G | G J;X
I Y T | Y I;T
C W V | C V;W
I U A | U I;A
A E Z | A Z;E
O N K | O K;N
C Y A | A Y;C
D W T | T W;D
G Y B | G Y;B
S Q V | Q S;V
O L R | R O;L
F B W | F W;B
B R T | B T;R
M G F | G F;M
F L W | W F;L
D R U | U D;R
V N C | V C;N
A W L | L W;A
M R T | T R;M
A N Y | N Y;A
W J G | W J;G
O T E | T E;O
Q B W | Q W;B
Q D X | D X;Q
I S T | S T;I
U E C | U C;E
O J G | O G;J
P C H | C P;H
J X Q | J Q;X
V O W | W O;V
T F D | F D;T
U L V | V L;U
I V N | V N;I
Z V S | V S;Z
O K U | O K;U
I S Y | S Y;I
D N F | F N;D
E O Y | O E;Y
Y N O | N O;Y
R E D | R D;E
Q B K | Q B;K
P E M | M E;P
S I H | H S;I
F I T | F T;I
M B N | N M;B
U K X | K U;X
A F V | F A;V
B Y I | B I;Y
L M D | D M;L
H I U | I U;H
P H Z | H Z;P
P K O | O P;K
R B T | T R;B
X N W | N W;X
K E L | L K;E
K E N | N E;K
I W K | K W;I
E W Z | E W;Z
J Z Q | Z J;Q
B G D | G B;D
Y W B | Y B;W
P S W | W S;P
R W Z | R W;Z
Y U B | B Y;U
R U B | U R;B
V K B | K B;V
P Z N | Z N;P
R Y G | R Y;G
Z I W | Z W;I
D R S | R D;S
P R C | C P;R
W X B | B W;X
Q P B | B P;Q
B E J | J E;B
O H J | H O;J
X Q Y | X Y;Q
X E C | C X;E
K C T | C T;K
K J Z | J Z;K
N Q P | P Q;N
P V C | P C;V
A K Q | K Q;A
P C O | C P;O
J B P | J B;P
O H K | K H;O
H C K | K C;H
V L C | V C;L
O G L | L O;G
D N Q | N D;Q
B Q D | Q B;D
Z M X | Z X;M
H K Z | K H;Z
I W P | W P;I
P T J | P T;J
I Q T | I T;Q
A H C | C H;A
X N C | C N;X
T V S | S T;V
U E J | J E;U
O A K | O A;K
Z L N | L N;Z
M D E | E M;D
B I A | B A;I
R Z Y | Y R;Z
B F V | B F;V
A Z J | J A;Z
U N Z | N U;Z
D F L | D L;F
U K B | K B;U
H I A | A H;I
E C Y | Y E;C
D E B | D B;E
S P Z | Z S;P
J Y U | Y U;J
D Y G | D Y;G
Y A T | T A;Y
Q C G | G Q;C
L J Y | L J;Y
U W T | W U;T
M D G | M G;D
J T M | M J;T
P B T | P B;T
J S L | S L;J
M P Q | P Q;M
C U K | C K;U
S H Q | S H;Q
K C F | C K;F
K D R | R K;D
X P Z | P Z;X
V D O | V D;O
I L U | L I;U
A T R | A T;R
O I Y | O I;Y
F D L | D L;F
G R D | G R;D
H W Y | H Y;W
Z Y N | Z Y;N
S F N | F S;N
U Y A | A Y;U
J L Y | J L;Y
A O X | A O;X
I Q E | E Q;I
D J B | D J;B
Z W C | C W;Z
P E O | E P;O
J G K | K J;G
K U C | K U;C
Z C V | C Z;V
D I G | G D;I
T D C | C D;T
I R D | D R;I
M U I | I M;U
R S H | H S;R
E O V | E O;V
C U J | C J;U
B T V | T B;V
T V S | S T;V
S E G | G S;E
C E M | C E;M
F U Q | U Q;F
L D E | E D;L
H D W | H W;D
G D C | G D;C
Q G J | Q J;G
N Q R | N Q;R
C P M | C M;P
K L G | L K;G
O V A | V A;O
I J O | J O;I
A U F | F A;U
M X H | H X;M
Z O L | L O;Z
R S W | W R;S
P L U | P L;U
M A I | M A;I
Q X Y | X Q;Y
J C Y | Y J;C
U I P | I U;P
R A C | R A;C
I B G | I G;B
X R Y | X Y;R
Q M V | Q M;V
L R U | L U;R
Z L K | K Z;L
E U Q | Q E;U
Z Q J | Z J;Q
U D T | U D;T
B T E | E T;B
W A Q | Q W;A
Q R Y | R Y;Q
H E N | N H;E
A Q D | A D;Q
K N C | N C;K
D G S | S D;G
B N F | F B;N
C W L | C W;L
E T X | T X;E
K A G | K A;G
G V D | V G;D
A J D | A J;D
T W V | W T;V
L S T | L T;S
Z B V | B Z;V
R C V | V R;C
W R F | F W;R
O N F | N O;F
K T I | K I;T
L X O | O X;L
L H J | L H;J
U S B | S B;U
M R P | M R;P
A N J | J N;A
E I T | E T;I
F J H | F H;J
F J G | F J;G
S F L | F L;S
V K E | E K;V
C L A | C L;A
G X Y | X Y;G
P V W | V W;P
Y T D | Y D;T
S H B | H S;B
X L B | B L;X
H Y W | H W;Y
C U J | U J;C
N L B | L N;B
P N A | P N;A
I J Z | Z J;I
R P O | P R;O
D T Q | D Q;T
N J K | J N;K
E Q F | F Q;E
E N D | N D;E
B U Z | Z B;U
P H Y | P H;Y
G A F | F G;A
V R N | V N;R
O L Z | O L;Z
W N F | W N;F
Q A U | A Q;U
E D J | E D;J
K W D | K D;W
U R H | U H;R
G S U | S G;U
C L E | L E;C
L F B | B L;F
Z X W | W Z;X
R M K | K R;M
X C D | C D;X
T G X | X T;G
E Y K | K E;Y
W Q J | Q J;W
U Q S | U Q;S
F H Z | F H;Z
V C S | V C;S
W J N | J W;N
H F X | X F;H
T S N | S T;N
W S H | S W;H
N K Z | N K;Z
R W V | R W;V
P O H | P O;H
Z J Y | Y J;Z
C Z G | Z C;G
B M T | T B;M
K P Y | P Y;K
S Y F | S Y;F
G M V | M G;V
D Q V | V Q;D
H L F | L F;H
Z D C | Z D;C
Q S H | Q H;S
E P Y | E Y;P
E C V | E C;V
A J E | E J;A
Z F C | Z C;F
W Z P | W P;Z
U D K | K U;D
O B K | O B;K
Y A N | N Y;A
A E J | E A;J
Z K Q | Z K;Q
O E A | E O;A
H G F | F G;H
B A V | V A;B
U G P | U P;G
Q F N | Q F;N
P M H | M P;H
D W M | W M;D
E I Y | E I;Y
T X B | T B;X
V U P | U P;V
V D Q | D Q;V
J H P | P J;H
I Z S | I Z;S
S N F | S F;N
V R J | R J;V
G S P | S P;G
U L G | L U;G
U C V | C V;U
O E G | E O;G
M L R | L R;M
Z R O | Z R;O
T U Y | U Y;T
F E A | E A;F
F L C | L C;F
Z T J | J Z;T
J K E | E J;K
E L H | E L;H
N G E | G N;E
M Z E | Z E;M
H K W | W H;K
X B T | T X;B
L O N | N L;O
F W Z | W Z;F
M W G | W G;M
D F J | D F;J
S D E | D E;S
H Z D | D Z;H
Y L V | V L;Y
E X S | S E;X
L J T | L J;T
I Y B | Y I;B
M K N | K M;N
P G R | R P;G
F O G | O G;F
N L J | N L;J
H Y I | H Y;I
P F S | P S;F
H J S | S J;H
T H D | T H;D
P V U | P U;V
T K Q | T K;Q
K L V | V K;L
J S M | S J;M
I E T | T E;I
G N O | G O;N
B J O | O J;B
O T X | X T;O
O Y I | O Y;I
B V J | J V;B
J O P | O P;J
E G O | O G;E
U D Z | D Z;U
M J H | M H;J
F Y L | F Y;L
S W N | S N;W
F A H | F A;H
E Z R | E Z;R
X G Q | X G;Q
K T G | G K;T
N U L | L N;U
G N V | G N;V
A K E | K A;E
H J Y | H Y;J
Y A T | T A;Y
Z D C | C D;Z
M S G | S M;G
N W Z | N W;Z
E M O | M O;E
G S B | G S;B
T B U | B U;T
M H I | H I;M
I V Y | V I;Y
O N V | N O;V
Z N R | Z N;R
I A J | A I;J
U I G | U G;I
W E K | W K;E
O X C | C X;O
K S C | C S;K
P V G | P V;G
A G J | J A;G
U W O | W U;O
F J H | F J;H
Z X J | Z J;X
D O Q | D Q;O
S X I | I X;S
Y T E | Y E;T
Q Y H | Q Y;H
O A I | O A;I
A W K | A K;W
J Q X | X J;Q
W G A | W G;A
Y B D | B D;Y
B Y R | B Y;R
Z L X | X Z;L
A P O | O P;A
Q V N | Q V;N
F Y Q | Y Q;F
E P K | K P;E
M Y J | Y J;M
T E H | E H;T
Q C G | Q C;G
V A L | A V;L
I V T | I V;T
J M N | M J;N
S U L | U L;S
A N J | J A;N
V Q S | S V;Q
L H B | H B;L
P C N | C N;P
R G V | R V;G
Q Z B | B Z;Q
X S U | X U;S
L N F | N F;L
V C S | S C;V
B Z T | Z B;T
L H Q | L H;Q
R U C | U R;C
H S V | V H;S
D J C | J C;D
P J W | P W;J
T L H | L H;T
Z S I | S Z;I
H C W | C H;W
J M F | M J;F
J B G | B G;J
G R K | G K;R
B N Q | Q N;B
F N K | K N;F
O R F | O R;F
U H Z | U Z;H
J A O | O J;A
A P T | P T;A
S Z A | A S;Z
U G K | K G;U
P H E | H P;E
S I J | S J;I
P N D | N P;D
I N G | I N;G
J I S | S J;I
P W U | U W;P
X S O | X S;O
W P H | H W;P
S K J | K J;S
B I J | B J;I
B E R | B E;R
I G W | G I;W
N I V | N V;I
G Z S | S G;Z
H G Z | H G;Z
M O V | O M;V
C P D | P C;D
V J U | V U;J
C F B | C F;B
V Q I | V Q;I
U Q H | H U;Q
X M Q | M X;Q
Q G V | G Q;V
Q R Y | R Q;Y
M T X | M X;T
V P O | P V;O
Y Z X | Z Y;X
L B O | L O;B
E G J | J G;E
W P N | N P;W
Z B K | K B;Z
H P Z | Z H;P
I L K | I K;L
T F O | T O;F
H V D | V H;D
G S R | G R;S
T W S | W S;T
O H M | H O;M
W L N | N L;W
B O S | S B;O
M X A | M X;A
X F H | H X;F
T L I | L I;T
C G P | C G;P
J I S | I J;S
T S K | T S;K
I S Y | S I;Y
B O S | S B;O
D A N | D A;N
M V T | V T;M
O C X | X C;O
I B C | C I;B
E J D | D J;E
D V X | V D;X
B S K | B K;S
H I L | H I;L
Y U Q | Y Q;U
Z P C | Z P;C
Y T K | K T;Y
E O L | O E;L
N B O | B N;O
W F N | F N;W
A R C | A R;C
X S B | B S;X
V U L | U L;V
S J R | R J;S
T M Q | T Q;M
Q Y N | Q Y;N
X Z I | X Z;I
E A K | E A;K
J P E | P E;J
D M E | E M;D
I B L | I B;L
Z E B | E B;Z
T F K | T K;F
V J L | L J;V
C Z G | C Z;G
T B N | N B;T
F S J | F J;S
T X L | X T;L
P L A | A P;L
K A J | J A;K
E L Z | E Z;L
Q S I | S I;Q
A V H | H V;A
C W H | C W;H
W M L | L W;M
P Q E | Q E;P
J A Y | J A;Y
A T W | A W;T
M I D | I D;M
J T Q | Q J;T
I K T | T I;K
R T Y | R T;Y
K U C | C U;K
H Y O | Y H;O
J K Y | K J;Y
G Z N | Z N;G
D H J | J H;D
K A E | A K;E
I E Z | I E;Z
B D C | C B;D
J T N | N J;T
H M R | R M;H
A D B | B A;D
N W G | N G;W
F M G | F G;M
L A S | A S;L
D W L | D W;L
L E M | M L;E
Y L H | H L;Y
R G W | W R;G
K X N | X K;N
U B C | U C;B
E H F | F H;E
T Z H | H Z;T
E I S | E S;I
J W V | V J;W
L B F | L B;F
I M Q | Q I;M
W A V | W V;A
C E G | C G;E
R V K | R K;V
D W V | W V;D
Y T V | T V;Y
C K Q | Q C;K
R X J | J X;R
B Q J | B J;Q
Z T N | N T;Z
J R N | J R;N
P V G | P G;V
G U A | G A;U
T F C | C T;F
U V F | U V;F
C Z Y | Y C;Z
Q N D | Q N;D
E M Q | Q M;E
Z B S | S Z;B
Z I M | I Z;M
C N U | C N;U
B J Z | B Z;J
V G N | N G;V
F D E | F E;D
F O N | O F;N
U E R | U R;E
X A I | I A;X
H I D | I H;D
L D W | L W;D
U R D | R U;D
I J T | I J;T
Y M L | L M;Y
S U O | U O;S
J U N | U N;J
D K G | K D;G
W B Z | B Z;W
X S L | X S;L
M C T | M T;C
Z P M | M Z;P
P Z X | P X;Z
L X G | L G;X
N D U | U D;N
Z G J | J Z;G
A S U | S A;U
E O X | O E;X
I J R | J R;I
I R O | R I;O
X P N | X N;P
H P F | F H;P
A P U | A U;P
U Y L | L Y;U
U M I | U I;M
I R O | O R;I
B M X | X B;M
D Z X | D Z;X
B D L | L B;D
K X W | X K;W
Y U T | Y U;T
Q L F | L Q;F
G J P | J P;G
O I B | B O;I
Q J S | S Q;J
G Z B | G B;Z
D A F | A D;F
J B F | B J;F
E W Y | E W;Y
G I X | X I;G
S Q R | Q R;S
C T D | D T;C
Y X B | X Y;B
Y O Z | O Y;Z
U S V | V U;S
P J R | J R;P
S G W | W S;G
E P T | P T;E
M B W | B M;W
C X F | X C;F
E W J | J E;W
J H Q | J H;Q
M O A | M O;A
I V X | I V;X
E X A | X A;E
Z P T | Z P;T
X U N | N U;X
O X R | X R;O
V S E | S E;V
D X L | D L;X
R T Z | R T;Z
V N O | V O;N
C R Z | R C;Z
H T N | T N;H
Y X T | Y T;X
C F N | F N;C
X H Y | X Y;H
O I A | I O;A
Q I J | J I;Q
Q H Y | Y H;Q
A U Y | Y A;U
N C L | L N;C
M A X | X A;M
F O D | F O;D
K M Z | Z M;K
N R F | N R;F
P H J | H P;J
S F Y | S F;Y
L F G | G L;F
C Q O | O Q;C
X D R | X R;D
O I Z | I Z;O
C L J | L J;C
B S A | A S;B
H X R | R H;X
B L Y | L B;Y
R X Q | R X;Q
C A E | E A;C
C F M | C M;F
Y E W | E W;Y
G U I | G U;I
Z F X | Z F;X
W R N | W R;N
V T H | H V;T
R Q V | V Q;R
D W Q | W Q;D
P B Q | B P;Q
J T C | C J;T
U G T | G T;U
Q B L | L B;Q
A K P | P K;A
R C L | C L;R
B J I | J B;I
O M G | M G;O
Q O Z | Z Q;O
G E W | G W;E
T G U | G U;T
P L V | L P;V
A M E | A E;M
O X G | G X;O
L S D | S L;D
G B A | G A;B
Q F G | F Q;G
J X H | J X;H
O S R | O S;R
U R L | R U;L
V P F | F V;P
H K D | D H;K
Q P Z | P Z;Q
I U F | U I;F
E O R | R O;E
Z F V | Z V;F
I U W | W U;I
E N T | E N;T
I B Q | B I;Q
K W T | K W;T
G L N | L G;N
U A X | U X;A
D B M | B D;M
O I N | N I;O
K N V | V K;N
R S G | S G;R
I T G | T I;G
U J N | U J;N
O R B | R B;O
J H E | J H;E
M Y B | M B;Y
G V I | I G;V
U A I | U A;I
Y J N | J Y;N
R T G | R T;G
D U H | U H;D
F V E | V F;E
D I Z | Z D;I
L Z J | L Z;J
O R Z | Z O;R
S B D | B D;S
F W U | U F;W
H K A | K H;A
Q X D | D X;Q
U F O | U O;F
S A B | A S;B
D C Z | C Z;D
A F D | F D;A
T D L | T L;D
A M O | M A;O
X O N | N X;O
C F V | V C;F
V H R | H V;R
F U O | F O;U
Q W X | W X;Q
P W M | M P;W
S P O | O S;P
Z U O | Z O;U
N D R | R N;D
V O D | V D;O
S O C | S O;C
L R I | L R;I
G T I | I G;T
X C V | C V;X
X S Z | X S;Z
B G T | B G;T
Y V Q | V Y;Q
R N X | X R;N
U G I | G I;U
V J Y | Y V;J
T H K | K H;T
D Q J | J Q;D
R I U | I U;R
U I T | T I;U
A Q L | L A;Q
L M P | P L;M
D B A | A B;D
W H R | H W;R
A R E | E R;A
J F R | J F;R
R Z P | R P;Z
P L H | P H;L
Y B J | J B;Y
P J Z | P Z;J
R G W | G R;W
Z F Q | Q Z;F
H N X | X H;N
E D F | F E;D
Y S W | Y W;S
K T W | T K;W
E A J | A J;E
Q M D | Q M;D
E I U | I U;E
O C K | K O;C
T V X | T X;V
R W P | P R;W
U X E | U E;X
O P R | R P;O
C R J | J C;R
L F K | K F;L
I V W | W V;I
A R X | X R;A
M A I | I M;A
P M G | G P;M
Z B A | Z A;B
F T C | T C;F
C J F | C F;J
D U Y | U D;Y
I G H | G I;H
F Z Q | Q F;Z
V N I | N V;I
X H D | D X;H
P B I | I P;B
Y Z P | Z P;Y
W Q R | Q W;R
F Q B | F Q;B
A V W | V W;A
V M S | S V;M
K P G | K P;G
Y E M | Y E;M
Y F D | D Y;F
V Y O | Y O;V
A G N | G N;A
X J I | X J;I
N A L | N L;A
J G I | J G;I
A K P | P K;A
K Y O | K Y;O
C Q W | W C;Q
Y K D | Y D;K
W P T | P W;T
J U X | X J;U
T C Z | Z C;T
P K W | K P;W
L I X | I X;L
B O N | O N;B
I H Q | I H;Q
A J G | G A;J
K G R | K G;R
U O K | K U;O
D P M | M P;D
S Q Y | Q Y;S
U K X | X K;U
S D T | S D;T
Y N Z | N Z;Y
S A Q | A S;Q
W D S | D S;W
C N P | N C;P
G Z M | G Z;M
B L Q | L Q;B
T Y L | Y L;T
P Y V | V P;Y
J C S | S J;C
C N W | C W;N
X V U | U X;V
B D W | D B;W
U O G | O U;G
N Z K | Z N;K
W A Y | A W;Y
B G W | B G;W
J N Q | J Q;N
D C G | D C;G
O P V | V O;P
V G N | G N;V
P U V | P V;U
W X O | O W;X
W P V | V W;P
P V A | P V;A
Z B I | Z B;I
P D H | P D;H
T S A | S T;A
I J S | S J;I
K B Y | Y B;K
M P C | P M;C
L S F | S F;L
B T M | M T;B
O G Z | O G;Z
H U X | H X;U
V C B | C B;V
H K I | K H;I
K L O | O K;L
R C Q | C R;Q
S G M | M S;G
C W V | W C;V
Y O R | R O;Y
G C E | C E;G
X J D | J D;X
Y G D | G Y;D
S W D | S W;D
T C L | L T;C
R S M | R M;S
J Y H | H Y;J
L Y S | L Y;S
D H L | L H;D
X U V | X V;U
E J T | J E;T
J Q Z | J Q;Z
R D Y | Y R;D
X W H | H W;X
G K N | N K;G
I X Z | Z I;X
I K F | I K;F
U T Q | Q T;U
E M K | M K;E
R O M | R O;M
I W G | W I;G
D S L | D L;S
R I U | U R;I
M V O | V M;O
U R L | R U;L
U S T | T S;U
E K V | E V;K
V U A | V A;U
F B E | B E;F
S M O | S M;O
I D G | I D;G
P U C | U P;C
O H K | H K;O
R I L | I R;L
S H T | S T;H
Z N U | N U;Z
J K B | K J;B
Y Z H | Z H;Y
D I Y | I Y;D
E N Y | N E;Y
T F U | T U;F
Z T J | Z J;T
G Z V | G Z;V
K W P | P W;K
Q H M | M H;Q
G S R | S R;G
P M V | M V;P
G M I | M G;I
W H E | H E;W
X P R | R P;X
R N U | N U;R
V O P | V O;P
V M T | M V;T
I J X | I J;X
L T C | T C;L
Z Q V | V Z;Q
T Y S | Y T;S
S F R | R S;F
M Q I | I M;Q
K B W | W K;B
K I J | I K;J
C Z P | C Z;P
H I J | H J;I
L U Q | L U;Q
Y E P | Y P;E
T M C | M T;C
Q W G | Q G;W
D P B | D P;B
Y L Q | Q Y;L
E X O | X E;O
Y N U | Y N;U
Z S U | Z U;S
W T Z | Z W;T
I O Q | I O;Q
L T G | T G;L
D C A | A C;D
T L V | T V;L
X M I | X M;I
B W T | T W;B
K L A | L A;K
O Z M | O Z;M
S H W | W S;H
M H Q | H M;Q
Q H F | F H;Q
D S C | S C;D
Q H M | M Q;H
F V I | F V;I
R C K | K C;R
V G A | V A;G
I O F | O I;F
E W I | W I;E
A G T | T G;A
H D O | O D;H
R G Q | R Q;G
A J Q | A J;Q
V B E | E V;B
Z S N | Z S;N
Z I U | I Z;U
Q P E | Q E;P
R P L | P R;L
O P T | T O;P
C A W | A W;C
R I Z | R Z;I
Y Z V | V Y;Z
D R A | R A;D
G Q S | G S;Q
P X L | P L;X
I U T | I U;T
U P V | U P;V
D V M | V M;D
N R G | R G;N
U X R | U X;R
B S K | K S;B
K L Y | K Y;L
F G S | S F;G
S Z E | E Z;S
R W E | W E;R
Y L O | Y L;O
L X C | X C;L
U E B | E U;B
J L U | J U;L
O F Z | Z O;F
M I N | N M;I
C T Q | T C;Q
I M A | A M;I
E G N | E G;N
A N U | U A;N
W G F | G F;W
G H F | H G;F
D H V | H V;D
O Z W | Z W;O
G B D | B D;G
V C P | C V;P
X Q D | D Q;X
J O T | J T;O
K P M | K P;M
P F R | R P;F
O N R | R N;O
P L W | P L;W
Y F I | Y F;I
S G P | P G;S
N W G | N G;W
H I V | V I;H
G X N | X N;G
H O V | H V;O
K V P | V P;K
L B M | M L;B
Y T H | Y T;H
H C D | H C;D
Z N M | Z M;N
U L K | L K;U
S W P | P S;W
N Q D | N D;Q
A L K | K A;L
V P D | D V;P
U V Q | Q V;U
M J K | K M;J
M N G | N M;G
Y M L | L Y;M
B G U | B G;U
V O W | O W;V
E X U | E U;X
P H Z | Z H;P
L Q X | X Q;L
N B A | B N;A
F T S | F S;T
X K N | X N;K
J N L | N L;J
N X Z | X N;Z
P U Q | U P;Q
L O N | N O;L
W I H | H W;I
F X Q | X F;Q
Y V K | K Y;V
A V Q | A V;Q
A R G | A G;R
W O T | W O;T
Z W T | W T;Z
C V Q | C Q;V
Z D I | Z I;D
B C R | C B;R
B P Z | Z P;B
M E G | G E;M
C T N | T N;C
C F Z | F C;Z
L X V | V L;X
T C E | E C;T
H Q I | I H;Q
E B S | E B;S
W E B | B W;E
C M W | M C;W
W Y P | Y W;P
L V B | B V;L
C G L | G C;L
G E S | S G;E
J N P | P J;N
W R A | W A;R
S K Q | S Q;K
S C Y | Y C;S
I W F | F W;I
Z L N | L Z;N
E R Q | E Q;R
I J D | D I;J
D V W | V W;D
D X H | H D;X
T O M | M O;T
N U G | G U;N
R W I | W I;R
U P J | P J;U
L G K | G L;K
W D T | T D;W
N P C | P N;C
O P H | H P;O
B M P | B M;P
X G K | G X;K
W E P | W E;P
R L Q | L Q;R
S O L | S O;L
W Y K | Y K;W
H B N | N H;B
I K X | X I;K
A I Y | Y A;I
X O T | T X;O
Q S V | S V;Q
O L E | O L;E
Y T N | Y T;N
T S V | V S;T
J O N | N O;J
M N R | R N;M
Q R K | Q K;R
W M Z | M Z;W
G O E | O E;G
R Z L | R L;Z
V Y L | L Y;V
L U G | G L;U
L E G | L E;G
C E M | C E;M
I U B | U B;I
R X U | R X;U
P J B | B P;J
D Y Q | D Y;Q
L N G | L G;N
X M V | X V;M
P G Z | G Z;P
E O L | O L;E
R Y F | R Y;F
A H K | A H;K
K E T | E K;T
M L W | W L;M
A Q I | I A;Q
I L Z | L I;Z
S M K | S K;M
H I M | I M;H
H F Y | H Y;F
E B P | B P;E
C G R | C G;R
P K V | K P;V
A X T | X A;T
X H N | N X;H
O W K | W O;K
F T M | F M;T
I Q Y | I Y;Q
B Y R | Y R;B
B T C | B C;T
R I K | I R;K
U Q W | Q U;W
Z R L | L Z;R
F D L | L F;D
P M B | P B;M
W I R | W I;R
X V I | V I;X
P B J | B P;J
S N Q | S N;Q
W L J | L W;J
C S X | X S;C
I N J | N J;I
D H S | H S;D
O Q K | Q K;O
A X K | A K;X
N S A | N S;A
V U I | V U;I
P M F | M F;P
T F H | H F;T
S A J | J A;S
H N Q | H Q;N
K H R | H K;R
H G K | G K;H
H M C | C M;H
F B P | P F;B
A U D | A U;D
U F O | F U;O
O W Y | W O;Y
H I Y | Y I;H
F W N | N F;W
A X U | U X;A
L W Q | L W;Q
I L U | L U;I
U I X | X U;I
X E O | E O;X
J V L | V J;L
U I D | I D;U
F Z L | Z F;L
J A I | A I;J
U T O | U O;T
T R H | H R;T
V F G | F G;V
Q F A | A Q;F
T A Z | T Z;A
Z W B | Z W;B
C N P | C N;P
P X A | X P;A
E Q T | Q E;T
Q J U | Q U;J
W J Z | W Z;J
E I W | W E;I
T U S | S U;T
I Q Z | Z Q;I
R M S | S M;R
M Q C | M C;Q
T H K | H K;T
J T S | S J;T
W Z M | W Z;M
Z Q P | P Z;Q
Q H C | H C;Q
F P D | F D;P
A B S | B S;A
I O M | I M;O
N G L | N G;L
Q D U | U D;Q
D U G | G D;U
V J U | V J;U
B A Q | A Q;B
M I T | I M;T
Q N U | N Q;U
E S F | S F;E
J B G | J G;B
R M W | R W;M
N I P | N P;I
W P Y | P W;Y
P I V | V I;P
E J V | J V;E
A W M | A W;M
R A J | A J;R
A H V | H A;V
R H O | O H;R
F G C | C G;F
N W O | N W;O
G O I | I G;O
A I H | H A;I
P R F | F P;R
V Y S | V S;Y
F C Z | C Z;F
U L K | U K;L
L K V | L K;V
L S W | L S;W
T N H | N H;T
S R F | R F;S
B I Y | I B;Y
K S V | V K;S
P Q I | I P;Q
Q O B | B Q;O
O M F | M F;O
W V N | V W;N
G B U | B U;G
H F N | F N;H
C K V | V K;C
M C X | M X;C
O S Z | S Z;O
G S E | G E;S
H L P | L P;H
A G X | G A;X
N T E | T N;E
E U J | U E;J
Q V U | Q V;U
J N F | J F;N
J P C | P J;C
G M V | M G;V
T V P | P V;T
P Y S | P Y;S
L P D | D L;P
E J C | E J;C
D R N | D N;R
P O U | P O;U
J N R | N R;J
U J T | U T;J
Q W N | N W;Q
A V K | K V;A
C H G | G H;C
D B L | B D;L
N K F | N K;F
X Y Z | X Z;Y
O U G | U O;G
T G M | M G;T
Q S K | K Q;S
P E H | H P;E
U R O | U O;R
C N Y | C Y;N
Q Y Z | Z Q;Y
K V Z | K V;Z
A J H | H J;A
D A M | M A;D
D E B | B D;E
L V W | V L;W
G A X | A G;X
K M C | M C;K
C M X | M C;X
T V X | T X;V
C H J | J C;H
D W Q | D W;Q
B M A | A M;B
R B L | R B;L
V P H | H P;V
L Z D | D L;Z
L P Q | L P;Q
Q W Y | Q Y;W
P M F | P F;M
W N J | N J;W
U J S | J U;S
O N U | N U;O
F Q A | F Q;A
M O W | W M;O
U Q L | Q U;L
W H T | T W;H
Q W R | W R;Q
G E N | E N;G
W K F | F K;W
L Z R | L R;Z
H Y Z | H Y;Z
I L N | L N;I
N F B | N F;B
P F S | P S;F
J Q E | E J;Q
Y G E | G E;Y
D W J | W J;D
S T R | S T;R
I B K | K B;I
C V S | C V;S
A K J | A K;J
H P Y | H Y;P
O F G | O F;G
O K X | X O;K
M J K | K J;M
C W J | W J;C
J Q Y | Y Q;J
H I D | D I;H
Q L T | T Q;L
Q R T | T Q;R
Q W V | Q V;W
Y R V | Y V;R
D J K | K D;J
L E X | X E;L
X J M | M X;J
J C F | C J;F
P V K | V P;K
R W Y | W R;Y
J I D | J I;D
T X V | V T;X
Y M G | Y M;G
Q T D | T Q;D
G K Y | G K;Y
U S O | O U;S
W T E | T W;E
P E S | E P;S
D W K | D W;K
A U S | A U;S
J I M | J M;I
A Z O | O Z;A
X Z O | X Z;O
U Q K | K U;Q
K Y D | Y K;D
H M Q | M Q;H
G W J | W J;G
L R G | R G;L
G Z H | Z H;G
K X I | K I;X
J V P | V J;P
V R C | C R;V
O S H | S O;H
K N Q | K Q;N
P G Y | Y P;G
C R G | G R;C
T M I | I T;M
V A T | A T;V
V B M | B M;V
N T I | T I;N
C R G | G R;C
P J O | O J;P
X R I | R I;X
S G D | S G;D
N K S | S N;K
Q N C | C Q;N
H T E | H T;E
X P N | P X;N
Y N Q | Q N;Y
R C L | R L;C
B Q J | J Q;B
Q V T | T V;Q
E C F | C F;E
S H T | T H;S
R J Y | Y J;R
E F C | C F;E
Z L U | L Z;U
R Y W | Y W;R
T G X | T X;G
F Q W | F W;Q
Z P K | Z K;P
C U E | C E;U
O E D | E D;O
J R D | R D;J
O H X | H O;X
O L T | O T;L
E K J | J K;E
F Q M | Q M;F
Y N Q | Q N;Y
M S H | H M;S
K Y L | L K;Y
P D H | D H;P
N V K | N V;K
P I D | P I;D
B A X | B A;X
I B E | I B;E
G W L | L W;G
V D X | D V;X
Q Z V | Z V;Q
L B U | L B;U
X Q Y | X Y;Q
S Y L | S Y;L
H K X | X H;K
G Y T | Y T;G
J A Q | Q J;A
E W O | O E;W
D C A | C A;D
R I E | R E;I
D K Z | K Z;D
R Z V | R V;Z
A F K | A K;F
U T S | S U;T
Z I K | I Z;K
T O Z | Z O;T
A N O | A O;N
F W K | K W;F
B F U | B F;U
X R Y | Y R;X
F G C | C F;G
F P Q | P Q;F
C S V | C V;S
K D Z | Z D;K
W Q E | W Q;E
X F U | F U;X
X N V | V N;X
L Z C | Z C;L
S D G | G S;D
H C B | C H;B
D U Y | U D;Y
G I F | F G;I
P X S | S X;P
P V H | P H;V
S B A | B A;S
T Q D | D Q;T
I L J | L J;I
A D R | D R;A
W I B | I B;W
E U P | E P;U
S P Z | Z P;S
I F Q | F I;Q
D R L | R L;D
C E Z | C E;Z
P W X | W X;P
V Q F | Q V;F
N X B | N X;B
E R A | R A;E
N C G | C N;G
Y O M | M O;Y
Y F P | Y P;F
U C K | U K;C
U Z L | U Z;L
U E P | E U;P
R V D | V R;D
X A L | L A;X
T D J | J D;T
S M B | S M;B
J A O | O J;A
Y J Q | J Y;Q
Q G E | E Q;G
V C L | C L;V
C I S | C I;S
F A M | F M;A
Z S R | S Z;R
Q B N | B N;Q
K M O | M K;O
L F V | L F;V
R L A | R A;L
Z T A | T A;Z
L B X | X B;L
E R Z | E R;Z
H U P | P H;U
P H X | H X;P
K Q V | Q V;K
K D S | S K;D
R S A | R S;A
J G N | G N;J
Y H T | T H;Y
E J W | E J;W
O F A | A F;O
V U N | U N;V
S Z X | Z X;S
P N R | P R;N
V F H | H V;F
I M Q | I Q;M
D M C | D C;M
R H V | R V;H
D T W | W T;D
C X V | C V;X
E V O | V E;O
S H M | H M;S
T H B | B T;H
P E H | P E;H
V W X | W X;V
B V W | V B;W
M D Q | Q D;M
A K W | A W;K
T H P | H P;T
T K G | T K;G
U V S | S V;U
P A R | P A;R
U L W | L U;W
O D K | O D;K
U D V | U D;V
W V H | W H;V
T Y A | T Y;A
J R F | J F;R
O N R | N R;O
V J F | F J;V
C H F | H F;C
X J Z | X J;Z
R S D | R S;D
W F U | F W;U
E G O | O E;G
D K M | K D;M
J S C | J S;C
S G E | S E;G
V K S | K S;V
R E P | P E;R
K S B | S K;B
B J N | N B;J
F R E | E F;R
T Y A | T Y;A
N D J | J D;N
X S Y | X S;Y
W P D | P W;D
M X T | X M;T
L R A | R L;A
A B G | A B;G
W E T | T W;E
O Q G | G O;Q
C Z H | Z C;H
Z L O | O Z;L
I V G | I G;V
S T X | S T;X
H S W | S H;W
C I H | C H;I
K F U | U K;F
Q P K | P K;Q
T Z X | T X;Z
E T A | T E;A
R L I | R L;I
H Y P | Y P;H
P J N | J P;N
P H D | H P;D
B T W | T B;W
Q X K | Q X;K
A L F | L A;F
C R L | R L;C
K H B | B K;H
G N Z | Z N;G
C E X | C E;X
L T F | T L;F
D J V | J V;D
O A G | O A;G
H V L | V L;H
U G F | U F;G
O F B | O F;B
M C I | C I;M
Q Y P | Y P;Q
Z W U | U W;Z
L O H | L O;H
U T Z | T Z;U
X L H | X H;L
H J W | J H;W
M Q E | E M;Q
V Z P | Z V;P
A O K | O A;K
B C K | K C;B
A R M | R M;A
L N C | L N;C
E L Y | E L;Y
V U E | V U;E
P T A | T A;P
H A W | H A;W
X A Z | Z A;X
C E A | C E;A
L C Z | Z C;L
V G A | A V;G
T W I | T W;I
M T N | N M;T
F E J | F E;J
F X W | F W;X
M R B | R M;B
U X E | E U;X
J H K | H K;J
J V C | C V;J
A F E | A F;E
R J C | R J;C
W Z X | W Z;X
P E W | W E;P
Y I N | Y I;N
B X G | G B;X
C H R | C H;R
E S R | E R;S
S W X | X W;S
L V U | L U;V
E Z W | Z W;E
H F L | L H;F
T V U | V T;U
U B J | J B;U
E O D | O E;D
L B S | B L;S
I N Q | I N;Q
J Z B | Z B;J
P J C | P C;J
G K Z | Z K;G
C S L | C S;L
Y S Z | Y S;Z
K X P | X P;K
B M V | B V;M
G Y J | G Y;J
E R M | R E;M
K N Q | Q K;N
Y H G | Y G;H
D W R | R D;W
M L O | O L;M
N V H | H V;N
O Z L | O L;Z
Q O L | L O;Q
K H C | H K;C
D M Y | D M;Y
Q N L | L N;Q
M H D | H D;M
J K A | K A;J
T F H | H T;F
I B H | I H;B
H J Z | Z J;H
J V O | V J;O
V G Y | V G;Y
P J K | K P;J
T V N | V T;N
O A H | O A;H
C R N | C N;R
I Q H | I Q;H
Y K X | Y X;K
O V W | W V;O
R F D | R D;F
E R M | R E;M
S A H | H A;S
K L A | K A;L
Z N I | Z N;I
M J X | M J;X
T C V | C V;T
R Z K | R K;Z
F L N | F N;L
T X D | T D;X
N J P | P J;N
U M B | U B;M
F D E | E D;F
C N U | C N;U
T M N | N M;T
G B L | G B;L
M S P | M S;P
S G U | G S;U
L P F | F P;L
E R Z | E R;Z
K J Y | J Y;K
S L G | G S;L
C O X | X C;O
C P I | I P;C
H E P | P E;H
R P I | I P;R
Y Z F | Z Y;F
K Z M | M K;Z
F G Y | F G;Y
I O Z | O I;Z
G T L | T G;L
D U A | U D;A
D G P | G D;P
I F P | F I;P
L X B | B L;X
V Y E | E V;Y
C T N | C N;T
A C S | S C;A
G M E | M G;E
O R Z | R Z;O
T B Y | T Y;B
C D Q | D Q;C
O E C | E O;C
G F X | X G;F
I B W | W I;B
Y Z R | Z Y;R
G V J | G V;J
P U J | U J;P
L N O | O N;L
N C P | P N;C
C N I | N C;I
C G F | F G;C
R Y I | I Y;R
N O U | N U;O
M D Y | M D;Y
K O Y | K O;Y
D J F | J D;F
I V W | I V;W
P X R | P R;X
Y C W | Y W;C
R K O | R O;K
N P W | W N;P
E D O | O D;E
B D P | B P;D
Y H G | Y G;H
Y S B | B Y;S
H R V | H R;V
M N H | H N;M
B U J | B J;U
Z G X | Z G;X
S N A | N S;A
J Q O | Q O;J
L V U | V U;L
Y L V | V L;Y
S W Y | S Y;W
S U J | S U;J
A J M | A M;J
F U N | N U;F
E A D | E D;A
N J I | N I;J
W R E | E W;R
Y L M | L Y;M
Q P N | Q P;N
H A C | H A;C
Z F G | F Z;G
M W H | H M;W
A O L | A O;L
I X R | I X;R
H G Y | H Y;G
B J F | B F;J
Y Z I | I Z;Y
M V X | X V;M
Y B G | B Y;G
D E A | E D;A
H V Z | H V;Z
V F O | V O;F
B X L | L B;X
V O Z | V Z;O
R M L | R L;M
A B N | N B;A
S Z K | S Z;K
S B K | B S;K
I O A | O A;I
A S D | D A;S
J B K | J B;K
D F P | P D;F
G H Z | H G;Z
P H O | O P;H
N T P | N T;P
B I K | I K;B
H A W | W A;H
G X C | X C;G
M V W | M V;W
F I R | F R;I
T Y E | Y T;E
P Y O | O P;Y
O T G | T G;O
W D L | W L;D
Y B T | Y T;B
Y H V | V H;Y
P W J | P J;W
V Q E | V Q;E
H N Q | N Q;H
U S J | S U;J
I W C | I W;C
X F A | F A;X
P R Q | Q R;P
Y T M | T M;Y
I K E | I K;E
W O B | B W;O
Z P B | Z P;B
V G F | G F;V
H F L | H F;L
I F A | F I;A
G C A | C A;G
Z O M | O M;Z
J N Z | J Z;N
K A Y | Y A;K
A K V | K A;V
I W R | W I;R
P V X | X V;P
H I C | H C;I
T O S | T S;O
Y N I | N Y;I
R Z Y | R Y;Z
T I H | T I;H
Z B A | Z A;B
D H S | H S;D
C R X | C X;R
Y S C | C S;Y
C K E | E K;C
M L R | M R;L
S V L | L S;V
W K P | W K;P
E S X | E S;X
W H J | W J;H
U J N | N J;U
R E G | G E;R
I Q R | Q R;I
G Q Z | Q G;Z
R W X | W X;R
V E F | F E;V
G D X | X G;D
A T R | R A;T
V M L | V M;L
R D I | D R;I
Z D C | D C;Z
T N X | X N;T
I D O | O D;I
H E B | B E;H
N A L | L N;A
P H B | B H;P
Y A X | A Y;X
J V X | J V;X
Q F E | F Q;E
M K B | M B;K
K D F | K D;F
D L A | D L;A
K J C | K J;C
I E F | I F;E
X L C | C L;X
D H J | J H;D
E P I | E P;I
E K U | U K;E
V D Z | Z D;V
N C R | R N;C
P Y I | I Y;P
E G D | D E;G
R B H | B H;R
T G I | G T;I
C D Y | C Y;D
G I Y | I Y;G
B C V | V C;B
E A Q | E Q;A
U Y L | L Y;U
T U L | T U;L
S C L | S L;C
M U I | I M;U
O V K | O V;K
D Y T | T Y;D
M D I | D I;M
A I M | M A;I
M W O | M O;W
D A N | N A;D
H L N | L N;H
Q N T | Q T;N
E I X | E X;I
X U L | L X;U
I R W | R I;W
U I D | U I;D
G W R | W R;G
Q D U | D U;Q
X J T | J T;X
O V S | O S;V
R G M | M R;G
X H G | G X;H
D P A | D A;P
F D Z | Z D;F
Y Z A | A Y;Z
O T C | O T;C
R H N | N H;R
A U W | W A;U
H E F | H E;F
H D M | M D;H
F S D | F S;D
S V H | H V;S
G F M | M F;G
B W R | B W;R
H E B | B H;E
H X P | H P;X
D R G | R D;G
E Z S | E S;Z
T N X | N T;X
W L H | L W;H
V T I | V T;I
V J D | V D;J
R W P | W R;P
J K I | I K;J
P C K | C K;P
W L M | L M;W
V B M | B V;M
Q Y B | B Y;Q
D W A | A W;D
D W X | X W;D
A E G | E A;G
E D J | E D;J
H C V | C H;V
L T Q | T L;Q
C I U | C I;U
N Z P | N Z;P
R L K | L K;R
X R K | R K;X
K A D | A D;K
B G L | B G;L
Q Y N | Y Q;N
M R A | A R;M
H V I | I V;H
V K Q | K V;Q
N I V | I V;N
N M J | N M;J
E P D | P D;E
B V Y | B V;Y
U P X | U X;P
W F R | W F;R
S M O | M S;O
K Q O | O K;Q
X V N | X V;N
T B O | T O;B
S T I | I T;S
H Z O | Z O;H
C D V | D C;V
H Z F | Z H;F
U P L | U P;L
M B C | M C;B
F E Q | F E;Q
X F D | X F;D
U C Z | U C;Z
B X R | B R;X
Z X P | Z X;P
G A R | G R;A
L B F | B L;F
B D E | D B;E
G U V | U G;V
U O J | U J;O
S Y T | S Y;T
Y L T | Y L;T
B J V | B J;V
M F H | M H;F
Z B K | Z K;B
T D G | D G;T
F R O | O R;F
X H N | N X;H
Y W F | Y F;W
I C M | C I;M
B S C | C B;S
A C W | C W;A
C K V | C K;V
R Z O | O Z;R
Q U J | Q U;J
A X O | A O;X
R Z N | Z R;N
X C S | X S;C
I G E | I E;G
G V H | G V;H
B E U | U B;E
T Y H | Y T;H
O S C | S C;O
J Y E | J Y;E
W O K | O W;K
A U N | A N;U
R A J | R A;J
R J G | G R;J
S D T | D T;S
T R V | R T;V
J M R | M R;J
J Q P | Q J;P
F G X | X F;G
S N Y | N S;Y
J Y M | J Y;M
Y Z F | Z F;Y
F M P | M F;P
J U Y | Y J;U
V Y X | Y V;X
S T H | T H;S
J E X | J X;E
O L B | O B;L
K J Z | Z K;J
V A D | D V;A
X U C | C U;X
S T P | S T;P
N K M | N K;M
V X H | H X;V
S E N | E S;N
O T V | V T;O
H Y D | D H;Y
H N R | H N;R
S N D | S D;N
D W P | P W;D
V D E | V E;D
S L X | X S;L
E L Z | Z E;L
G L K | K L;G
G P I | G I;P
Z N H | Z N;H
U B I | U B;I
A O B | O A;B
F Q E | Q F;E
Z W X | X Z;W
K W Y | K Y;W
D K J | D K;J
P O L | O P;L
D U B | D U;B
Q U H | H U;Q
G O U | U O;G
Y H N | N Y;H
U X B | U X;B
E Y P | Y P;E
R D O | O R;D
V S U | V S;U
V U X | X V;U
V X K | K X;V
T U Z | Z U;T
T B D | D T;B
N U A | N A;U
U L S | U S;L
Y Q T | Y T;Q
T N U | U T;N
B N G | N G;B
E A S | S E;A
A R U | U R;A
A I V | V A;I
F C R | R F;C
R D Y | R D;Y
X E S | E S;X
M Y V | V M;Y
J O F | F J;O
O A B | A B;O
V E M | V M;E
V A E | V E;A
Z R G | R G;Z
K R I | K I;R
X R W | X R;W
V O G | V O;G
S N J | N J;S
K T V | T V;K
N X B | N X;B
U T W | U T;W
G E S | G S;E
J V R | V J;R
M K Y | K M;Y
F K S | S K;F
W V P | P W;V
X Q L | Q X;L
L T B | B T;L
Q Z D | Q Z;D
Q M Y | M Y;Q
W K H | H W;K
G P N | G P;N
V H W | V H;W
O F V | F O;V
B N E | B E;N
Z V D | Z D;V
U B G | U G;B
W K Q | K Q;W
G A U | U A;G
S W L | L W;S
P O W | W P;O
B L E | E B;L
H J Z | J H;Z
F Z Q | Q Z;F
F G C | G C;F
U A Z | Z A;U
X I M | M I;X
W X T | W X;T
P Y Z | Z P;Y
R P T | R P;T
M K L | M K;L
N U V | N V;U
I G N | N I;G
Y S Q | Q S;Y
Z V D | V Z;D
B S N | S N;B
J P S | P S;J
I L B | I L;B
P I O | O I;P
P I Y | Y P;I
C S Q | C Q;S
I F V | I V;F
J M O | M J;O
Z M B | Z B;M
H T X | H X;T
O S E | O E;S
K O V | O K;V
C V B | C B;V
F C M | M C;F
W J B | B J;W
A M W | M W;A
L M Y | M Y;L
E G X | G X;E
D F T | D T;F
Y R T | R T;Y
F T Q | Q T;F
H R B | B R;H
N V G | N G;V
V W P | W P;V
L T R | R L;T
J V Y | J Y;V
G Y S | S G;Y
N R O | N O;R
J O G | J G;O
E P W | W E;P
V O B | B V;O
I S T | S I;T
A R L | L A;R
Y M G | G Y;M
Y I U | U I;Y
R J P | P R;J
V K U | V U;K
Z C X | X C;Z
J G L | G J;L
I W P | I W;P
T J L | J L;T
S B R | R B;S
C U Q | U C;Q
H I P | H I;P
K B Z | Z K;B
D O J | D O;J
R C F | C R;F
W Q S | S Q;W
B S F | S F;B
X E O | X E;O
M Y W | W Y;M
B I K | K I;B
S V Z | V Z;S
G A B | G B;A
R A L | L A;R
F D N | F N;D
V P Y | P Y;V
S G M | G S;M
Z F X | X F;Z
M Z H | H Z;M
W Y U | W U;Y
B U Z | U Z;B
C U D | U D;C
T U W | U W;T
X E T | X T;E
C K H | C H;K
X D G | D X;G
V B Q | Q V;B
P Z W | W P;Z
R M Z | R M;Z
L R Y | L R;Y
B G Z | B G;Z
S V W | W S;V
V I M | I V;M
D T B | B D;T
H Z E | E Z;H
I T O | I O;T
J F Y | Y F;J
K M F | F K;M
T O B | T B;O
Y H M | H M;Y
H Y X | H Y;X
Z F V | Z V;F
A C H | A C;H
W D H | W H;D
D F B | D F;B
L P Q | P L;Q
J U B | B J;U
C F X | X C;F
E C G | G E;C
U E Z | E Z;U
N I E | I E;N
K Z J | J K;Z
J V X | V J;X
J R Y | J Y;R
B K H | K H;B
E D P | P E;D
J G M | J M;G
E M L | E L;M
X Q G | G Q;X
P E O | O P;E
V Z W | Z V;W
M X B | X B;M
N M Q | Q N;M
V T P | P V;T
Z X V | Z X;V
U A E | U A;E
U O N | N U;O
B P Y | Y B;P
G L J | J G;L
C B F | F B;C
Q W N | W Q;N
A N P | N P;A
F T R | F R;T
Z P R | P Z;R
W O J | W O;J
W S R | W S;R
J V O | V O;J
G J Y | G J;Y
A Q G | A G;Q
G P N | P N;G
Q G J | J G;Q
M Z G | M Z;G
Q J V | V Q;J
V D R | D R;V
P C G | C P;G
I Z F | Z F;I
Y A E | Y E;A
I S N | S N;I
Q A Y | Y Q;A
X U T | U T;X
T C Y | C T;Y
L Y Z | Y Z;L
I L Y | Y I;L
R M X | M R;X
K D A | K A;D
N E A | E N;A
G B N | G B;N
T L C | L T;C
C H Y | C Y;H
G V E | E G;V
T Y W | Y W;T
E Z Q | Q E;Z
K H J | J H;K
Z V E | Z E;V
Z G I | I G;Z
B L I | I L;B
U T Y | U T;Y
Y J W | W Y;J
Z B K | K Z;B
S M E | S E;M
J A P | A J;P
C Z G | G C;Z
H R Z | H Z;R
G B N | G B;N
R C Q | C R;Q
E C Q | C Q;E
E B X | E B;X
D I F | I D;F
J M C | M C;J
S H X | S H;X
S X J | S J;X
P G D | G D;P
J U F | J F;U
M F R | M R;F
F H N | N F;H
V L Q | V Q;L
Z B Y | B Z;Y
C D U | C U;D
N W Z | Z W;N
C S Y | S Y;C
J X R | X R;J
Q W Z | Z Q;W
B P E | P B;E
F Z Y | Y Z;F
L V A | A V;L
S P Q | Q P;S
L T F | F T;L
L F H | L H;F
C O S | C O;S
V Q K | V K;Q
O P L | L P;O
I C Y | I Y;C
V U Z | V U;Z
B U Z | B Z;U
M J V | V J;M
Z I Q | Z Q;I
N L Z | L N;Z
K D E | E K;D
W T Q | T W;Q
W X C | W X;C
T N L | N T;L
C N B | N B;C
N U A | A N;U
N L B | L N;B
F I A | F A;I
Z W O | Z O;W
W G N | G N;W
O M U | M O;U
J A H | J A;H
W P S | W P;S
N T Y | T N;Y
K D P | P D;K
F H T | H F;T
V H D | H V;D
K H U | U H;K
F M B | M F;B
H M X | H X;M
K I U | K U;I
O H L | L H;O
Z O H | O Z;H
C A N | C A;N
T D W | W D;T
P D T | P D;T
N L Z | N Z;L
T B G | B T;G
A V O | V A;O
X C L | C X;L
Z D A | A D;Z
X U J | X U;J
R H B | H R;B
A P O | P O;A
I U K | K I;U
Z K F | K F;Z
L N F | N F;L
G Y I | I G;Y
R K G | G K;R
V U S | V S;U
A Y R | R A;Y
H U Y | H U;Y
H Z Q | H Q;Z
Z R M | M Z;R
Q C S | Q C;S
Y C Q | Y C;Q
W K Z | Z K;W
F U E | F E;U
P K E | E K;P
I B M | I M;B
Y X S | Y S;X
N J P | P J;N
J I U | I U;J
V S E | E V;S
M K L | L M;K
F L R | F L;R
H I R | R H;I
B O R | O R;B
Y C B | Y C;B
M I T | T M;I
J S Q | Q J;S
G L Z | L Z;G
P O Z | P O;Z
C H E | C H;E
F M W | M W;F
P M Y | P M;Y
S L Q | S Q;L
D C M | C M;D
V R W | W V;R
X A N | A X;N
D O K | K D;O
U G D | D U;G
T X Q | T X;Q
M E P | M E;P
V M R | V M;R
K P G | P G;K
C T W | W T;C
O S K | O K;S
F N H | H F;N
E Y N | E Y;N
E B G | E G;B
S W V | W S;V
Y F O | F O;Y
F N O | O F;N
C D B | C B;D
U A W | W U;A
V H R | H R;V
W C F | W F;C
X Z I | X Z;I
A S G | G A;S
P V B | V P;B
E B S | S B;E
Q U G | U Q;G
S B G | B S;G
H Y T | T Y;H
Y Q N | N Q;Y
Y Z B | B Z;Y
D T Q | Q T;D
O N D | D O;N
U F I | F U;I
T M C | M C;T
P T W | P T;W
Q S J | J S;Q
Q D L | Q L;D
X R U | X U;R
A C I | I A;C
X B F | F X;B
S M Y | S M;Y
Z M Q | M Z;Q
W V T | T V;W
X Q E | Q E;X
E X Y | X E;Y
Z U B | Z U;B
X E A | X E;A
K J O | K J;O
H I L | H I;L
M F B | B F;M
J O U | U O;J
K G U | U G;K
N Y D | D N;Y
R Y X | Y X;R
T B D | D B;T
M Y H | Y H;M
X A D | X D;A
G U S | G S;U
Q K N | N K;Q
F X C | F C;X
T D S | T S;D
Z N M | M Z;N
Q J P | J P;Q
D L C | C D;L
F O Y | F Y;O
Q N J | N J;Q
A J E | J A;E
W U Z | W U;Z
E Y Z | E Z;Y
P U T | U T;P
B J W | J B;W
I K G | K G;I
T N S | T S;N
G J T | J G;T
B E Q | Q B;E
F D C | F D;C
B E T | B E;T
X N K | X K;N
X G A | A G;X
M V T | V M;T
X F C | X F;C
N O H | O N;H
B A W | B W;A
W G O | W G;O
A W O | W A;O
W G C | G W;C
F W J | W F;J
Y B I | I Y;B
Q S Z | S Z;Q
E S X | E X;S
Y R S | R S;Y
G O Q | O Q;G
A N T | T N;A
Z N G | Z G;N
N W J | J N;W
B I W | B W;I
C P S | C S;P
F D E | D E;F
U G N | N G;U
M W X | W X;M
W D F | W D;F
V X O | O X;V
P B D | P B;D
B E Q | E Q;B
I V E | E V;I
J Q F | Q J;F
W Z M | M W;Z
Y L A | L A;Y
C P U | U P;C
Q K U | U K;Q
M G L | M L;G
F C L | L C;F
Z W X | W X;Z
S N H | H S;N
E H U | H U;E
G U N | U N;G
F E L | E L;F
E X G | G X;E
A J T | J A;T
I O U | O I;U
Y J U | J Y;U
O M H | H O;M
I B H | I B;H
I T O | I O;T
E C G | G C;E
G Z U | Z G;U
Z C F | F C;Z
R Q D | Q R;D
Z D S | D S;Z
I T Y | Y T;I
Z L B | L Z;B
R E D | R D;E
V W Y | W V;Y
Z N H | H N;Z
Q Y A | Y Q;A
G C P | G P;C
W Z F | Z W;F
W A I | A I;W
P F I | I P;F
P N O | O P;N
I M A | A M;I
Q V R | V Q;R
V B G | B V;G
G T S | T G;S
K T V | K V;T
Z S R | S R;Z
D T W | W T;D
U J I | J I;U
C H F | H C;F
T N W | N W;T
J O G | O G;J
J G W | W J;G
O A C | O C;A
H E U | H U;E
V S G | G S;V
W T S | W T;S
I Z P | Z I;P
I Z F | I F;Z
G V U | V G;U
I N B | B I;N
X L F | X F;L
F Q Z | F Q;Z
G B J | G J;B
O W D | O D;W
U L M | U L;M
B M S | M S;B
V A D | V D;A
D T Z | Z T;D
T A S | T A;S
Q E L | L E;Q
J H T | T J;H
C L W | C L;W
I R F | F I;R
I A D | I D;A
E A W | W E;A
Q D N | N D;Q
Y J G | J G;Y
O L A | A O;L
C Y T | T Y;C
Z E D | D E;Z
C U E | C U;E
O H C | H C;O
L O W | W O;L
U G N | N U;G
N G H | G N;H
W X P | W P;X
S J A | J S;A
F N T | T N;F
G E Z | E G;Z
L O P | O L;P
K P B | P K;B
M O X | O M;X
U F K | K F;U
Y Z U | Y U;Z
J Q A | J A;Q
A V C | A C;V
H J L | J L;H
H W L | H L;W
I H C | I C;H
O U X | X O;U
K L C | K L;C
D J F | J D;F
G V R | G V;R
K R Y | Y R;K
K M I | I M;K
E L Y | Y L;E
U N Z | U Z;N
P L T | P L;T
X Y J | X J;Y
F E T | F E;T
U T K | T K;U
H J N | N J;H
L Y W | L W;Y
V A L | L A;V
C F A | A C;F
Q S M | Q M;S
L P C | C L;P
I X L | I X;L
U H G | G U;H
S Q O | O S;Q
E J Y | Y E;J
O P K | O P;K
O J H | H J;O
A F T | A F;T
L E O | E L;O
M O L | M O;L
J K X | K J;X
C O H | O C;H
O G Q | Q G;O
F P T | T F;P
S T Y | Y S;T
P M G | G P;M
I D P | I D;P
D F L | L F;D
L C O | L O;C
M P W | P M;W
C U F | F C;U
Y G C | Y G;C
V J A | A J;V
Z T V | Z T;V
B U V | B U;V
B P V | B P;V
D I W | D I;W
C N F | N C;F
G M Z | Z M;G
P V A | A P;V
A P Z | Z P;A
B U V | B V;U
R G D | R G;D
J A W | J A;W
T H W | T W;H
M A P | M P;A
N J H | H J;N
D I V | V D;I
T J O | O J;T
J L T | T J;L
G R F | R F;G
Z T N | T Z;N
V O H | O H;V
L U M | L M;U
J X E | J X;E
Z C S | S Z;C
K E H | E K;H
M R T | T R;M
Z W O | Z O;W
I T V | I T;V
C M N | M C;N
W E B | E W;B
Q Z S | Z S;Q
W Z F | F Z;W
C O W | O W;C
L G D | G D;L
C S P | S C;P
T B C | T B;C
W P U | W U;P
Z N M | N Z;M
X P O | X P;O
B R U | B U;R
P V L | L V;P
L G S | S L;G
Q B L | Q L;B
I C A | I C;A
U L T | T U;L
W S C | W S;C
O B H | B O;H
F B W | W F;B
Y N K | N Y;K
G S A | G S;A
B Z O | O B;Z
Z Y O | Z O;Y
P T I | P T;I
Z P O | Z O;P
I J B | I J;B
R N M | M N;R
B W N | W N;B
X B M | M X;B
Q F K | Q F;K
P F R | P R;F
K V M | M K;V
I C T | C T;I
H R M | R M;H
E K D | K D;E
D Y R | Y R;D
N L J | J L;N
I Z P | Z P;I
J Q R | Q J;R
Q J H | Q H;J
H M G | G H;M
T R S | S T;R
A E R | R E;A
Q A K | Q K;A
C W X | W X;C
J V T | J T;V
C I N | I N;C
U B Q | U B;Q
Q H L | Q L;H
W K Y | W K;Y
H I D | H D;I
X W I | X I;W
B F N | N B;F
S G Z | Z S;G
O Y Z | O Z;Y
H G W | G W;H
W V C | W V;C
Z Q L | L Q;Z
F R T | F T;R
J G N | N G;J
D N Z | Z D;N
P U Q | P U;Q
E Q L | E Q;L
R N S | S N;R
A U X | U A;X
K O F | F K;O
W B N | N B;W
Z F X | X F;Z
G Q P | P Q;G
Y G A | G Y;A
N H V | V N;H
K I O | I O;K
O W M | M O;W
N F H | N F;H
D I H | H D;I
H O K | K O;H
U H V | V U;H
B S M | B M;S
V G L | G L;V
Z D S | S Z;D
H I P | P I;H
Y S R | S Y;R
V S W | S W;V
F D P | F D;P
J Q V | Q V;J
M Y D | D Y;M
X E I | E X;I
T K M | T M;K
K P E | K E;P
R D P | R D;P
G R Q | Q R;G
O K S | K S;O
F P W | F P;W
D C N | N D;C
Z O P | P Z;O
Z L V | L V;Z
Y X V | V X;Y
T X K | T X;K
C W Q | W Q;C
X I V | I V;X
T O U | U T;O
M V R | R M;V
G O P | O P;G
S I B | S B;I
L B C | L C;B
X U T | U T;X
D O H | H O;D
E J Y | J E;Y
S F T | T F;S
K V X | X V;K
C V Q | C Q;V
R N J | J N;R
A P J | J A;P
D F S | S D;F
T D Y | Y T;D
I E G | G I;E
H J C | C H;J
K G E | G K;E
N W T | N W;T
B P Z | B P;Z
N Z P | N P;Z
N T G | N G;T
J M K | M J;K
Z S I | I Z;S
F C Y | Y F;C
Z O Y | Z O;Y
J H P | H P;J
K M W | M W;K
Z X U | U X;Z
Z K Q | K Q;Z
M V C | V C;M
A R T | A T;R
K C H | H C;K
V Z K | Z V;K
K B C | C K;B
G A D | D G;A
G W A | A W;G
B E W | E W;B
L T W | W T;L
F L Y | L F;Y
G W C | C G;W
Z C W | W C;Z
A W P | P A;W
D W V | D W;V
W D L | D L;W
A D J | D J;A
D H U | H D;U
A W C | W C;A
J T Q | Q T;J
I K H | K I;H
F Q U | F Q;U
K D B | D K;B
Y V F | V F;Y
X Q S | Q X;S
R I D | R D;I
W C I | C W;I
D J V | V J;D
M U C | C M;U
A M Q | A Q;M
W O D | W O;D
M Y A | M A;Y
T D N | D T;N
R L W | W R;L
V Z B | Z B;V
N G X | X G;N
C Z G | Z C;G
L H C | C L;H
I W S | S I;W
S P Y | S Y;P
M F T | F T;M
F Q P | Q P;F
J R P | P J;R
Y J M | M Y;J
G R I | R G;I
Q M G | M Q;G
Q W G | Q G;W
B T O | B O;T
Y J S | J Y;S
P X Q | Q X;P
E W V | E V;W
N J Z | N Z;J
Q F B | B Q;F
V Z B | Z B;V
E W D | E W;D
R U N | N U;R
N T G | T N;G
R M J | R J;M
S T X | S X;T
W G Q | G Q;W
I W B | W B;I
X A P | P X;A
Q S K | K S;Q
F V R | R V;F
U F H | F U;H
S H K | S H;K
A M F | M A;F
Z V H | Z V;H
S O E | S E;O
B K F | F B;K
J S Q | Q J;S
T P W | T P;W
S L Y | S Y;L
J S W | J W;S
G Q Y | Y Q;G
I Z X | X I;Z
P G T | G T;P
B N A | N A;B
Z G U | G Z;U
L F V | F L;V
D V L | L V;D
L I K | L I;K
V J R | J V;R
J V O | O V;J
H T A | T A;H
M E G | M G;E
E P L | E P;L
R F L | L F;R
D Q J | J Q;D
Y V I | I Y;V
I X G | X G;I
F S B | S B;F
O H E | O E;H
L U K | K U;L
R B V | V B;R
Z K V | K V;Z
I L G | L I;G
P D M | P D;M
F U C | U F;C
P Y F | Y F;P
G P H | P G;H
E A Q | A E;Q
I L N | I N;L
B Y Z | Z Y;B
W Q X | W Q;X
N Y M | Y N;M
T A J | T J;A
U J D | J D;U
G A C | G A;C
X Y J | X Y;J
C W Y | Y C;W
Y B C | B C;Y
Q A U | A U;Q
V P U | U V;P
G N R | G R;N
N O X | N X;O
P K B | P B;K
X C N | N X;C
H R Z | H Z;R
R U Z | Z R;U
D W Q | Q W;D
V T Q | Q T;V
G E R | R E;G
S T L | L T;S
A W T | W T;A
O R I | R I;O
K B T | T K;B
P Y H | H Y;P
B Q G | G B;Q
J M E | E M;J
K D Q | Q K;D
B V N | N V;B
V M G | M V;G
I A Y | Y A;I
C V D | C V;D
A G W | A G;W
N O Y | O Y;N
U B I | I B;U
T D C | T C;D
Y Z D | Y D;Z
A Y L | A L;Y
K N Y | N Y;K
V H F | H F;V
H X B | H B;X
K A X | X K;A
Z N Y | Y N;Z
A O P | P O;A
C B F | B C;F
Q O K | K O;Q
D T M | D T;M
B J L | L J;B
G V M | V G;M
P F L | L P;F
R K N | N R;K
J S A | A S;J
I B N | N I;B
F V I | I F;V
O Z X | Z O;X
Y P W | W Y;P
U D T | U D;T
N O J | O N;J
J H L | J L;H
O N B | N O;B
C G U | U G;C
P Z W | P W;Z
K P S | K S;P
S V Y | S V;Y
L U K | U L;K
J R L | J L;R
J Z E | J E;Z
C R P | P C;R
A J P | A J;P
U D I | U D;I
D A M | D M;A
C O B | C B;O
D C N | D N;C
Q M W | M Q;W
L A J | L J;A
U Q K | U K;Q
Z S Q | Q S;Z
M R K | R M;K
P X C | X P;C
G Q B | B Q;G
Q B R | Q R;B
N J L | J L;N
V B A | B V;A
B V D | B V;D
T K M | T K;M
F B P | B P;F
K A E | K E;A
C I L | I L;C
V G N | V N;G
F E T | T E;F
M R W | R W;M
J F S | F J;S
A D L | A L;D
U D R | U R;D
V K M | V M;K
W J N | J W;N
F D E | E F;D
G U F | F U;G
S I K | I K;S
E W F | W E;F
I Y N | I Y;N
R O P | O R;P
W Z Y | W Y;Z
A O J | A O;J
T P H | H T;P
I Q C | Q C;I
Q R S | S Q;R
R Z A | R A;Z
D W J | W D;J
U K W | K U;W
M W V | M V;W
Y K S | K Y;S
D C B | C D;B
B E A | E B;A
Q Z G | Z Q;G
Y K D | D K;Y
N A F | F A;N
F J N | J N;F
U S C | U C;S
R W A | R A;W
U E J | U J;E
M Q V | V M;Q
T R L | L T;R
K F B | K B;F
L X I | I X;L
V J Q | V J;Q
F D K | F K;D
X R Z | Z R;X
A U P | A P;U
T Y U | T U;Y
J K B | B K;J
D I P | D I;P
Y H L | H L;Y
G P Z | Z G;P
R J Y | J R;Y
C A H | A H;C
K X E | X E;K
L V A | L A;V
Z X Q | Q Z;X
C B H | B C;H
L V Y | V Y;L
Q C G | C Q;G
Q J M | J Q;M
E Z A | Z A;E
V S E | S V;E
G E H | G H;E
C N J | C J;N
C T G | T C;G
V F C | V C;F
R O N | R O;N
L O V | L V;O
S R H | H S;R
Z O L | L O;Z
D A Y | D A;Y
Z S J | Z S;J
R J B | R J;B
Z V R | R V;Z
A K V | K V;A
H U A | H U;A
C Y Q | C Y;Q
W Z V | V W;Z
W R S | S R;W
Y H V | V Y;H
B W Y | Y W;B
D Y Q | Y D;Q
J O B | O J;B
Q J G | J Q;G
H E A | H A;E
S V R | V S;R
U T I | U I;T
C Z G | C G;Z
D H J | J D;H
Z O G | Z G;O
H D A | H A;D
U E T | U E;T
J W F | J F;W
X F J | X J;F
P A K | K A;P
Q M D | Q M;D
P K T | T P;K
V M K | V M;K
N F Z | Z N;F
T I N | N T;I
J G O | O J;G
N A M | M N;A
G R Q | Q R;G
X T W | T W;X
N E R | N R;E
A I Y | A Y;I
R U M | U R;M
A X D | D A;X
C Q Z | C Q;Z
L E U | L E;U
H S O | S H;O
A E S | S A;E
Z F S | Z F;S
N K S | S K;N
M W D | M D;W
N X R | X R;N
U S P | U P;S
S K H | H S;K
H Z Q | Q H;Z
T O G | G O;T
N J O | N O;J
M Q L | L M;Q
M X Z | M Z;X
O W S | S O;W
E R S | E S;R
W Z X | X Z;W
Z S X | S Z;X
F C A | C F;A
F I V | I V;F
C E I | E I;C
D U Z | Z D;U
V U B | V U;B
Y Z X | Y X;Z
R O Q | O Q;R
R K P | K R;P
S B D | B D;S
A S F | S A;F
Q W L | L W;Q
H J L | H L;J
T G C | G C;T
Y A P | P Y;A
U Z O | U Z;O
J W Z | W J;Z
X B V | X B;V
M R Z | R Z;M
T S X | T S;X
I L C | L C;I
X L F | F X;L
Q E U | Q E;U
E Q Y | Q Y;E
D C O | D O;C
G A D | G D;A
T C I | C T;I
P Q N | P Q;N
E K B | E B;K
E F Z | E F;Z
Z V Y | V Y;Z
N S P | S P;N
J Q F | Q F;J
L Z Y | L Y;Z
S B Q | Q S;B
A Z M | A Z;M
E L Z | L E;Z
H L N | N H;L
S W K | W K;S
O Z G | G O;Z
R D P | R P;D
Z D Y | Y Z;D
Z M K | K M;Z
B O D | O B;D
N V E | E N;V
A Z P | A P;Z
R W Z | Z R;W
G M U | G U;M
Z Q M | Z M;Q
N Z F | F Z;N
H E T | H E;T
V A Q | Q V;A
X H O | O H;X
L B O | O L;B
Z V J | Z J;V
O J Z | Z O;J
E J W | E W;J
V H O | O V;H
Z K H | K H;Z
C V O | C V;O
F O M | M F;O
A G P | A G;P
B R D | B R;D
R O Q | Q R;O
G H C | G H;C
D R A | D A;R
E X P | P E;X
D B U | B D;U
L W U | L W;U
R C O | C O;R
S N Y | N Y;S
L U E | L U;E
F H A | F H;A
I K H | I H;K
R H V | R V;H
P C M | P M;C
O Y J | O J;Y
E H R | E R;H
F N W | F W;N
S Z I | Z I;S
O R C | C R;O
S H N | H S;N
M F X | F M;X
Z L P | L Z;P
W O Y | O Y;W
G K O | G K;O
P G N | G N;P
K V W | K V;W
X W B | X W;B
G Q B | B G;Q
H X W | W H;X
D N W | W D;N
S I G | G S;I
B S K | K B;S
L N J | J L;N
P U Y | Y P;U
G O D | D O;G
V Y H | Y H;V
P S G | P S;G
D H E | E H;D
U B H | U B;H
E O X | O E;X
G H R | R G;H
A U M | U A;M
B L X | L B;X
R K Y | Y R;K
I E K | E I;K
A C O | O C;A
L A H | H A;L
Y T E | T Y;E
M R D | M R;D
Y N O | N Y;O
Y T B | B Y;T
W L J | J W;L
M J Y | M Y;J
K Y D | D K;Y
R P H | R P;H
M X A | M A;X
D S W | W D;S
T G C | C T;G
M B K | M B;K
L G U | U G;L
V T F | T V;F
D M R | M R;D
E U F | U F;E
B Y S | S Y;B
I H R | H R;I
P O L | O L;P
L O D | D O;L
Q H J | H Q;J
N X Y | X N;Y
Y G V | Y V;G
L E Z | E Z;L
O V T | O T;V
T G B | T G;B
E X R | R E;X
L O G | L G;O
D K U | U D;K
X O F | X O;F
Y L P | P Y;L
O L A | A L;O
J Z X | J Z;X
G A E | A E;G
I R V | I R;V
X U K | U K;X
T P M | M T;P
K F T | K F;T
S Q M | Q S;M
O B R | R O;B
J O Y | O Y;J
U B P | U B;P
J C B | B J;C
M W E | M E;W
H W K | W H;K
O W K | O W;K
G V T | V G;T
P G O | O P;G
P S J | S J;P
Z K U | U K;Z
E M N | N E;M
B F I | B I;F
V M S | V M;S
H Z P | P Z;H
H K C | K C;H
T V X | X V;T
V Z X | X Z;V
L C W | W C;L
I Z T | T I;Z
R D J | D J;R
N H F | H N;F
D C B | C D;B
P C O | C P;O
T D J | D T;J
F P I | P F;I
P U K | P U;K
D I M | M D;I
Q C N | N C;Q
T U V | U V;T
T R A | T R;A
E Y G | Y E;G
P T R | R P;T
Y C K | K C;Y
I A W | I A;W
S Q J | Q S;J
V D I | V I;D
M Z C | M C;Z
B L Q | B L;Q
X D F | D F;X
V A N | N A;V
R E Q | R Q;E
W J E | E J;W
M G I | M I;G
A H X | H A;X
C X R | C X;R
P N K | P K;N
C V E | E C;V
H R Q | R H;Q
Y V K | K V;Y
E Z G | Z E;G
Q U Y | U Y;Q
I M G | G M;I
O F X | O X;F
X Y P | X Y;P
K F X | K F;X
K Z O | Z O;K
K X O | X O;K
L S I | I S;L
V H K | H K;V
S U X | S X;U
R K Z | R K;Z
Q N Y | N Q;Y
L A U | A L;U
P F J | J F;P
H K B | B H;K
D O Z | Z D;O
T R Q | R T;Q
H S J | S H;J
T A Z | T A;Z
P U R | R U;P
I O B | I O;B
U X C | C U;X
P F B | P F;B
S E D | D S;E
V J P | P J;V
U H R | H R;U
R P N | P N;R
C P Z | Z P;C
L B A | A B;L
V P C | C V;P
D B J | J B;D
Y W U | W Y;U
G J V | J V;G
N A S | N S;A
N Y W | W N;Y
Q H Y | Y H;Q
L W M | L M;W
F C W | W F;C
Q U H | U Q;H
O L C | L C;O
N E L | N E;L
L F O | F O;L
U D H | D U;H
L Y G | L Y;G
P Y M | M P;Y
O L I | I O;L
E F L | L F;E
Y I Z | Y I;Z
P X A | A X;P
B K W | K B;W
I D Z | D I;Z
A L H | L H;A
P N G | G P;N
E I B | I B;E
A U L | A L;U
J K Q | K Q;J
D K C | C D;K
D Z C | D C;Z
T J Y | T Y;J
N R Y | Y N;R
A H G | H A;G
Y L N | N L;Y
R H J | H J;R
K T Y | K T;Y
B Z X | B X;Z
O P D | D P;O
W G V | V G;W
U S H | U H;S
N Q F | N Q;F
K T A | T K;A
L Q Y | L Y;Q
B X U | U B;X
L J F | F L;J
N R V | R N;V
M R Y | M R;Y
A R Z | Z A;R
R X E | X E;R
Y Q O | O Y;Q
X N S | X S;N
K F Q | F K;Q
L W J | W L;J
B D A | A B;D
W M O | M O;W
J S U | S U;J
S K H | K H;S
T S J | T S;J
L R D | L D;R
K H Y | Y H;K
S V E | E S;V
J Q I | Q I;J
E C Q | E Q;C
J T P | T P;J
J H P | J P;H
C D E | E D;C
J G A | A G;J
V C E | C V;E
H C X | H X;C
J I V | I V;J
A P V | V A;P
Z V S | V S;Z
L G H | L G;H
J F E | E F;J
V L H | H L;V
C N I | C I;N
K U F | U F;K
S F N | S F;N
B C A | A B;C
J T M | M J;T
C S V | S V;C
I B X | B I;X
B F A | B A;F
D E H | D H;E
B S G | S B;G
V O Z | Z V;O
B A J | J A;B
Q N E | Q E;N
L Y P | P Y;L
U F P | U P;F
K Y N | K Y;N
Q G U | G U;Q
E B R | B E;R
G Y U | U G;Y
J K L | J K;L
B J E | B E;J
C J T | T C;J
C J N | J C;N
G C L | G L;C
B M H | H B;M
E K I | I E;K
A Y N | Y A;N
S D Y | Y D;S
I K R | I R;K
F X V | F V;X
Q X Y | Q Y;X
D Z A | D A;Z
L Z C | L C;Z
V A J | A V;J
Z R Y | R Y;Z
Q Z F | Z F;Q
G Y R | G Y;R
I K H | K I;H
K P Z | Z K;P
U R A | R A;U
K V Y | Y K;V
J H R | J H;R
X D O | X O;D
D H M | M D;H
P J C | P C;J
W L M | M W;L
S T V | V T;S
C E H | E C;H
F S C | S F;C
E A Z | Z A;E
B C J | C B;J
D H O | O D;H
H Y J | Y H;J
O A R | A R;O
G D Y | D G;Y
G Z I | I Z;G
B H V | H B;V
S K J | K J;S
S K L | L S;K
Q X T | Q T;X
M T P | P M;T
U E I | U E;I
C I G | I C;G
B P G | P B;G
S Y C | C Y;S
E U T | T E;U
E T D | D E;T
V L A | A V;L
H D V | D V;H
B J I | I J;B
A Z W | W Z;A
R I B | B I;R
I P X | P X;I
T R V | T V;R
F T O | F T;O
S C T | T S;C
E Z U | U E;Z
I O S | I S;O
H R P | R H;P
S C R | R S;C
K T S | S T;K
F Y M | F M;Y
M G V | G M;V
H B M | H M;B
I T X | X I;T
M Q C | C M;Q
V N T | N T;V
K F U | F K;U
Q I C | I C;Q
P A I | P I;A
N M R | M R;N
X G M | M G;X
X N Y | X N;Y
R U C | U C;R
F B X | X F;B
V D O | D O;V
R I F | F R;I
D F Z | Z F;D
E J H | E H;J
G S O | G S;O
L V U | L U;V
T E Q | E T;Q
Q N G | N Q;G
B Q F | Q B;F
C R V | R C;V
N I R | I R;N
K P D | D P;K
P C I | P I;C
P S R | R S;P
E J T | T J;E
S Z O | O S;Z
T B M | M B;T
B Y L | Y B;L
V Q W | W Q;V
E L C | E L;C
I Z T | Z T;I
K X P | P K;X
K H X | H X;K
R H V | H V;R
Z D J | Z D;J
V G X | X V;G
E Z Y | Y E;Z
H R U | R U;H
W Z F | W F;Z
C U N | N U;C
O H S | S O;H
F B N | B F;N
S Q U | U Q;S
A B P | A P;B
W S N | N W;S
Z B S | Z S;B
A T V | T A;V
P T C | C T;P
C M Z | Z C;M
B G H | H G;B
M L T | L M;T
G S O | G O;S
H W B | W B;H
Y J U | U J;Y
I A L | L A;I
V L X | X V;L
X J O | O J;X
E S U | S U;E
L M Y | Y M;L
D A U | D A;U
D H C | D C;H
I Q J | Q I;J
J Z O | Z J;O
T F U | U F;T
O S H | H O;S
U W R | U R;W
T Z O | O Z;T
P V J | J V;P
M D X | D X;M
P A R | R P;A
I J K | K J;I
F Q E | E Q;F
C G V | V C;G
L P O | L P;O
M O Y | O Y;M
J T X | X J;T
J C V | C V;J
T K X | T K;X
J T I | J T;I
C J B | B C;J
F K D | F K;D
R Z D | Z R;D
Y E Q | E Q;Y
K I E | I K;E
G M D | G D;M
A Y P | P A;Y
R Y I | I Y;R
L O J | L O;J
N S Z | S Z;N
D M C | M C;D
S Q H | H S;Q
F Y J | J Y;F
E Y H | Y H;E
B F D | B D;F
V X D | X D;V
O H J | H J;O
T Z X | X T;Z
P S W | S W;P
J H D | H J;D
W V D | V D;W
D K V | V K;D
N O B | N O;B
K Z U | K U;Z
J P N | J P;N
U T Q | T U;Q
T N K | K N;T
S O V | O V;S
T Q D | D T;Q
G U S | G U;S
R V H | V H;R
O B S | S B;O
B F P | B P;F
B W Y | B Y;W
T U W | T U;W
J T M | J M;T
C L F | C F;L
N C L | N C;L
P L F | L P;F
D M A | A M;D
N K U | U N;K
Y D Q | Y Q;D
F N D | D N;F
M U B | M B;U
Q K O | Q O;K
O I W | I W;O
Y D S | D Y;S
N D V | V N;D
O Z F | Z O;F
N A I | A I;N
F M V | V F;M
E S P | E P;S
I W E | E I;W
K M O | M O;K
J O K | K O;J
E B R | E R;B
Z W S | W S;Z
Q Y C | Y Q;C
N M W | N W;M
V Y E | E V;Y
N I T | N T;I
S G V | G S;V
C V M | M C;V
D Q O | D O;Q
Z H O | Z H;O
Q H S | Q S;H
G Z J | G Z;J
T Y G | G Y;T
V M D | M V;D
M L U | L U;M
T K M | K M;T
F H J | J H;F
O W T | O W;T
V M Y | V M;Y
A Q H | Q A;H
K L H | K H;L
L H Q | L H;Q
S N Z | N S;Z
C E X | X E;C
Y H D | Y H;D
Y X O | X Y;O
H L S | H L;S
Y K N | N K;Y
Y H M | M Y;H
F B S | S F;B
F Y X | F Y;X
N W R | N R;W
H O E | E H;O
C Z N | Z C;N
W K U | K U;W
T P M | T M;P
U L H | L H;U
G N X | G X;N
C U W | U C;W
K R V | R V;K
M S N | N S;M
Z P S | P Z;S
R C X | R C;X
I O S | O I;S
B Y H | H B;Y
H L P | P L;H
W L H | W L;H
C P K | K P;C
Z Y R | R Y;Z
D H N | H N;D
Q B A | A B;Q
D M A | M D;A
S K M | M K;S
R K A | R A;K
B J I | I J;B
V S D | D S;V
L B K | B L;K
S G E | S G;E
P A Z | P A;Z
F E C | F E;C
V K Y | Y V;K
C Z L | L Z;C
Y M V | M V;Y
H E L | E L;H
O T B | B T;O
A V Y | V A;Y
H A O | H A;O
R H F | R H;F
O Y U | U Y;O
D W G | G D;W
E A G | A E;G
Q Z T | T Q;Z
P C Z | Z P;C
N B O | N O;B
P D H | P H;D
F V O | V O;F
H T O | O T;H
P E C | E P;C
L B C | L C;B
C W O | O C;W
I N Y | I N;Y
P E W | W P;E
Q I S | Q S;I
X H W | W X;H
N S E | N E;S
M Y Q | M Y;Q
K R O | O R;K
K S B | B K;S
W M C | C M;W
N U V | N V;U
U R T | R T;U
Z T U | Z U;T
M W U | M U;W
D W L | L D;W
Z Y N | Z N;Y
I P V | V I;P
H A L | H L;A
Z O V | O V;Z
V Y O | V Y;O
E F O | O F;E
M H R | M H;R
B O H | O H;B
M C Q | M Q;C
Z Q K | Q K;Z
Y K Z | K Y;Z
W T R | W R;T
R S O | R O;S
H N A | H N;A
Y R W | R W;Y
V L O | L O;V
A Z C | Z A;C
H M V | H M;V
X R D | D R;X
L R S | L S;R
F P V | V F;P
A K S | A S;K
G R J | J R;G
B W J | J B;W
L O J | O L;J
B R O | B R;O
O K E | K O;E
J F V | V J;F
U L A | A U;L
Z J D | D J;Z
V Y D | D V;Y
V A M | M A;V
D K F | F D;K
M E X | E M;X
W Z H | H W;Z
I R B | R B;I
O E Y | E Y;O
Z U F | Z F;U
S X N | X S;N
I F M | F I;M
V O B | V O;B
J B T | J T;B
O F Y | O F;Y
O U B | U B;O
U Y T | U Y;T
Y E P | E P;Y
Q Y B | B Y;Q
S Q G | S G;Q
I J W | J I;W
K J N | J K;N
X Z T | Z T;X
C N T | T C;N
C A S | C S;A
N K H | K H;N
A N I | N I;A
H Z U | H U;Z
I B M | B M;I
L S M | S L;M
D V X | D V;X
S L G | L G;S
I Y H | I Y;H
N B T | T N;B
D B I | B D;I
T V D | D V;T
S R K | K R;S
I D X | D X;I
N Q P | N P;Q
O B W | O W;B
Y U F | Y U;F
D O X | X O;D
A Y Q | Y Q;A
E M F | F M;E
D B O | D B;O
Y I Q | I Y;Q
T A Q | Q T;A
Z M A | Z A;M
A O J | O A;J
Y R S | S Y;R
R I W | W I;R
V E M | V M;E
X R D | D R;X
U F E | E F;U
J G F | F J;G
C N U | U C;N
K Q R | R K;Q
I O T | O T;I
U D Q | D U;Q
A Z S | Z S;A
Q S W | Q S;W
Z B C | Z C;B
A X G | G X;A
W J Y | Y W;J
Y B U | U B;Y
I C X | I C;X
Y H K | Y H;K
Y W D | W D;Y
N G Y | G Y;N
P V N | P V;N
P Z C | C P;Z
D Q W | W Q;D
B W L | L B;W
B P W | W P;B
N D H | H N;D
Y J P | P J;Y
L Q O | L Q;O
E O I | I E;O
F I D | F D;I
B H F | H F;B
U F C | U C;F
H J O | H O;J
E M O | E M;O
L A I | I A;L
O R U | U R;O
X V L | V L;X
A E G | E A;G
T X G | X T;G
K F C | F K;C
V H W | W H;V
A U E | U E;A
B W U | W U;B
A S E | S E;A
A B E | E B;A
R K Z | K Z;R
A Y D | D A;Y
L U E | E U;L
O Q A | O Q;A
J N L | N J;L
E H G | G E;H
I M W | W I;M
D Z N | D Z;N
U H G | H G;U
R K C | R K;C
X Z N | X Z;N
M F R | R F;M
B O G | G O;B
G P Y | P Y;G
G H P | H P;G
N D H | D N;H
L C U | L U;C
W X S | X W;S
B T G | B T;G
S R G | S R;G
W T I | T W;I
B R M | R M;B
P Z C | C P;Z
G J B | J G;B
C S D | D C;S
C R L | C R;L
Q W M | M Q;W
Y M T | Y M;T
V D Q | Q V;D
G Y M | M Y;G
U Q N | U Q;N
E J Q | Q E;J
H O V | O H;V
W O Y | Y O;W
K R F | F K;R
P B Y | B P;Y
Y J O | Y J;O
Q F M | M F;Q
F W Q | F Q;W
E W S | S W;E
H P Y | P Y;H
P H V | P H;V
N Q C | N Q;C
V E P | E V;P
L H A | L H;A
E K J | E J;K
R I G | I R;G
G I B | B G;I
N C K | K C;N
A W X | A W;X
W T E | W E;T
U S J | U S;J
E B Z | Z E;B
M N R | M N;R
L M O | O L;M
B I O | B I;O
O M X | X O;M
C O Y | Y O;C
A D O | O A;D
K U N | K N;U
Z U T | Z T;U
G U C | G U;C
Y N B | B Y;N
T L Q | T L;Q
M G K | M K;G
W O G | W O;G
E L V | E L;V
H Q Y | Q H;Y
R H N | R H;N
P W Z | W Z;P
E I M | M E;I
X E G | E X;G
X Y U | X U;Y
F K C | K F;C
Q X Z | Z Q;X
J W D | D J;W
V R M | R V;M
P G M | P G;M
P V X | V X;P
J R K | J R;K
O S T | T O;S
T K A | K T;A
W B C | C W;B
Q W U | W U;Q
I F U | U F;I
B M O | M O;B
R M T | M R;T
Y T L | Y T;L
J S X | J X;S
N P K | N P;K
U V S | U V;S
I G U | I U;G
D V P | P D;V
R D Z | Z R;D
K O E | O K;E
I X Y | X Y;I
I V O | I O;V
Q C M | M Q;C
L T A | L T;A
G X L | L G;X
Z W C | W Z;C
K L I | K I;L
Y L P | Y P;L
E Q G | E Q;G
A K E | A K;E
U F C | C F;U
K N J | N K;J
S L C | S C;L
K X F | K F;X
B T U | B T;U
M E F | E F;M
P B O | B P;O
G R S | G S;R
K A W | W K;A
J M N | M J;N
V E K | V E;K
C H E | E C;H
V J I | I V;J
H E K | E H;K
L W V | L V;W
E R B | R E;B
D Z B | D B;Z
O Y S | O S;Y
G N O | G O;N
N F J | N J;F
D N W | N D;W
P C Y | Y C;P
P T W | P W;T
B M O | B M;O
V O Q | V O;Q
N Z G | G Z;N
K D A | A K;D
S N V | S V;N
G N J | N G;J
Q N X | N Q;X
T S I | S T;I
N M J | J N;M
Q Z S | S Q;Z
R Z K | R K;Z
R H S | H R;S
F O I | I O;F
I U A | I U;A
D A K | K A;D
P B T | T P;B
K S I | S K;I
T C Q | C T;Q
G K X | K G;X
F Q S | F S;Q
Q E L | E L;Q
Z E Y | E Y;Z
M W H | H W;M
N E T | E N;T
O H N | N O;H
G D Z | Z G;D
X N T | X T;N
W J I | J I;W
M T C | C T;M
E A R | E A;R
A D B | D A;B
W X O | O W;X
M Z T | T M;Z
X Z O | X O;Z
F I A | F I;A
Q A Z | Z A;Q
R U Q | Q R;U
W B L | B W;L
R L V | V R;L
S V G | V S;G
M U W | U M;W
M G X | M G;X
J Q S | S J;Q
R J F | R J;F
U I X | I X;U
Z N L | Z N;L
G M E | E G;M
F E M | M E;F
U Z E | E U;Z
O H Y | O Y;H
I B K | I B;K
V T R | R V;T
R L N | R L;N
C O Q | C Q;O
Y I T | Y I;T
G X I | X I;G
X L B | L B;X
W Y H | H Y;W
I H B | B H;I
K O E | O K;E
D X T | X T;D
U Q Z | Z Q;U
U A X | U X;A
S K T | K T;S
C G L | G C;L
R X W | X R;W
Q S J | J S;Q
K J M | K J;M
B Z U | Z U;B
S J C | S J;C
N B C | B N;C
A Z S | S Z;A
B X C | B X;C
R X O | R O;X
T B M | M T;B
C O T | C T;O
B H W | H W;B
F U Y | F Y;U
B F X | X B;F
H O Y | O Y;H
C A K | C A;K
I U G | U I;G
A I V | A I;V
K S I | K I;S
X E J | X E;J
Z L W | W L;Z
A U P | A U;P
V G L | L G;V
R E D | R D;E
T U V | T U;V
U Y W | Y W;U
T I A | T A;I
S I U | U I;S
D Q Z | D Q;Z
S Z G | G S;Z
Y S N | Y N;S
Y O J | J Y;O
E B F | B E;F
L F Y | Y F;L
W N Q | W N;Q
U W G | U W;G
M Z N | M Z;N
M V D | M D;V
T S L | T L;S
O L B | O B;L
N U C | C U;N
Z R O | O Z;R
B P O | O P;B
F L O | F O;L
S X C | C X;S
Q J V | V J;Q
Z H K | Z K;H
Q L K | K Q;L
A C H | A C;H
O A R | A R;O
M R L | M L;R
O Q L | Q L;O
N L D | L N;D
W T I | T I;W
A U O | O U;A
C I O | O I;C
N P W | P N;W
U N M | N M;U
Y A G | Y A;G
S Q E | Q E;S
N Z V | N Z;V
W R S | W S;R
V R J | J V;R
Q K T | K Q;T
I Q X | I Q;X
S Y G | S G;Y
I C R | I C;R
R V W | V W;R
N G D | D G;N
G Y H | H Y;G
P W V | P W;V
B N H | B N;H
V H M | V M;H
M L Q | Q L;M
Z P K | Z P;K
D I W | I W;D
O I Q | O Q;I
Y R G | R G;Y
O I C | O C;I
O L U | U L;O
C F O | C O;F
D H W | D H;W
Q U W | W Q;U
T R F | F R;T
Y U L | U Y;L
J P I | I P;J
M V I | M V;I
C W P | C P;W
B K N | B N;K
B P G | P B;G
L E N | L E;N
L I A | L I;A
B X W | W B;X
K J X | K J;X
Y W U | U Y;W
W C P | P W;C
G E Z | E G;Z
B J S | B J;S
D U N | N U;D
H A W | W A;H
I J K | J K;I
B T M | M T;B
Y D Z | D Z;Y
T A Y | T Y;A
G F R | F G;R
Q T G | Q T;G
Z F V | Z F;V
E C D | D E;C
X N H | X H;N
T N J | N J;T
G F L | F G;L
Z W V | W Z;V
W T O | T W;O
M E C | C M;E
T Z G | Z G;T
I X S | I S;X
H T C | H T;C
Q Y U | Q Y;U
O K G | G K;O
U W Q | W Q;U
R I G | G R;I
A O V | V A;O
Z L I | Z I;L
J O V | V O;J
I S R | R I;S
C N V | N V;C
S Y N | N S;Y
B I Y | B Y;I
I X C | I X;C
W R N | R W;N
U Q Y | Y U;Q
J D K | D K;J
Q D X | X Q;D
I C E | C E;I
A M J | A J;M
M F D | F D;M
D F N | N D;F
P F R | R F;P
Y D C | D Y;C
C U X | U X;C
Z I R | Z I;R
Q Y K | Y Q;K
K X C | K C;X
U S W | S W;U
F E B | F E;B
S E L | E S;L
L V M | L V;M
V X M | V X;M
K H G | H K;G
Y Q C | Q Y;C
K Q B | K Q;B
P K Q | Q P;K
S H E | H S;E
L R Y | R L;Y
T H L | T H;L
N Q W | N W;Q
B C X | C X;B
T J E | J E;T
Y U Q | Q Y;U
Y E S | S E;Y
X T F | X F;T
Q P D | Q P;D
J O W | J O;W
C N W | C N;W
C B T | C B;T
D N J | D J;N
U X N | X U;N
L W I | W I;L
N F I | N I;F
Z C J | J Z;C
J C Y | C J;Y
V Z K | K Z;V
K T S | T K;S
V M A | V A;M
W M O | M O;W
U R V | V R;U
N A D | N A;D
L V D | D V;L
O U J | U J;O
V N R | N V;R
Y A G | G A;Y
V P F | V P;F
Q B V | B Q;V
N J F | J N;F
X S M | X M;S
H B V | H V;B
N C R | C N;R
C Q A | Q A;C
E Q G | E G;Q
C E Q | C E;Q
E H C | H C;E
K O X | O K;X
G I R | G I;R
Z P M | M P;Z
S U M | S M;U
U X I | I U;X
Y X B | X B;Y
R E N | R N;E
Z V W | Z W;V
M I L | I L;M
Z S Y | S Z;Y
G Y B | G Y;B
A L M | A L;M
L P Q | Q L;P
G Y U | G U;Y
U Z E | E U;Z
C Y L | L Y;C
Q A R | R Q;A
T O K | O T;K
Z U W | U Z;W
W H G | H G;W
Z L G | G L;Z
H S M | S H;M
I K D | I K;D
Y H I | Y H;I
E U B | U E;B
V S K | V K;S
G P B | P G;B
I O C | I C;O
S X R | R X;S
G K Y | G K;Y
T P H | P T;H
K G E | G E;K
N B Q | Q B;N
R V Z | V R;Z
E F N | F N;E
E K H | E H;K
D S F | S F;D
C F V | V F;C
M J G | G J;M
R S H | R S;H
Z Q D | Q D;Z
B D X | B D;X
L U R | R L;U
O J X | J O;X
W D X | W X;D
S U D | S U;D
W U V | V U;W
C W X | X C;W
W Z Y | Z Y;W
Z A W | W A;Z
L F P | P F;L
U V D | U V;D
C K S | S K;C
D J F | D J;F
Z R N | R Z;N
V P W | W P;V
P L H | H P;L
G K M | M G;K
E Y I | Y I;E
Q W G | G W;Q
B P R | R P;B
G C U | C G;U
B X D | D X;B
Y H L | Y H;L
D R V | V R;D
R S B | B R;S
D P W | P W;D
T Y D | T Y;D
X F H | F X;H
F U M | U M;F
B G X | B X;G
M Y N | Y N;M
H L O | H O;L
D M G | G M;D
T R S | S T;R
O N F | O N;F
N F S | N S;F
Y G U | U G;Y
X B Z | X Z;B
Y A J | A Y;J
E G P | E P;G
U Z O | O U;Z
F X C | F X;C
E K I | E I;K
T K D | D K;T
I K W | K I;W
V H O | V H;O
P J D | J P;D
N J B | B J;N
C P M | C M;P
V P S | S P;V
M U J | J U;M
I D K | K I;D
V X H | H V;X
F N X | X N;F
P I F | P F;I
X Y H | X H;Y
T H F | H T;F
G X B | X B;G
K O W | W O;K
R T C | R T;C
E J Y | E J;Y
B U F | U F;B
Q T A | T Q;A
Y R M | R M;Y
F K Y | F Y;K
A Y E | E A;Y
R A Q | Q A;R
B U L | B L;U
X O E | E O;X
L E T | E T;L
O G X | O X;G
D N R | N D;R
C I V | C V;I
G L O | G O;L
R N S | S R;N
Q Y D | Q Y;D
V Q S | V Q;S
O J A | A J;O
X H J | J X;H
U A Z | A U;Z
A M V | M V;A
K J X | J K;X
F X I | I X;F
P D F | D P;F
Y H J | Y J;H
Q C P | C P;Q
V Z C | V Z;C
Q S J | J S;Q
V X G | X G;V
J E U | E J;U
X B N | N X;B
V O H | O H;V
I E D | I E;D
C Y Z | Y C;Z
C H Z | Z C;H
N A L | A L;N
D W M | D M;W
X U J | U J;X
Z E P | Z P;E
I F Q | F Q;I
J E W | E W;J
B F M | M B;F
V S L | S L;V
T U X | U T;X
Q I D | I D;Q
F W G | F W;G
Z L E | Z L;E
K F G | G F;K
Q P V | V Q;P
T D M | T D;M
D Q R | R Q;D
I S E | S I;E
F R N | N F;R
W Q F | Q W;F
A I V | V I;A
W T Z | T W;Z
K P G | G K;P
U I H | H U;I
U Z Q | Q U;Z
Y F I | Y F;I
D N R | N R;D
K X F | F X;K
N B V | B N;V
H D C | H D;C
N G S | S G;N
G K S | S K;G
C K A | K A;C
E F J | F J;E
C H L | C L;H
H I K | I H;K
P B H | H B;P
T Y O | T Y;O
B P Q | Q B;P
G D K | G D;K
R L E | R E;L
G F L | L G;F
L R T | T L;R
W B P | B W;P
V Y S | S V;Y
K R F | R F;K
Z Q J | Q J;Z
A Q R | R Q;A
J I O | J I;O
U M Y | M U;Y
G B H | G B;H
G C O | G O;C
W P B | P B;W
T M W | T M;W
T I R | I T;R
B F N | F N;B
M B Q | Q B;M
M O L | M O;L
C I D | I D;C
J L S | J L;S
L W S | S L;W
E A R | R A;E
C Q D | Q C;D
B Z U | Z B;U
Y H N | N Y;H
J G S | G J;S
W E O | W O;E
Z U H | H U;Z
A J F | J A;F
Y Z K | Y Z;K
V Q A | Q A;V
R F W | R W;F
L I J | I J;L
U O F | F O;U
H L E | H L;E
O L U | O U;L
C M F | F M;C
M E Y | Y E;M
O G H | H G;O
P O E | P E;O
S Q J | J Q;S
J U N | U N;J
A W J | W J;A
B V Q | V B;Q
L Y W | L Y;W
B X C | B X;C
L C K | L C;K
X W E | E W;X
A C V | A V;C
K X O | O K;X
P U D | U P;D
R D K | D K;R
E S H | E S;H
E R Y | Y R;E
O V U | U O;V
C Z Q | Z Q;C
A Q E | Q E;A
S I Q | Q S;I
R J I | R I;J
E G F | E F;G
M Z R | R M;Z
V H J | H V;J
R I D | I R;D
H S X | X S;H
N H S | S N;H
J D X | D X;J
C V F | V C;F
P M J | P J;M
P Z W | Z W;P
S M N | S N;M
E A D | A D;E
W G D | G D;W
B C U | U C;B
W E I | W I;E
T G P | T P;G
L M R | L R;M
O M Q | O M;Q
U K G | K G;U
W K C | K C;W
A Z O | O Z;A
Y X K | X K;Y
Z F H | F Z;H
G H F | F H;G
G N Y | G Y;N
L D M | D L;M
W F Q | Q F;W
D O A | D O;A
F A U | U F;A
S X J | S J;X
Z K J | Z J;K
F W J | F W;J
D O Q | D O;Q
X S C | X C;S
B N Y | Y N;B
P J B | P B;J
X A J | A X;J
L W O | O W;L
W R L | L W;R
O J Z | Z O;J
C T Q | Q T;C
G J L | G J;L
W O P | O P;W
V R B | R V;B
L D Z | L Z;D
K V J | K V;J
E X A | A X;E
C W L | C L;W
H P K | P K;H
W C F | W F;C
O G Y | O Y;G
Q W J | W Q;J
R Q C | Q C;R
Z W A | A Z;W
C R B | R B;C
E Z R | E Z;R
V Q I | Q I;V
D K X | K D;X
R X F | X R;F
Y E G | E G;Y
G N J | G J;N
U M E | M U;E
H A M | A M;H
I U Q | U I;Q
T M X | M T;X
R W G | W R;G
J P E | P E;J
Q M K | M Q;K
F D V | V D;F
J Z Q | Q Z;J
O J G | O J;G
Y D T | D Y;T
X H F | X F;H
M Q R | R M;Q
M I V | M V;I
T M K | M T;K
R N U | R N;U
J H M | H J;M
R K B | R K;B
I T N | I T;N
O L W | O L;W
V E G | G V;E
G H U | U H;G
A Z M | M A;Z
M X S | S M;X
B I T | T I;B
W G I | I W;G
D K B | D K;B
K H J | H K;J
L K S | K L;S
W T Y | Y W;T
Z O M | M Z;O
G I A | A G;I
Q S A | Q S;A
R E A | R E;A
K O P | K O;P
P N M | P M;N
J Y A | J A;Y
O N U | N O;U
C O F | O F;C
J R Z | R J;Z
T Q H | Q H;T
Y L Q | Y Q;L
Z W B | Z B;W
O T E | O E;T
V Q Z | Q Z;V
H V S | S H;V
J Y O | J O;Y
L T G | G L;T
U E R | U R;E
Z N O | N Z;O
H J F | F H;J
X B T | B T;X
B T O | O T;B
E H T | H E;T
C B N | B N;C
Y G S | S G;Y
R H D | D R;H
F T A | F T;A
V X K | V X;K
R P H | P R;H
A L Q | Q A;L
L J Y | Y L;J
L B X | X L;B
E Y W | E W;Y
A K M | A M;K
Y I S | S Y;I
E B L | E B;L
M T V | M T;V
C T P | T C;P
Y B Q | Q B;Y
T P Y | T Y;P
P Z B | B Z;P
Q V N | Q N;V
J A K | J K;A
Z Y D | D Y;Z
L Y W | Y L;W
S G D | D G;S
P L F | P F;L
T H Y | T Y;H
L T Z | T L;Z
S I U | I S;U
Z J P | Z J;P
Z W K | Z W;K
J O B | B O;J
I S O | S O;I
U Z C | U Z;C
K S N | K S;N
I A K | A K;I
H R U | R H;U
T R J | J T;R
G A K | A G;K
X F J | F X;J
C S N | S N;C
N F T | F T;N
R S A | A S;R
L F B | F B;L
L Z O | L O;Z
B C N | N B;C
I L P | P L;I
P W B | B W;P
M C V | M V;C
A Y F | A F;Y
P J Y | J Y;P
F Y S | S Y;F
T Z W | Z W;T
M P B | M P;B
W C F | F W;C
H Z W | W Z;H
S B D | B S;D
E J C | C E;J
J L R | J L;R
Y R Z | Y R;Z
T Z K | T Z;K
R D Y | R D;Y
L F N | L N;F
D P Y | P Y;D
R G V | V G;R
U T V | T U;V
W T O | T W;O
X D W | D W;X
J B P | B J;P
D Q P | P D;Q
L X Z | Z X;L
P E V | E P;V
R W N | N R;W
U C F | C U;F
B Q E | B E;Q
H L I | L H;I
J Q B | J Q;B
U M B | M U;B
Y P I | I Y;P
N R Y | R N;Y
U R N | U N;R
H X J | X H;J
L V W | L W;V
W E T | W E;T
F L Q | F Q;L
X R T | R X;T
S U L | L U;S
I R S | R S;I
W L O | W O;L
V Y M | Y M;V
S T X | X T;S
Q M Z | Z M;Q
Q V C | V Q;C
L A T | L T;A
H G J | G H;J
N V Y | N Y;V
Y N D | D N;Y
E D C | E C;D
S L P | S P;L
V G H | V H;G
T D I | I D;T
T H Q | Q T;H
D X Q | Q X;D
T C I | I T;C
A V G | G A;V
P A E | P E;A
G U V | V U;G
M S H | M S;H
H G P | P H;G
H B V | V B;H
Z Y C | Y Z;C
S U N | U N;S
V B L | L V;B
J L Y | J Y;L
D K F | F K;D
R M C | R C;M
X H T | T H;X
P X R | P R;X
H F O | H O;F
Q I F | Q I;F
X H V | V X;H
G V O | G V;O
K R H | R H;K
J E F | J E;F
O D N | N D;O
X O R | X O;R
Z K J | J K;Z
S M C | C S;M
N R V | R V;N
Q S E | S E;Q
Y A V | Y A;V
R I X | R X;I
X D U | D U;X
Z X A | X A;Z
S N B | N B;S
P C V | V C;P
I N T | T N;I
W S Q | W Q;S
C W G | W C;G
U B Y | Y B;U
Y V D | Y D;V
Z X K | Z X;K
R U V | R V;U
R D O | R O;D
D K S | K D;S
Q R D | R D;Q
N A Y | Y A;N
D X T | X D;T
A J X | J X;A
R I N | R N;I
Q S Z | Z S;Q
L I W | W I;L
V U D | V U;D
Z Q Y | Q Y;Z
G O S | S O;G
W M Y | Y W;M
Q K W | Q W;K
S R I | R S;I
A O V | A V;O
T N R | N R;T
Y D X | D Y;X
N D Q | Q N;D
Q N F | N Q;F
P U I | I U;P
O Q N | O Q;N
U T D | T U;D
P M R | M R;P
Q P I | P I;Q
V P U | V P;U
N J I | J N;I
W T I | I T;W
F C I | F I;C
R S H | R H;S
O A Q | Q A;O
S P O | S P;O
V X F | F X;V
U V K | V K;U
N B Q | B N;Q
A H I | I A;H
O H Q | Q O;H
C Q N | C N;Q
I M B | I M;B
T M I | I M;T
M G H | H M;G
Y D A | Y A;D
J Y S | Y J;S
B Z E | Z E;B
V P I | I V;P
D U W | D U;W
W G B | W B;G
V I D | I V;D
D M T | M D;T
S A Q | Q A;S
O L W | L O;W
Z R Q | Q R;Z
Y Q O | Q Y;O
W C P | C P;W
Q V G | V Q;G
S F Y | F S;Y
W J S | S J;W
M V C | V C;M
V K O | O K;V
Y P O | O P;Y
C J F | F C;J
H R Z | Z R;H
N I P | N I;P
O Q A | O Q;A
R O B | R O;B
T V C | T V;C
O B D | B D;O
G D T | D G;T
T S N | S T;N
M G Y | G M;Y
P Z H | Z P;H
Y M D | Y D;M
L H U | H L;U
D B R | D B;R
Q S H | Q H;S
L N W | N W;L
R U S | S R;U
B R I | R B;I
F I O | I F;O
H X G | X G;H
K M C | M C;K
T Y V | T V;Y
T J K | J K;T
O G A | A G;O
Y Q C | Q C;Y
W M A | M A;W
K T G | T K;G
H M X | M X;H
G V E | V E;G
D O G | O G;D
T X U | X T;U
A O Z | Z A;O
W Z H | W Z;H
A N G | N G;A
V E P | P V;E
C S O | C S;O
N S Q | N Q;S
Q S J | S J;Q
S Y Q | S Y;Q
Y A U | Y U;A
E T W | E T;W
Y U C | C U;Y
A O E | E A;O
I F M | I M;F
P U G | U P;G
D N V | N D;V
H O Y | Y H;O
Y U V | U Y;V
T D J | T J;D
Y G K | G Y;K
M O T | T O;M
N X B | X B;N
S V I | I V;S
L R C | C L;R
P A X | X P;A
Y B O | O Y;B
G O H | G O;H
R X M | X R;M
T V L | V L;T
G A B | A B;G
M V G | M G;V
E O M | M E;O
B J L | B L;J
O Y W | O W;Y
J X W | W X;J
L R W | L W;R
S N E | S E;N
J M V | M V;J
C M N | C M;N
T D S | D T;S
I T P | P T;I
Q X Z | Q Z;X
Y C B | Y B;C
D A E | A E;D
G V K | G V;K
H K Q | Q H;K
X R C | X R;C
P Z M | M P;Z
D Q W | W D;Q
E S F | F E;S
D A H | A D;H
P U W | W U;P
J G A | A J;G
D Y F | F D;Y
Z H I | Z I;H
S N P | N S;P
K O N | O K;N
G F J | F J;G
I X A | I X;A
S I O | I O;S
V Y M | M Y;V
S J K | S K;J
F T M | F M;T
B L T | L B;T
Y D N | Y D;N
C K S | C S;K
W C T | W C;T
I F L | F L;I
N L Y | Y L;N
Q V P | V Q;P
X Q V | Q X;V
W N D | N D;W
J L W | J L;W
T B D | T D;B
Q I Z | Z I;Q
W F K | W F;K
H Z K | Z H;K
Q S O | Q S;O
X Q A | X Q;A
V C L | C L;V
N C H | C H;N
U Y J | Y J;U
G U V | U V;G
R M Z | Z M;R
N V B | B V;N
K G E | K E;G
K M T | T M;K
L M I | M I;L
D S T | T D;S
E I Y | Y E;I
E O K | K O;E
P O V | O V;P
F S T | T S;F
J U K | K U;J
A F M | M F;A
S H I | H I;S
J I O | I J;O
N Q P | N P;Q
S K I | S K;I
H X U | X U;H
N E V | E N;V
H G P | G H;P
W J I | W I;J
K J P | P K;J
S R P | P S;R
S R G | S G;R
X C O | X C;O
F H R | F H;R
O R A | O A;R
T H S | T H;S
I S Z | S I;Z
K N S | K N;S
P K W | W K;P
N L M | M L;N
B I O | I B;O
V C X | V X;C
H A K | A H;K
R K W | K R;W
B G A | A G;B
C F M | C M;F
V A O | A V;O
S Z U | S U;Z
P X Z | X Z;P
D K L | K D;L
I E H | E H;I
Z Q A | Q A;Z
T S X | S X;T
E X R | R E;X
S O F | S F;O
R H Y | H R;Y
X Z S | Z S;X
X P J | X P;J
F W V | V W;F
M Y S | M S;Y
B N R | R N;B
M X G | X M;G
F E Y | E F;Y
B C J | J C;B
B E C | E B;C
D K H | H K;D
O P L | P O;L
U W L | U W;L
B M E | E B;M
Z A U | Z A;U
P W N | P N;W
Q E O | Q E;O
B H I | I H;B
T M F | M F;T
P Z O | P Z;O
F T Q | F Q;T
K W U | W K;U
O M J | J O;M
J S C | S C;J
Y S X | X S;Y
K U R | K R;U
U W I | I W;U
S U D | D S;U
U D A | U A;D
V L D | L D;V
S Z B | Z S;B
I B F | I B;F
H N U | N H;U
K T W | W T;K
P O V | O V;P
A Z X | A X;Z
B K Q | K Q;B
W Z I | I Z;W
V I Q | Q V;I
Z B O | Z O;B
U V E | E U;V
A J D | J D;A
Y J B | Y B;J
X Q B | X Q;B
S Y C | Y S;C
S Y U | Y U;S
J T F | J F;T
N P K | N K;P
W M O | O M;W
Z R A | R A;Z
A S Y | A Y;S
M B Y | M Y;B
U S D | S D;U
V H O | O H;V
H Y L | H Y;L
Q Y B | Q Y;B
T G H | G H;T
S K B | K B;S
V R I | R I;V
Q V F | V F;Q
Y H O | O H;Y
B F I | B I;F
F W B | B W;F
T P I | P T;I
H I Z | H Z;I
P F R | R P;F
C E F | F E;C
I S A | I A;S
T L K | L K;T
Q G V | V Q;G
T L Z | L T;Z
A S I | A S;I
A E N | A E;N
N O V | V O;N
I L V | V L;I
C B P | C P;B
F Y E | Y F;E
E A X | A E;X
D X P | D P;X
E Y Z | Z Y;E
W J K | K J;W
C J P | J C;P
U T A | T A;U
W M S | M W;S
C D U | C D;U
U Q H | H U;Q
G N M | N G;M
E F N | E F;N
K O S | S K;O
I Y A | Y A;I
X O W | W O;X
I A M | I M;A
L A P | A L;P
X H G | X G;H
Q Y U | Y Q;U
P V M | M V;P
E T U | T E;U
C A F | A F;C
G J T | J T;G
V F H | F V;H
F X B | F X;B
G S O | G S;O
Q N O | N O;Q
A G O | G O;A
V F G | V F;G
B O M | M B;O
Z W A | A W;Z
M J V | M V;J
H L P | P H;L
H Y D | D H;Y
J W N | W N;J
U C M | C U;M
I J A | J A;I
R E X | R E;X
N E F | N F;E
M G D | D G;M
B T W | W T;B
C P T | T P;C
T X U | X U;T
H R V | V H;R
L S Y | L S;Y
O H N | N H;O
P Z J | P J;Z
F Q C | Q F;C
P K Q | Q K;P
P T N | N P;T
J O D | J D;O
D F G | F D;G
G X A | X A;G
A M F | F M;A
Q U V | U Q;V
S H U | U H;S
