K S F Z M Y | Z F K M Y;S
L P D U A F | F L P U A;D
U J Z R N O | O N J R Z;U
C A M D V Y | V Y C A D;M
P R T C N K | T P R K C;N
G A R M C F | F M C G A;R
U M Y Z C O | C Z M O Y;U
R O I F B S | B F S I R;O
G P O K Y B | Y P B O K;G
B I A V Z L | Z V B A I;L
Z W I J M D | I Z M J D;W
L X D A K G | K A D G L;X
G E Z K R N | K Z G E N;R
T O K Q M W | K W O M Q;T
E Q K U T J | Q J K U T;E
Z L K O B I | L I B K O;Z
T O Q Y V D | V D O Q T;Y
O Q X K E A | X O K E A;Q
H V Y B W I | B H V W I;Y
Z D X H B O | O X B H Z;D
X M B K D G | X G K B D;M
F Y P I J R | F R Y P I;J
U S F L Y B | L U F B Y;S
V L F S C M | C V F S M;L
I O W F N Q | Q O W N I;F
T C B J M A | T J M B A;C
J T E H V G | J V G T H;E
V S B U D A | S A B D V;U
B K T D Y P | K Y T D B;P
I A H X V D | X I D H V;A
J Q B H C P | P B H J Q;C
R M T J E Z | T M J Z R;E
Z E F B U K | Z E F K B;U
V B J Z Q I | Q Z B J V;I
D R N J K H | J H D R K;N
Z V T B P C | V Z P T B;C
D R Q H C Z | Q C R D H;Z
M W Z F D Q | Z F M W D;Q
I U Y P Q E | E I U Y P;Q
E X W Q M A | W X M A E;Q
L R J U S G | J L R G U;S
Q Z F V N E | E Q V Z F;N
E R B N G F | B G E N F;R
Y W H V J Q | J H W V Q;Y
K D C F Y B | K C B F D;Y
W G C U O R | G U W R O;C
I G A T O Z | A O G I Z;T
G P S Q B T | B S Q T P;G
L P G V K A | V G A L P;K
H S P T N M | T M N P H;S
Z X Y V R A | X A R V Y;Z
A Z H E V M | H V Z E M;A
Q P F U R D | F U D P R;Q
D H E R K P | D H P K R;E
S G X N O R | G R N X S;O
H Y E Z I M | I M H E Y;Z
A P J R V Y | P V Y R A;J
J B M C S Y | B J C S M;Y
I L Y T N U | Y I N T U;L
B F H O S W | S H W F O;B
E F V M X G | X M F E G;V
O H S E T N | O T S H N;E
A I K R S L | S I L A R;K
C S J F W P | W P J C F;S
F D I V L S | I L V D F;S
T U N B Z D | D Z T U B;N
T E A P Q V | T Q P E A;V
T S Z U W L | T S Z U W;L
A D N E S F | E A S N D;F
A O F L K V | A O V K F;L
Z F I S A H | F I S H A;Z
E O Y Z N J | O Y N Z E;J
H N G F P J | F H N J G;P
L M S T K F | F M S L K;T
C R J S B O | J C O B S;R
R D P K X W | P D X K R;W
P D X G M C | P M C X D;G
W Y R N K E | Y E N K R;W
A L K P I M | L P A M I;K
I K G N O A | N G O I A;K
H O J Q E I | J I Q O H;E
Q L R W E G | R G E W Q;L
K X Q J W U | X W K Q U;J
M T Y S B D | B T S D Y;M
U W O X Q J | U J W X Q;O
L P O R D U | L U O D P;R
D E Q A G H | D Q E G A;H
R T K H O C | O R T H K;C
M B I T F W | M T B I F;W
A Y Z K L U | L U A Y K;Z
H X D L Y V | D L H V Y;X
G T E J O F | G F O E T;J
T V B M X K | K M V B T;X
E T X I D F | X F I D T;E
O A H X W F | F W H X O;A
Q E O K S D | D S Q O K;E
O Q B C H J | Q B C O H;J
A P G E O Y | O G E A P;Y
S R M P D X | S M P X D;R
R L M D X F | D R M F X;L
D O U P M N | N M P U D;O
T A J S H B | S T B J A;H
O K E U Z B | B K O Z U;E
O G I Q L X | I O X Q G;L
C T J H S I | J C H T I;S
I N L W A B | B L A I N;W
U K C M I V | U V C K I;M
H T I Y K N | Y K N H I;T
X J C F Z B | Z C B F X;J
N G E T I Q | N Q I G T;E
U L B E P A | B P E A L;U
T M S E B U | U E S B T;M
J O B Q C K | C O K J B;Q
N M K Z R P | K N R Z M;P
N H Y Q F X | H F X N Y;Q
W U R Q V P | P W Q V R;U
K P J N B U | J N P K U;B
L M J N W I | I M L N W;J
W E N M U V | W N V M E;U
W Z P T U X | W X Z P T;U
E J M N Z D | Z N J D M;E
T C V J Y Z | Y Z C T J;V
C G L P Q V | Q C P V G;L
P T B I R M | I R T P M;B
Q O L M N R | L O N R M;Q
F V U B H D | H D U F V;B
T N Y S R A | A R S N Y;T
P G R J H E | G R H P J;E
C G L W E Q | Q G W C L;E
M K W Z B I | M Z W K I;B
L Y A C O N | A N Y C L;O
W S A C O K | A S C O W;K
D Z O F E S | F O Z D S;E
I N Q R V J | R V I N J;Q
J N H Y S X | Y N S J H;X
V N F T P Q | T Q F P N;V
E N S H J X | X H E S J;N
S M D W U P | D S M W U;P
W L R J X A | W L A J X;R
E P F J O S | E P F S J;O
G R T F E L | F L E R G;T
V C X T E I | V E T I C;X
R G A P X Q | Q X G P A;R
G O J W M U | J U G W M;O
L H J R X B | B X L R H;J
Z D X M U I | D U X Z I;M
I N B S V F | S B F V N;I
N J L H W I | N L W H J;I
F K E M D P | P D F K E;M
E S M V G J | S E V G M;J
N P E V C H | H N P V C;E
A K F G Y O | F Y K G O;A
N L U Z Q I | I Z N U L;Q
J Z G V H Q | Q J G H Z;V
A X S H B O | B S A X H;O
J N U E C I | I U E C N;J
L O D W K U | L K O W U;D
R H T V G P | P R H T G;V
E V O Q M C | O C Q V M;E
F B H G X V | X G H B F;V
N R V F I C | N I V C F;R
W K J P G B | P B J G W;K
H Z O K N P | O P K N Z;H
S F O U Y C | O U S C Y;F
N Y T L O H | O Y T N H;L
X V F A U S | A F V S U;X
K R X I Y L | L R X K Y;I
M D O Y S G | G S Y M O;D
W U H D V B | V D B H W;U
Q H K C L T | K T Q C H;L
B I H U Z K | B H K Z U;I
Z J V I H G | V Z I J H;G
M L Z E K U | L M Z E K;U
M Y P K E X | X P K M E;Y
Z R G K M W | G M R K W;Z
A S V U G D | V S D A G;U
P Y O Z W J | J Z Y P O;W
A N O X W T | T N W O X;A
A B C R I H | A B C R H;I
L M G J I R | J M R L G;I
X Y I J F O | Y I O J F;X
P C G E I X | C I P G X;E
D K T X B I | I K B X D;T
M R F A V O | V R A O F;M
A Q K D G F | K F D G A;Q
E T S H J C | S E T C J;H
C B P T U O | P U O T B;C
X A S L F G | X A S F G;L
N W B O F J | B O F J N;W
B X S W G E | G W X S B;E
K B F S T G | B T K G S;F
W U P N R J | U R P N W;J
N U H D S L | D L U S H;N
H Q Z D F R | Z H D R F;Q
D S F H E W | F S E H D;W
Y B A X W O | W B A X O;Y
E O U C N H | E N O U H;C
V B N F K C | B K F C N;V
Y V G H C N | Y C V H N;G
H B O R N E | E N R H O;B
W M H V D F | M V D F H;W
G K E F T W | W K E F T;G
Q Z F X V R | X V R Z F;Q
O L A Q U F | O Q F A L;U
X A L U N J | L X N A J;U
T P J S B I | B P I T J;S
Z H G O I W | G H O W Z;I
R G D M S Z | R S G M D;Z
D C Z Y I M | D Z M C Y;I
C I A Z H S | A S C Z I;H
N D Y R Z M | D Z N M R;Y
V K G Y M E | V E K G Y;M
O U M P F H | P M U H F;O
O R H C Z W | Z R H W C;O
L F B H P M | P B H M L;F
S Y T N M P | M P T Y S;N
Z B O I H U | I U B H Z;O
A E R D V N | A E R D V;N
K Z D V B C | B Z K D V;C
X O N Z C E | E N X Z O;C
M B Z I F N | F N B I M;Z
P X W M D G | D W M P G;X
P H M C Z K | K C H M P;Z
G X Y I R F | F I Y X G;R
G D I A J Y | Y J D I A;G
P V A S G Y | S V G A Y;P
O J X Y H E | X O J Y E;H
T R V J B H | T V J H R;B
P O Z U R X | U O X Z P;R
R N H C Y Z | R C Z Y H;N
D N R O C A | A O N D C;R
R T C W N K | C K R T W;N
V U B H A T | A T V B H;U
U L S E B X | B X L E S;U
G Q J E O F | G F J O Q;E
E B L T D I | T E L D B;I
C S O L Y T | C S T O L;Y
S M W H A C | S W M H A;C
B W H O M V | H W B V M;O
F M N Y K U | K M U F Y;N
V R W F L M | M L V F W;R
K E C N S X | E X N K S;C
L X U S W T | L S U W X;T
H T M O W V | V M H O T;W
O F M T V X | O F X T V;M
F J Y B R G | B G F J Y;R
Q A F L J B | Q A F B J;L
F P T O V B | B V F O T;P
Z P Q R X C | Z P R X C;Q
X M H D N U | H M N X U;D
J P T L Z E | J E T Z P;L
L X Q W G D | G X D W Q;L
X L U C H T | L X U H C;T
J X O Y V N | V N J O X;Y
X Y Z W Q C | Z W X C Q;Y
O H X Y W Q | O Q W H Y;X
A G I P J U | P J I G A;U
I C F V R D | F C V D R;I
G U L C O Q | C L O Q U;G
N A H F Q E | F E N H Q;A
S Q H C I L | L C Q S H;I
A U H Z N D | N Z U D H;A
X C R V N I | R X N V C;I
K Y D C H R | K R C Y H;D
T F X W B H | B F W H X;T
O P G Z H Q | Q Z G P H;O
V W P F H X | W H F P V;X
I F L K J M | F I M J K;L
N J Z S T E | Z N S T E;J
V W J A T O | A O V J W;T
G W X P L Y | W L P G X;Y
K N T E X O | E N X T K;O
D X F E M Y | F X D M E;Y
X V U Z T O | X U V O T;Z
B L A P C F | L P C F A;B
A B P X I Q | X Q P A B;I
L W T Q A M | Q T M A L;W
T W N S Y Z | Z N Y T W;S
A F X N P U | N A F P U;X
I T U M J R | J M U T I;R
S Q F G L J | Q L F G J;S
J O M P T H | H T P M O;J
G K H J Q X | H K Q X J;G
G A I W V U | G U I W A;V
M K Z B G X | K M B G X;Z
U H F C N S | S H F N U;C
S A N X C U | N U A X S;C
Q Z H D J B | B Z H Q D;J
C K H M G X | C K H G X;M
L B Y W Q D | B D Q L Y;W
E A Y Q M U | A E M Q U;Y
G K H S M A | H S K G M;A
L Q I W O R | Q W O I L;R
I B S E J A | S I J B E;A
O B J P W U | P O W U J;B
S K N Z V L | S K N Z L;V
Z N L M Q I | Z L Q N M;I
E M V I D L | E I L D V;M
S Z A M F U | Z M U S F;A
J H O B D Q | Q H J B D;O
O U K W R N | R N U W O;K
V J D I S F | D I V J S;F
N D A T Q U | T A Q D N;U
M V C N F T | T N F M C;V
Z B P Q K M | Z M K Q B;P
Z V L D F K | Z L K F V;D
L E R O K W | K R E O W;L
O X Q C B F | O Q B F X;C
B G L Z A F | B G F Z L;A
Q X U R O Z | U O Z R Q;X
E C Q Z V A | Z A E V Q;C
Q U J V G M | G Q U V J;M
M J W S Z L | S W J L M;Z
C J A O D S | O C A J D;S
H T E P S N | T N S P E;H
Z T S C L Q | Z Q T C S;L
Q O C A W S | Q C A W S;O
F S N C V X | X V N F S;C
Z S O P B L | P O L Z B;S
P A L Q E G | Q G A E P;L
J O Q B V C | V C Q B J;O
E V T K F C | C F K T E;V
V W J U G T | V G W U T;J
Q Y A I F E | A Y I F Q;E
R N J E X T | E N X R T;J
F X Y Q T Z | T Y X Q Z;F
E F J D R S | S E D F R;J
O Q J Y V T | Q O V T J;Y
N V G M B U | V U N M G;B
O B T C X F | X B O T F;C
Q S A W N V | W N V Q A;S
C M T R X O | C T M O R;X
P A W F S U | P A F U S;W
T N Z F L Y | N Z L Y F;T
Z I A Y P R | P I A Y Z;R
N M Z U O F | F M N U O;Z
G R M E V A | E G R M V;A
K G L U S M | S L G U K;M
X V U N L M | M V X L U;N
F Z Y E X S | E S Y Z X;F
A X M T Y R | A R X M Y;T
H V I R C P | H I V R P;C
V M S X A L | X M A S V;L
E V T M K N | V M N K T;E
E U B D Z F | F Z E D B;U
X T V G F R | T R X F V;G
I H D X V A | V H I X D;A
Z N K O R D | D N O Z K;R
L O I Y H F | Y F I O H;L
R C H Q U S | S R C Q H;U
S N O R U V | O U N R V;S
U B T M O C | M U T B O;C
K R C L A G | L K C R A;G
E A N M C X | A C N M E;X
X E D K O T | T D O X K;E
H J F I L B | L B H J I;F
R N B L A M | R A N L B;M
H M B W D A | W A D H B;M
J U K M Q F | Q U K J F;M
H D T W F U | D W T F U;H
C O A Q S I | C O Q S I;A
K H N U W C | H N C K U;W
P N I J K T | P N J K T;I
T O L M P I | O M P T I;L
S B R I C A | B A C S I;R
R B M U H D | D B R M H;U
T M L E S W | E M S L W;T
B Y V J Q T | V J Q B Y;T
V J W M Y L | M J Y V L;W
M T J S G X | X J G S M;T
S D K B I X | K B I D S;X
Z I V A L G | G I L V Z;A
R V A T X W | A R T X V;W
U W C X B S | U B S C W;X
H O I W Y R | H O Y W R;I
H X K Q P L | P X K H Q;L
U C E B L J | B E L J U;C
Q M L X D F | D M L Q F;X
F W L A Q X | X A F Q W;L
Y F M O I Q | I Q Y O F;M
U S V H G J | U H G S J;V
L A Q D V G | A L D V G;Q
W C Q L X T | C X L W T;Q
Z A T V J R | Z R T V J;A
X A Y B U F | Y B A X F;U
X K J Y W L | W X L J K;Y
A P J M K F | K M P J A;F
E T P C W B | E C P W B;T
E K D A C G | E G A K C;D
T W J A H S | H T S W J;A
J M W Q R E | M W R E J;Q
T Y C H A O | H O C A Y;T
C J W M L D | D C L M J;W
C A M Z F N | C M F Z A;N
J F B L U G | J U L G F;B
K Z S O F G | O K S Z F;G
S D K C G Z | S Z K G D;C
T P N X Y Q | Y P Q N T;X
R K Z X Q F | Z X R K Q;F
Z I K A M P | Z I K A P;M
U J I A L Y | Y A L U J;I
T U B S M Y | B Y U T M;S
I E U A Q F | E I A F Q;U
C M Y S X D | S C Y D X;M
W O H C D M | C O M H D;W
B D U P V Y | V P U B D;Y
A K R W P Q | W A Q K R;P
W P X S A U | S U W A X;P
M F I B H Y | I F B H M;Y
I Q S G P W | W I P S Q;G
W L X I H M | L H M I X;W
A P R N Y V | N R V P Y;A
X C N F U V | N V X C F;U
Z B Y W L T | L W B T Z;Y
W Z L S K P | W P S L Z;K
R W S L T O | L T S W O;R
L Z C S Q T | C T Q Z S;L
U O B J L Q | U O L J B;Q
M C S K H O | M C S K O;H
K J T Z L F | K F Z L J;T
L E S O J V | S L V J O;E
G W I Q A U | G I W Q U;A
V J B N C R | V B N J R;C
D H W F X S | F H W D S;X
M R H N Z Y | Z M H Y N;R
P S Q A E X | A S X P Q;E
X P G K T Q | P T G Q X;K
L O W Q I T | T I O Q L;W
B U F G R H | F U R B H;G
B P T W V G | W G T B V;P
D L G C V X | X D C L G;V
B D N S K O | O B N D S;K
U M V A K T | M T K A U;V
W X G N R M | N X M R W;G
Z Y B S K V | Z B S Y V;K
M V T N W Q | Q M V W T;N
Y X D C S R | C R X S D;Y
S O B H V J | H V B O J;S
R S J N U O | R U J S O;N
W Y M O G J | Y G W O J;M
A P C M V Q | M V P Q C;A
G D K I L U | I D U K L;G
O E J G F W | O W J F G;E
G S B J A Y | Y S G A J;B
X V B T M C | T X V M C;B
U P V G R C | V G R U P;C
G S Q O F R | R Q O F S;G
Z T M X W F | X W T F M;Z
S W A U C Q | S C Q W A;U
I P F T E C | P E I C T;F
S W C P K N | W P K S C;N
F O P S K L | O L K F S;P
T Y D S A P | T Y P D A;S
N D F T P B | P B D N F;T
X D E W K P | W D K E P;X
T U G L P R | P G U L T;R
I X H Q Y F | I H Y Q X;F
L V P O F K | O F P K V;L
Y O A F C M | Y A C F M;O
X B A U Z E | B E Z A U;X
R P L O I X | L X O P R;I
M P X J W C | W J P X M;C
I J W A X H | J A H X W;I
H S N I K U | S N H K I;U
T A J Q D H | J D T Q A;H
Q H B Z Y A | B A Y H Z;Q
Y E B G L R | E Y L B G;R
P M N J Z W | M P N J W;Z
E N R H L S | H N S L R;E
C V Z K G M | G K Z M V;C
D H J I V L | H D L V I;J
K P Q G X S | S Q G X P;K
H X J Q N O | Q O J N X;H
O A F D J I | J A O D I;F
Y O A T K P | A K T Y O;P
M A Y P F S | Y S M F A;P
T E X G L I | I E L X G;T
U D W A B N | D U B W N;A
A E Z M B U | B E M U Z;A
U P M C D F | M C F P U;D
Z B U S Y J | Z B U J Y;S
R O K Q T Y | O Y K R Q;T
Y M P S R H | Y R S P M;H
U K H D I M | M D K H I;U
A J Y V Z G | J Z A V G;Y
K I X T M P | I M P T X;K
X N L C S J | L C J S N;X
Z K B I H O | I K Z O B;H
N A C Z J E | N E A J C;Z
X G D B R J | D R X B G;J
B G O H M J | J M O H B;G
L H Z R M T | R H L Z T;M
D M T I P W | T P I W D;M
X M J E W L | W E L J X;M
X O W Q J H | Q J X H W;O
K X F L H Z | F L Z X H;K
I C K X B L | C L B I K;X
G D E F O X | E G X F D;O
X N Q F V Y | F V Q N Y;X
C K F E M X | E F C X K;M
R B V L W H | R H W L V;B
C V Z W M N | V W N M Z;C
F X D G B E | F D E G X;B
F J K O G Z | J G O F K;Z
H Y E S U L | L E H S Y;U
B Z N H S P | S B P H Z;N
W U R D P B | P R U W B;D
R W H L I F | I R F L H;W
I F J B S P | I F B J S;P
F Y X L W D | W Y D F L;X
C F M V U D | D F C U M;V
W I T J D G | J G W T D;I
N P C U I Y | Y I P C N;U
Q K W P S N | S N W Q K;P
T H L R K S | H L S R K;T
V Q A C M P | V Q C A M;P
K Z A F T N | K A T N Z;F
D I K Z Q S | S Z K Q I;D
Y M P I V W | Y W P I M;V
X G L V W A | G X A L W;V
C Z K J T L | T C Z K J;L
E G X Q P O | P X O G E;Q
V J S G Q M | G J Q S M;V
V R S Z I E | Z V R I E;S
U Y C H E A | A U H E C;Y
V F N G E R | N G R F E;V
F G I T J Z | I F J T Z;G
K B C A E N | A E B N K;C
W K Y I M U | I M W U Y;K
N X A Y D U | Y U N X D;A
F U K I P W | I W U F P;K
R G Q I O Z | G R Z O I;Q
C M O P N D | C P M O N;D
R C T P F Z | Z T P C F;R
K N P G Q X | N G K X Q;P
B I Q D N J | I B D N J;Q
U G T D Y E | Y T E U D;G
Q O T J H U | U H Q J O;T
U X C N J M | X J M N U;C
F G U X A O | O X G U F;A
J N Y T Z A | A N Z J T;Y
P H E B M D | E M B H P;D
A W Y C V O | O W Y V C;A
N D O H B Y | O D Y B N;H
A D C Y X Z | D Y A Z C;X
T K B S A W | W T B A K;S
L Z J N I P | I J N L Z;P
I E Y M F Z | E Z F I M;Y
K S D G P R | R S G D P;K
R S Y W B L | R B L S Y;W
T U R C K Q | Q T U K R;C
B S M X Z F | Z M X B F;S
R N A E U G | G N A E R;U
X U G S V T | G T S X U;V
E X I C A Z | Z X C E A;I
S Y R P A W | Y S A W P;R
T D Z V P W | D W P Z V;T
J P L A V B | B P A J V;L
L C N J U E | N J C L E;U
G O H W D Y | Y D H W O;G
C O I S M P | I O C M S;P
F G N P R A | F N A P R;G
R F L Q G N | F R L G N;Q
X N G A U W | N A U X W;G
O F N T M I | O T M N I;F
Q C B O I H | B O C H I;Q
W L X F M J | J F L X M;W
Q O A M L B | O M Q B A;L
Z J N Y X I | Z J Y N I;X
C V W P B K | B C V P K;W
T D P I A V | P A I T D;V
Y R K F X U | K U R Y F;X
F U E Q P A | U A Q E F;P
L K J C U P | P L U C J;K
A G N O P E | E A P O N;G
L E I Y B J | B Y J E L;I
R K J O M I | K I O J M;R
A W T N K V | A T W N K;V
U D G K S Z | Z K S U D;G
H F K Y U Q | H U Y F K;Q
T Q A K O D | T D A K Q;O
S J V K W H | S W K V J;H
I C U X G V | G I U X V;C
X P M W Z V | W M X P Z;V
H T C R Y S | C S H T Y;R
Q U F N G L | G Q L N U;F
C G E F L N | F N C L G;E
F U A J V D | J D U A V;F
C I T H K W | T W K I C;H
O D U N M S | O M N U D;S
Y J V W D S | D W Y J V;S
K X Q N B J | K B Q X N;J
F G X Y U J | Y X G U F;J
J E U V G Z | J G V Z U;E
R I C B S X | X S I B C;R
U T K I E V | I E K V T;U
N K S U P A | S P U A K;N
X O S L V G | S V G X L;O
K M V B L I | B L K V I;M
Q S B R U K | U K R B S;Q
P F E K S N | E S P F N;K
H E F B R D | H B F R E;D
D Y A S N G | G N D S Y;A
K U P F Y D | Y U K P F;D
M C F J H X | C X F H M;J
E H K X T S | H X E K S;T
P A V L S I | L S V A I;P
L M I J G Z | M I J L G;Z
G Y H S P I | H Y G I P;S
T S B Z Q J | S T Z J B;Q
K P B M O Q | B Q M O P;K
I M N S H L | N L H M I;S
U Y D F N C | Y N F D U;C
Q N P A Z I | Z A I P N;Q
H F A P R I | A H I R P;F
S I O A P T | I P S T A;O
V C Q K E M | C K E Q V;M
N U O W T C | W O T U C;N
W T K L P X | P L W X K;T
R Z V N Q E | E Q Z N V;R
E Z H I N W | H E Z N I;W
M S O Q H K | M O K S H;Q
S Y A K M X | K X M S Y;A
Y J Z P K C | K C Y P Z;J
H J O Z B Q | Z H B O Q;J
B A N E K Q | Q N B E A;K
H W I N U D | W I N D U;H
B J Q Y G N | Q Y J B N;G
D K Q T I A | T Q D A I;K
T L A R P H | T R A L H;P
T N C V J S | C J V S T;N
I R X J T L | I J L X T;R
Z Y X E I G | G E Y X I;Z
N I K A L M | L N M I K;A
G C O R I K | R G C K O;I
X W O T H M | T X H O W;M
P E X I J O | O P J X E;I
G U A K V F | G V K U A;F
Q P W D M B | M Q B P D;W
V A L F Y C | Y A L C V;F
Q V W H F I | I V F H W;Q
D Q A H Z Y | D A Z Y H;Q
N Z I F B Q | Q Z N F B;I
H Y E P W N | Y P H W N;E
G U N Z T B | T N U B G;Z
T N I J L V | I T J V L;N
E R M S T H | S M H R T;E
T R B J U H | T J R B H;U
A S W T F K | A F T K W;S
P Q O V A B | Q V B O P;A
K V C L G W | K G W L V;C
M C N U O P | M O C P U;N
O S D V P T | S P O D T;V
M Z Y W D B | D Z Y M B;W
E Y M R S Q | R S M Q Y;E
Z I Q L F S | F Z L Q I;S
Y W K Q E O | Q O E K W;Y
V M L K G C | K G M C V;L
Q D C F L J | F C Q D J;L
Y G V I U Q | Y I V G U;Q
B V A F J N | N F B V A;J
P A D M Y X | X P Y D M;A
B Z Q X J K | J B X Z Q;K
Z Q B X T S | T X S Q B;Z
S K U F Z A | K F U S Z;A
F T V Y O J | O T V F J;Y
I Y F V Z P | I V P F Z;Y
E O Y U H F | H Y E O F;U
N D C I J A | J I C A D;N
E H A K Q N | H E Q N A;K
J V T K L S | V L S J K;T
F K Q A Y H | H Q K F Y;A
F Z S R O C | F C Z R O;S
Y J B K E N | J E B K Y;N
H B S K P O | S P K B H;O
J H V B A G | A B G J V;H
N B F A J P | F A N J P;B
G K Y S Q W | G Y W K Q;S
E Y A Z C M | M C A E Z;Y
Y X U G L J | G J Y L U;X
W V L R N Z | R N W Z V;L
M F C V E G | F V C G E;M
D Y B Z S C | S C Z B D;Y
L B R J Q S | Q J R L S;B
X U N W L E | U E X N W;L
O W R N G I | R W N I G;O
O B L F R H | L R O F H;B
D X L J M S | J S L D M;X
F T W K V R | R F T K W;V
D A Z S J O | A J Z D O;S
G Q O K X R | R O G Q X;K
T Q G O M I | T M G I O;Q
V U M H E A | E M H A V;U
C B J Q N E | B E C J Q;N
R W A E P G | W G R E A;P
K W M O F G | M G O F W;K
A F G K T P | A G K T P;F
R D M O L K | D K L O M;R
U X V W M K | U M V K W;X
W R G F I A | G F R A I;W
R G E X S L | S L G X R;E
P F B Q E D | D E F P B;Q
O Z U F X Y | X O F Y U;Z
U Y O Q E H | H E Y O Q;U
J S U W M O | O S U W M;J
P H R S Z J | H J Z R P;S
J G A Q D R | J D A R Q;G
D M Q P O S | P D Q O M;S
X F U T G Z | T G F U X;Z
X L W O E S | L E O X W;S
B J C I Y M | J M I B Y;C
G E C Y Q O | E G Q Y O;C
B E C J X W | X C J E W;B
G L O I E M | I L M G E;O
E Q F O A S | F E Q S O;A
T L W E U N | U T L E N;W
L H R G K A | A G L K H;R
E X I R C Q | E C Q X R;I
Y N I Z J Q | Q I Z J N;Y
S T Z X M U | U T X S Z;M
G S R Z V W | V Z G W R;S
F X W I J B | F X I J B;W
R J Z B H M | R M Z J B;H
O B E C I A | I C E B O;A
X T L S M I | I M L S X;T
B O N Z T Q | B N Z O T;Q
E G L X Q Z | Q X G E Z;L
R D C K A N | C R A N K;D
P G D E B M | E D B P M;G
M H D J Z G | H J D M G;Z
I K X N Y E | N E X I K;Y
H K T E L J | K H J E T;L
X Z Q N U G | N X G Q Z;U
Q V F G N H | V G Q F N;H
L I B X F A | L X F B A;I
T N X W K O | X O W N K;T
R A C W Z X | X W Z R A;C
L B Z T N E | Z B N T E;L
Y P H I N Q | N Y P Q H;I
S A R T Z K | S Z K T R;A
F V U H T C | C V T H U;F
U E Y S W B | Y U E W S;B
J M S U R T | J T M S U;R
E N Y S Z J | S J Z E N;Y
D F E B P K | B F K E D;P
G C E B T Y | Y G E C T;B
U E B W R K | W B R K U;E
O E J W F H | W E F O H;J
F B H P L R | R H L P F;B
V R O Z B D | Z B O D V;R
N W Y O L S | S L Y N W;O
H Y A D G T | D T Y A G;H
X W Q Y V F | V X W Q Y;F
X A W V O I | O V A I W;X
T R S N Z V | S V R N Z;T
S D F L A Z | A F Z L S;D
B G J D O E | G O E D B;J
H I M W X E | I X E H W;M
V P M U Q X | V P M U Q;X
P V R T O M | R O M V P;T
T K H D O M | K H T M D;O
S C J D K T | K J D S T;C
O A U B R H | H A U O B;R
Y B F I Z U | I Y Z U B;F
R U J K X C | C K J U R;X
K U H S N Y | S N Y U H;K
G W B Y Z E | B G Y W Z;E
H P M V A S | P V M S A;H
L C S T I E | T E S L C;I
X K Q J S C | J K Q C S;X
W Q L E A T | T W L Q A;E
I O E Q T M | Q M I T E;O
U M J L Q C | C M J Q U;L
R W T P H E | R H W E T;P
U Q W E X K | E W Q X K;U
I J D N Q M | M N I Q D;J
B D R O V J | B D V J O;R
H M E L R T | H M E L R;T
Q C K B A J | C J Q A K;B
O J T Q F N | T F N O Q;J
Q P A U Z W | A U Q W P;Z
I V W X K C | X K V W C;I
X A Z Y F G | X G A Z Y;F
U D E G R T | U R E D G;T
D K E R M Q | R M D Q K;E
W R J O Z K | W J R Z O;K
G O X U T H | X U O G T;H
T V C M I Y | M I V Y T;C
G S E X J N | G S N X E;J
D K N R B I | B D K N I;R
B J A E V D | J A V B E;D
K B Y X Z E | X B Y E Z;K
J P M O L U | P J O L M;U
S K T J N M | N J M T S;K
M Q E S N T | Q S T E M;N
G C Q V R O | R V G Q C;O
S W K Q C O | Q W S O C;K
C H W U B G | H W B G U;C
K T E G M C | G T C E K;M
X Q N J L A | J Q L N X;A
H V A N J O | A V N J O;H
Q C E M F D | D M C E F;Q
D X L J W H | D X L W J;H
D M X H N O | H D O X N;M
T I L A J H | J H T A I;L
X T J E Q L | T E Q L J;X
P R X A O D | A X D R P;O
K O E V F L | O F V E L;K
M J I H C R | C R M J I;H
A C K O T G | K G O T A;C
I H Y E B A | H Y A I B;E
N F O D U L | L O N F U;D
U M H R Z S | R H Z M S;U
G P R X U E | U P E G X;R
E T X O D Q | Q O X D T;E
H O X R M E | H E X M O;R
K Z S R L G | K L S R G;Z
W Q P E X H | Q P H X E;W
M V J G Y E | V Y E M J;G
A W M L V Y | A W V M L;Y
R S G W B J | B G W R S;J
E I O Y D R | I Y R D E;O
W M H G A Z | Z M W H G;A
L V H T I J | V I L T J;H
S H Q V T X | T H V Q S;X
C N B I O Z | Z O N B I;C
E X Y F G C | X Y C F E;G
O D L S Q B | S L D O Q;B
J H F K U R | U H K J F;R
T K G F Q P | Q K F T P;G
O S J C R M | O S C R M;J
E P Q U K Y | U K Y Q E;P
S I F L V T | I V S F L;T
V U N G S J | N S J U G;V
A M C I N B | M N I A C;B
A V Y G N C | C A G Y V;N
F J R M S G | R F M J G;S
N I G Y U E | G E Y U I;N
L X F U K P | X L U F P;K
K I U D H J | H J I U D;K
D Q W L U G | Q D U L G;W
B O Q Y X J | X B O Q Y;J
I E Y S W N | N I E S Y;W
H A C K Z V | Z C V A K;H
A X E Q W H | E H X A Q;W
G E C Y H L | C H E Y L;G
W L P A C G | L A P W G;C
P M X E S O | X M O S P;E
Y Z O A U B | Y O Z A U;B
F A Q L I K | Q F L I A;K
T U Y N Q X | Y U T N X;Q
I X R Q P D | P D Q I R;X
G E A C J N | C N G J A;E
S R M H L N | L S N M H;R
W R S K N C | R N K C S;W
T X Y B A E | X A B Y T;E
V K T X W Z | Z T K X V;W
H A J C S Q | S A C Q H;J
I J O K Y S | O Y S I J;K
K R M S I H | R H S M I;K
S O N Q Y A | A O N Y Q;S
C H X S J P | J P H S C;X
H O G R W T | G O H R T;W
V W E S X K | W V K E X;S
O G C F V R | C V G F R;O
R T G P C B | R P C T G;B
I M T Z P L | T M L I Z;P
A H F K P N | P A N K H;F
V R N B Z O | N Z B O V;R
P L U R V X | X R V P L;U
Y B A H I U | I B A U Y;H
K A I O E J | E J I O A;K
I S D K B M | B K D I S;M
L I Y V Z E | L V Z I Y;E
M U H E Z T | U Z M T H;E
Y W D P T Q | Y D P W T;Q
E B O U A P | B E P A O;U
M H C J B A | J B A M C;H
Q G U P D C | C Q D P U;G
P A F V Z C | V P F C A;Z
K B N Z V J | B K N Z V;J
T N F J H M | T M N J H;F
Q G D F A S | S F G D A;Q
B E V F W X | F W E X B;V
B P M R O E | M P B E O;R
Q Y F E B L | L B Y F E;Q
I N M S V B | N S V I M;B
J K Y R B T | B T K R Y;J
W L U H Y T | Y H W U T;L
R D A L J T | T D J A R;L
R A E J U Z | J A E U Z;R
B T N H Z I | Z H I N T;B
E R N C Q T | N E T Q R;C
X Z N E B C | B X Z E N;C
D K P F E O | E D K P O;F
X R P S D H | X H R P S;D
H M D J N G | G D H J N;M
A D R G V P | R A P D G;V
T H W L Y K | W H K T L;Y
B J X Z V Q | B J Z X Q;V
E T Q H V K | E H Q V K;T
Z E P W Y O | O W P Z Y;E
D Z P A U T | U P D Z T;A
S B R U M T | U R T B M;S
D M V C O N | O M D V C;N
O N K Q L Z | Q Z K N L;O
C I Y X V T | X V Y T I;C
M C P X J D | P D J M X;C
E R Q J K N | K N E R Q;J
H F Y L B D | L D Y H F;B
R J G O W H | R G J H O;W
R M Y U L C | U C Y L R;M
E J R W G I | R E W I J;G
U F R B T C | F T B R C;U
M I R N K O | O N R M K;I
W F X K J O | K J W X F;O
O M R L X Q | R M O Q X;L
I G B O N P | P I O N G;B
P N H Q O R | O Q R P H;N
P J A Q V X | A P J Q X;V
Y D N H Q I | H Y D N Q;I
G C I R M Q | M R Q I C;G
D O A E S I | I A S E D;O
D H K O E Z | D E H O K;Z
F M A U P B | A P U B M;F
W E D U S L | D L S U E;W
U P T Y C N | C N Y U P;T
M Y Z E R X | E M Z X Y;R
U X F N T Z | X T F Z U;N
I B M L J E | B L E J I;M
D N G J X F | G F N X J;D
V A X Y B T | T A Y X B;V
Y M W V P H | H M Y W V;P
Y S T M C H | H S Y C T;M
I J B L Q S | Q L I S B;J
E F A J B R | R J F B E;A
H J B G M F | J B F G H;M
O T B Q S I | T S B Q I;O
A G X N M L | A L N X M;G
L A M W E D | D A L W M;E
B I H V L D | L H V D I;B
M A Q K Z U | A Z K Q M;U
R J X O H B | R H O X B;J
E T Y U G P | T P E Y U;G
V O H F M S | S M H V F;O
I F C N E V | F C I V N;E
M L D J H N | M J L D N;H
D K Y L X M | D X L M Y;K
M S U C O G | O U M G S;C
F A W G V E | G F W A E;V
J W H F R U | F W J H R;U
C E R K Q D | K Q E R D;C
J S N T U L | L N T S J;U
F T W G O H | T G W H F;O
F T Z A G N | T N G F Z;A
M N Q H O S | M N S H Q;O
R C V N Y Q | Y R N Q V;C
N H E U X A | X H N A E;U
J R I V W G | G J R W I;V
X H E G K N | K N G X H;E
Y J S A X Z | A J Z X S;Y
J H K E P W | E P K W H;J
J K S H Y D | K H D S J;Y
M K I L T E | T K L I E;M
K Z U O E H | Z K U O H;E
P R F B T M | P R F M T;B
V Y I C M N | M N V I Y;C
M X V D C O | X M V O C;D
F S I L W A | A S I W L;F
A Y J Z X B | Z J A Y X;B
H S L A J E | A S L J H;E
S X T Q Z U | S Q X Z U;T
C L N Q H M | H L N M Q;C
J N E B V Z | E J N B V;Z
Q L W H K I | K Q I W L;H
O B Q K H L | O L H B K;Q
X M L K Q Z | Q X Z M L;K
J S I O U F | I J S U F;O
M E T Q C P | T C Q M E;P
S H P M E X | M P S X H;E
E C M X B O | X O E C B;M
Z F L H B W | W L F Z H;B
R Z A X G M | A G X R Z;M
Q I A W N G | I G N W Q;A
W Q I P E F | Q E P W F;I
L I M G Z W | G Z L I M;W
O J I W Z N | Z I J O N;W
D T L P Q F | T P Q L D;F
S J H I D P | P S H J D;I
P F A H X Q | Q A X F H;P
G A C O X K | K A O G X;C
N M B G U T | U T N M G;B
Q C K M X E | M K X Q C;E
T R M C P Y | R P C M T;Y
K X T Z V B | B K X Z V;T
A Y O H N G | O G A H N;Y
T V D A H N | A V D N T;H
Z S T F B E | B E T Z S;F
K N X V O Q | V X O Q K;N
A W L J B T | T A L B W;J
M X Q Z E D | M Z X D E;Q
T I P C K O | I C K O P;T
N H T U K J | H K N U J;T
P X V A Q J | V P X J Q;A
F Z J B D E | F Z E B J;D
K Q G U Y A | K Y G U Q;A
P U R K X Q | X K P U R;Q
G X D B W I | I W G B D;X
Y T D N S F | S N T F Y;D
O Y J F L E | E F O L Y;J
B W E J Z D | B D Z J E;W
B A U N D C | A U N B C;D
O Y H V K E | K V E H O;Y
U L G F S V | U F S G V;L
N C Z Y I B | C N Z Y B;I
M D Y H B T | D H T Y M;B
A Q Y W J T | T Q Y W J;A
G N C O K Z | Z N C O G;K
Y P V A E D | Y V P E D;A
W J M Z K A | A Z J W M;K
L Y Z V K A | L Y Z K V;A
M W A R N F | A W F M R;N
Q E F T U A | Q U F E T;A
H L N C P J | N P C H J;L
W D R E X C | E D C R W;X
J G B M O U | B U O M J;G
U S K C E I | U E I S K;C
A B Z F N R | F R N Z B;A
A N V O Z B | O N A V Z;B
K J U R N E | E J K U R;N
S D W G O C | C W D S O;G
B M E Y C K | C Y M B K;E
I T W H L R | T I W H L;R
T Y W C D Q | Q T W D Y;C
H I Q J T Y | H T Y Q I;J
A V F L I D | L D I F V;A
Y G M K F D | D F G K Y;M
G P K X L V | K L X V G;P
S A D O P Y | D O P S Y;A
P M R O H Q | Q M O H R;P
P A K T D X | T A P K D;X
L T B R G O | R L B G T;O
D I L B G J | I L B G J;D
W F Z Q Y E | F Y E Q Z;W
O R Q X N G | X O R N G;Q
B G Y Z F S | F B Z S G;Y
P Y C U I M | Y I U P C;M
P F D J O I | D J O P F;I
N P O X W E | W X O E N;P
Q T G N W M | G W Q M T;N
C Z Y V A Q | Y A C V Z;Q
C X A Z Q D | D C X Z A;Q
D J Y G R B | Y B R D J;G
V A P I F G | G P F V I;A
K E N Z Q F | F E K Q Z;N
F Y W G N E | Y N F W E;G
X S K B E O | B S K E O;X
K A G I O T | O A I K T;G
L F W S C K | K W C F S;L
U Z W R K M | K R U M W;Z
V R C F I U | U I R V F;C
Q L Z W B G | W Q B Z G;L
Q U N B J Z | Z N B U Q;J
Z O T U D H | T U O H D;Z
T N B V C J | N T V C J;B
U C X N K A | N A K C X;U
I G U R A D | D U A I G;R
D F A Q R S | Q F R S A;D
U H I Y Q Z | Z Y H Q U;I
O D Y K Z X | Z X D K O;Y
H T L D J V | J D T V H;L
Z L G J C F | L Z G J C;F
U Y E T G F | F G U T E;Y
C V A E B K | B K A C V;E
J Y G O M Z | Y Z M G O;J
Q D Y V S E | Y E D S V;Q
G K E P X N | X N G E P;K
J W D N F P | N F D J W;P
L S N Y E C | Y L C S E;N
I Z K Q O S | Q Z S O K;I
G L X B J M | G B J X M;L
M Y F O H I | H I M Y O;F
K Q H X B J | B K X Q H;J
F A U G O S | F A G S O;U
I Q U Z W G | Q G W I U;Z
M W H Z X S | S M H X W;Z
F S R N E H | R F H N E;S
O T L B U S | O B U T L;S
H B P Z F G | P G H B F;Z
G L K D S C | K D L S C;G
W X S G O V | S O V X W;G
I A Y N M Q | A M Q Y I;N
Y F D A O K | D F Y O A;K
H W G A E K | A E H K W;G
J F R T P X | P R X T F;J
C V F I N Y | N V Y F I;C
U K Q M T O | U M Q K T;O
F K C G W Y | C Y F G W;K
Z Y J X C T | T X Y Z J;C
D Q B R X Y | D Q X R Y;B
L D I H Y C | L I D Y C;H
C Q I F H O | I F Q O H;C
B E S O A J | A B E S J;O
Q T Y E S P | P Y Q T S;E
I W Z O Y V | Z V Y O I;W
F I E A L X | X A I F E;L
C U P H G J | U G J P H;C
Q V B C P U | P V B U C;Q
S Y N E K D | D N S K E;Y
J C Z W Y F | F J Y W Z;C
F I T N R L | L T I N R;F
I N W X Q J | I J Q W N;X
F B S N M E | B M S E F;N
K F D E T O | F K D E T;O
P X D M K A | K M D A P;X
W A Y O Q N | Q Y N W O;A
K W U N R D | K N U W D;R
E U S L R D | L E U S D;R
M V N B D Y | M N Y D V;B
P C J F M I | I M J P C;F
K N H U I O | U H N O K;I
S D Q O C F | D O C S F;Q
I E R Y S M | S M E R I;Y
W G R K L U | K L W U R;G
J E Q S H P | P S Q E H;J
B V Y P D T | V P D T Y;B
F I N D Z O | Z I N O D;F
N H G R M U | R G N H M;U
C U O I H S | H I U C O;S
M E Y I X T | X E T M I;Y
N E M T D W | M D N W E;T
L B J A R U | U B A R L;J
R W G L Q B | Q R W B L;G
U M W V J Z | V Z W U M;J
J C B V A S | C V B A S;J
X J Z Q I P | J X Q Z I;P
M H T N J Q | H Q N T J;M
N X D S T K | S K D N X;T
V E M Z B H | V H M B E;Z
D H S Q G Y | D G Y H Q;S
N O J P B T | O N P J B;T
X F P S O E | P F X O E;S
D U V Y A C | C V A Y D;U
R I K F P X | I K R F X;P
A K R O E M | E R M K A;O
W Q C Z F Y | Q W F Y C;Z
F Y A C X T | F C A Y T;X
M P Z W O H | P Z M H O;W
E X M Y Z H | Z H Y E X;M
R B Y C X M | B M X C Y;R
V S T R B G | G T B S R;V
N S D O R Q | S R N Q D;O
W E M J H D | W D M E J;H
M J S F Q A | F Q J S M;A
W L S X Q R | L X W S R;Q
I M K Z N L | I K N M Z;L
B D K U Y M | M D K Y B;U
J D I P Y W | P Y I W J;D
M F A K S O | O S F A M;K
G D W S O N | S O W N D;G
C A X W T O | C A W X O;T
F V S D C B | F V C D S;B
U K L G I Y | G Y L K U;I
K A M P F Z | M P A Z K;F
G K S A F L | S K L A F;G
A M P N U D | U P D M N;A
J Y H G P R | J R H Y G;P
W T G R X F | F T R G W;X
C T J R D S | C R J D S;T
Y W D N C T | W Y T N C;D
E X A G V C | E C V G A;X
O R T U S I | T R O I S;U
A B O N M K | A N B K M;O
N V S R J F | S R V F J;N
J X C E V H | E X V H C;J
J O K P V H | K J P V O;H
F P D W T N | T P W D F;N
S D O P Q B | S P Q D B;O
B E G R A J | E R B G A;J
T R S C W X | W R C X T;S
O Z C H Y A | O C Z A Y;H
F M H E D O | D M H F O;E
W E X Y U G | Y E G U W;X
I D M Y C H | C H Y I M;D
Z G O S Q H | O Z S Q H;G
Q G D S P X | X S Q D G;P
G L H Y E C | H L E Y G;C
Z X Y A P U | P U X A Z;Y
Y F V N C D | V Y F C N;D
F P R G Y L | P Y R G F;L
S W A K E I | W E A I K;S
J Q M C T L | Q L C J T;M
D M Y I N L | M Y I L N;D
D G W B A J | D G B W J;A
O K H S U L | H O S L U;K
E Q F A D U | E A Q F D;U
O F P S I R | S I P F O;R
B H W P L T | P W H B T;L
K D H A W E | D K E W A;H
O I T D Y Z | Y O I T D;Z
L W F K U N | N U F W L;K
B T G I F O | B G I F T;O
K H U Q G M | M U Q K G;H
Y U C K R M | Y M U C R;K
W C H G F L | G W F L H;C
S E H P X V | E X P S H;V
A J P M C O | P C A J M;O
C R Q W I J | I W J R C;Q
K Y B P U S | S Y U K B;P
X V G J U Y | X Y J U V;G
S T J W V Q | S J Q V T;W
T U M R D B | M U B T D;R
T C I L Q E | I C L T Q;E
Y U Z X T H | H Z U Y T;X
N D K T Y Z | N Z D Y T;K
E T F I U L | U E T L F;I
T E V S Y H | E H Y S V;T
K L X B Y A | K L B X Y;A
O G Q J S W | Q S O W G;J
L G S R A J | S G A J R;L
K H A R Y J | Y A K J H;R
S A O W P H | H P A O S;W
F K J D G A | F K G J A;D
P F G A B R | B G F R P;A
F E T V H I | I E H V F;T
N E B W T G | E T W G N;B
Z T B Q C R | R T B Z C;Q
D K O S Q T | O D Q K S;T
O V D F I Q | O V Q D F;I
I G D X V C | X G D I C;V
B V U I D T | U T V D I;B
B O W I J U | B O I J U;W
G D U N J W | D N U J W;G
U I Q D K V | K Q U V I;D
W I B H M O | O W M H I;B
Z R L P F S | P R L F S;Z
Q B I Z L U | Q Z L U B;I
C T U B O E | O E C U B;T
L P C X S H | L C S X P;H
S X I A G Q | A Q S G X;I
H O R V M T | H T M R V;O
J W A R Q C | W R J Q A;C
F G U W V M | M U V F G;W
S D K W Y M | Y K D M W;S
J U Z X S F | J S Z U F;X
O N E S V W | E V S W O;N
W P R B Y D | P B Y W D;R
O J W T E Y | E T J W Y;O
V F A N S E | E N A F S;V
F E S U W P | F S U W P;E
S E R U M G | M S U G E;R
S Q O K W Z | O Z W K S;Q
A N W B O F | O F B N A;W
X D T G S O | O D S X T;G
E N D H O V | N D O E H;V
W B C Z F Y | F C B Y W;Z
U N E T Q X | E Q T U X;N
M L Q I N J | J Q M I N;L
B M H V P F | M H F P V;B
F X Z Y W P | F W P X Z;Y
N P R Z O T | T P O Z N;R
I C X L W V | V I L W X;C
H T M D K X | X D K T H;M
X D W Y K B | W K X B D;Y
Q O H U R B | B Q U H O;R
I V H O J Q | O J H I Q;V
R Z D V O S | R S O V Z;D
X N J I T Q | J Q N I T;X
P G E I C V | V E C G I;P
U Y N T C J | T C J N U;Y
S T V L G A | A G S V T;L
Y S K P E A | E P Y K S;A
Y E J N Q B | B Y E N Q;J
M X N K V A | A N V X K;M
F S E A D Z | S Z E D F;A
V I K O Q U | U Q I K O;V
N Y W S T A | N Y W A T;S
L E M C G V | V E C G M;L
R V O M H E | M O E H R;V
Q X B Y N F | B F Q N X;Y
L Z N W R P | N R L W Z;P
M F O X Q J | M J F O X;Q
R T J E O N | E J T R N;O
L R V H Y U | R U H V Y;L
A W U Y T M | U A Y W T;M
Y A K H S T | S A Y K T;H
K A R C T U | T C R A U;K
Z E D H N U | H U N D Z;E
K P A R V S | K A P V S;R
A R D N O J | R N J D A;O
Z V F H S M | Z H M V F;S
Q M E A U N | U Q N A M;E
T K C V R U | K T U R V;C
Z X K R U I | I K X Z U;R
H O A G P Y | A P Y O G;H
Z L S W O X | O L S W X;Z
M O G Z E N | G N M Z E;O
I A F H C J | H C F J I;A
L P G W Q D | W P D L Q;G
E H A C W R | W H A E C;R
X Z L P A U | L X A Z P;U
Q W N F V O | W V N F Q;O
U N V K I Z | K I U Z V;N
N C P Q U E | E P N U C;Q
J V N Q C E | C V J Q N;E
V R A S H Y | S V H A R;Y
E A C S Y D | D E S Y C;A
A G J Y M C | A J G M C;Y
T G R I N K | K T I G R;N
N X A L D H | N X H A L;D
U B G J I K | I K B J U;G
I L C S R T | C R L S T;I
A C I J K N | I N J A C;K
L G I D W K | D K I L W;G
B L G T W O | T L B W G;O
C W U Y R V | W C Y U R;V
Z L D Q H I | Q D L Z I;H
I K S C F O | O C S I F;K
L B G K H I | I B G L H;K
G P F Q N H | Q P F H G;N
B Z J O C V | C Z J B V;O
U M L Q H K | Q L H U M;K
Y V A E H J | J V A Y E;H
I B Y O N K | K N O Y B;I
B Y H W D A | D W B A Y;H
C S W E D T | W T C S D;E
Q D C U F Z | C U Q D F;Z
F A T E I U | I U T E A;F
N K F S Z X | K N F Z S;X
H F P G A K | H G F A P;K
A Z Y W T L | A W L Y Z;T
E M D Y U K | E M D U K;Y
K T U J W N | N J W U T;K
Z L I M F H | F Z H L I;M
T G B L Q W | G L B Q W;T
L D R E V J | J D E R V;L
K O S C E T | C S E K T;O
W D E R N V | V N W R E;D
T V N C G X | T X C N G;V
S R T W O J | O J R T S;W
Z R K N V S | V N R Z S;K
G S V N H E | V H N S E;G
Y O C A T B | B C Y A O;T
A E B V C Q | C A B E V;Q
Z O K L Y B | B L O Y K;Z
M T C N F J | N C J T F;M
F H O G M E | H G O F M;E
O T M Z W S | Z O T W S;M
U G F M I E | I G M E F;U
X H V W K J | V X K J H;W
D N E X L K | K D X E N;L
K A T V J Y | T Y J A K;V
J F P R O C | O J C F P;R
F G O D C Y | D F C G O;Y
O T L E K R | K L T O E;R
Q X A T L P | A X T L P;Q
O S Y K N P | O Y S N K;P
W H R X I B | X B R H W;I
I C H U E O | I O U E H;C
L J G X I R | I G R X J;L
O B I P Y X | Y P X B I;O
L A F O N B | F B A L O;N
R S M H G U | U G S H M;R
C P R D X N | P X D C R;N
B N X P L O | X O N B L;P
Y S T D U X | S T Y X D;U
P D F X G S | F D P S X;G
U V P N Y W | V N Y W P;U
K X Q M D S | X Q K D M;S
U X L Z H Q | L H U Q Z;X
C U R N K Y | Y R K N C;U
K X D C P O | O D X P K;C
Z X I V Y G | G I Y X V;Z
I E K R V L | V R I E K;L
G C U F B W | B W G U F;C
B Z C E M U | E B M C Z;U
I C X M H Z | Z X I C M;H
U W F S E Z | Z F S E W;U
W D M Q J T | J T D W Q;M
M P O K A X | A M O X P;K
D W K B O X | O W K D B;X
J A E Z H Y | Y A J H Z;E
X I R M V D | M R D I X;V
H J O L X Z | J H Z O L;X
Z D K A F J | Z J K F A;D
T Z R S P A | R T Z P A;S
S O J Z K C | S Z C O K;J
F A K Y H B | H A F B Y;K
M F Y N T Z | F Z Y T M;N
Y V O N P G | V O P G N;Y
D B Q Y L R | L Y Q R B;D
J Z T G D V | Z G T D V;J
M B A P Z G | Z G P M B;A
M X J N Z L | X J M N L;Z
U Q L D T N | U L T N D;Q
M S O N W V | W N O S V;M
S J B Q V C | S C Q V J;B
N J R P Z S | Z R S P N;J
I B H W V S | V W S I H;B
I N C Q T V | T C Q N V;I
Q I C K Z U | U C I Z Q;K
N F X K Y W | K W X Y F;N
F Y Q U W T | W Q Y F U;T
S C B H O V | B V O H C;S
Z Y N V B D | B Z D V Y;N
N B C P V I | V I B C N;P
M I A O Q N | N O Q I M;A
W F O Q P D | O Q W P F;D
G O Q S V B | V B G S Q;O
X Q K U M R | M U X K Q;R
N M J Y T W | J M T N Y;W
M L P V O J | M L J P O;V
R U C M V T | U V R T M;C
G U R J L F | R U L F G;J
A P J S G V | V G P S A;J
T E I Z N F | F E Z T N;I
R F X G L Q | F G Q R L;X
R H M Z Q K | R Q Z H M;K
P Z T I D E | P Z I T D;E
S L Y H G R | Y L H S R;G
E M V F A C | V M F C A;E
P Q G D C M | Q G D M C;P
U H N V X D | H U D V X;N
K H I J V Y | J I H V Y;K
D E P H V O | E P O D V;H
F Y A O W M | Y W F A M;O
U R Y O F C | C R Y U F;O
O F Z I R M | Z F I M R;O
U J B K T L | L J B K T;U
O C S N X A | O N C X A;S
B K H Q Y J | Y K B H Q;J
P D W V A Q | P Q D A W;V
S I G Q R N | S N Q R I;G
C T E L P Q | E T L P C;Q
L B F T O S | S O F B T;L
T A K Z I Y | Z A T K I;Y
Y A L K H W | W Y H A K;L
P I D W O A | P O I W A;D
C Q O A M B | M Q O A B;C
V D F Z W G | W F Z G D;V
Z N I Q E K | Z K N I Q;E
O S W N U G | G U N O W;S
M R Q U J A | U Q A M R;J
R C B W Y N | R N C W Y;B
F B U L K S | S K L U F;B
V Z Q E X F | F E Q V X;Z
H Y W M D O | W Y O H M;D
E D K R A S | R S A D E;K
R A S N B O | R O A S B;N
U R G S Q Y | R Y S U Q;G
P L B U M Y | B Y U L P;M
T M A R D S | D S T A M;R
M A I S H Q | H I Q A M;S
O G H D Q V | D H Q O G;V
J O Z R F N | F R N O J;Z
S U E P Q D | U D S P E;Q
H I J C O L | I O H J C;L
U J Z Q F I | J U Q Z F;I
G H Y O F W | H Y F G O;W
D L P S E N | D E S P L;N
K A F M T O | F A M K T;O
N L G X K E | N L X K E;G
J C B S T E | C J T E B;S
K P H R E V | K H E V R;P
D K B O S V | O K D V S;B
N X H W C S | C X S H W;N
Y E P G X F | Y G E P X;F
Y L W A F J | F Y L A J;W
K P D W E H | E K H W P;D
L K T Y H F | K H T Y L;F
A W D L K C | D C W L K;A
Y B C M W D | W M B D C;Y
J C I X Y D | J Y I C D;X
A T D F I K | T K I F D;A
X I U F S O | U O X S F;I
X V C W P L | W P C X V;L
I G R U S K | I R U S G;K
G E F A J P | J A P F E;G
P Q I R U S | Q I U R S;P
Y X W S E P | P E X S W;Y
O I N Z B J | N Z O B J;I
J G S Z H N | H N Z J G;S
A V Z E Q O | A Z O Q E;V
N O E Q U K | K U O E Q;N
U K O F H T | H T K O F;U
T R U L Q I | L Q T R U;I
W B A Q K N | W Q B K A;N
U I P T F L | U P L F T;I
D Z G K O Q | K Q D G Z;O
K W U Z T C | C W U T K;Z
D R W E A L | A D L W E;R
S P W X H D | P S X W D;H
H P O L V Q | L Q O H P;V
G X U J E S | G X S J E;U
R A X S G H | X G H S A;R
M S V Z H Y | Y H S Z M;V
H Z Y J V C | Y C H Z V;J
B E D H C R | E B D H R;C
T V H Z Y R | T Z H Y V;R
T S F H D J | J S H F D;T
D S H A P U | A P H S D;U
E H P U R S | H U E S R;P
N B I M G P | N M G P I;B
Q C K F Z I | Z Q F I C;K
S D P Y U X | D Y X P S;U
C E J U D H | E U C D J;H
F O C Z J P | J Z F C O;P
N V Y B R D | B V R N Y;D
Q M O B V H | V M O Q H;B
I L F N M B | L N B I F;M
T G V F P E | P V T E G;F
J N D E A W | N W A J E;D
Y C I T N H | N T H I Y;C
W K M O R N | O K M W R;N
X L T Y B G | X T B G Y;L
S A X O C G | A S C X O;G
F J L V O C | F J O L C;V
F H Z U X T | T U F Z X;H
X D G L Z Y | Z D Y G L;X
G V D E F Q | D G Q E F;V
P B N T K O | K N P B T;O
O T U W G Y | W G U Y O;T
S M V L N Y | N S V L Y;M
U N L F H O | N L F U O;H
O V D M R F | V F R D M;O
E W J F A P | W E F J P;A
N Y U C V B | Y N U V B;C
I N Z K J P | P Z J I K;N
V G A U T K | T A G U V;K
B V Z Q E K | B Q V E Z;K
N Z R P K Y | Y K N P R;Z
B I Z H O F | F I B H Z;O
A O Y X N B | N B O Y X;A
S Z Q O M A | A S O Q M;Z
B R U A S Z | U A Z S R;B
A O V M C N | O N V C M;A
A G W K F D | K F A D G;W
Y W T M L V | M L T V W;Y
Z Q H T D C | Z D Q T H;C
A K N V S R | K A N R V;S
M Y B C N J | B N J Y C;M
A Z B E U W | B U Z A E;W
I W N J Y D | Y J I N D;W
R M Q I H C | R C Q H M;I
D V T E X L | E L T V X;D
Z O U Q E L | Z U O E L;Q
P O S L N A | O S L A N;P
E A L T S R | T R A L E;S
G I Q X O Z | X G O Z Q;I
D L P F S K | D S F L K;P
G A Z P N E | P N G A Z;E
O I N H W C | W O H C N;I
C R B K D I | C D R K B;I
Z F N Y C S | C F Z Y S;N
U G P Q A X | P Q U A X;G
H O C D J Y | J C H O Y;D
D P A C F R | D R C A F;P
E U X A S J | S A E U J;X
P X F M L O | F M X O L;P
Z D G J B Q | B Q G D Z;J
R D J E Z N | J N D Z E;R
J B H Y G E | H E Y G J;B
J L E M V K | J V L M E;K
H M N B P D | D M N H P;B
P O N E U H | P H E O U;N
I D Y A P H | A I Y H P;D
F B D X H K | X B K F H;D
I Y E V J O | O V Y I E;J
Y F U M S H | U H M Y F;S
Z Q U O Y G | G O Q Y Z;U
K Z J N L G | G K J Z N;L
Q Z E W T G | Q W G T E;Z
S E L N W R | N W L E S;R
G N C R D A | D R N C A;G
T Q U S F I | S I Q F U;T
M Y W L O I | L Y O I M;W
S C L K U A | U K L A S;C
F Q X L R P | Q L X F P;R
O G I R E M | O R E I G;M
W V M H R T | R H V W T;M
S K O X H N | N O H X S;K
L I C W B E | C L I E W;B
Q A O U I X | I U O X A;Q
W Y P U K I | W Y K P I;U
E G K H Y A | A K Y H G;E
X I G N Y J | N I Y J G;X
B H Y F N S | B Y F S N;H
T W G Y R Q | Q G W R T;Y
F M C Z K N | C M N Z F;K
D G Y Z O V | Z Y V G O;D
J T H M U L | U T H J L;M
F E R H S M | H E R M S;F
Q A L B D W | B A L D Q;W
F U N C E K | K F E C U;N
K E W X M Y | W X Y M K;E
W M S B V T | V T B M S;W
O D Z Q M N | Z O N Q D;M
S Y X C G P | Y S X C G;P
A I N H Z F | H N A I Z;F
M T H C U X | X H T M U;C
L G V Q P R | L P Q G R;V
I C G U E W | I W C U G;E
M U X L O Q | M Q L U O;X
W R U N V F | V U N F W;R
C B Z D F V | F V D Z B;C
D Y X N B J | Y J N X B;D
E K S O X J | K J E S O;X
V L S R N I | N R V I S;L
B U S R E L | U S E B R;L
N G Y J S W | N G W J Y;S
N H R S T Q | T N R S H;Q
U D O J S Z | U J S O D;Z
U A D R Q I | R I D U A;Q
C J M B A P | C M B P J;A
F V T L J G | T J V G L;F
H M K Z P N | P N K M Z;H
K I J C W O | K W C O I;J
F Z G P J Y | J G Z P Y;F
S Z U E H A | H E A Z U;S
Y T K J R O | K J T Y O;R
M Q Z K T W | T Z K Q W;M
K B V T L G | G T B V L;K
S U B H R T | R B S T U;H
M W P C Y L | M W C Y L;P
M I N S Q E | E S I M N;Q
V U B G P L | P B U V L;G
S Y M X G K | S X G K Y;M
V Q B D E H | H D E Q B;V
V I M Q D O | V Q D M I;O
M E A N C U | N A C U E;M
X G R B O E | G B E X O;R
D W U Y B S | D U W S Y;B
B F A X O C | C O A X B;F
A I V C N G | V C N G A;I
D J C S Y A | S C J D A;Y
T J F N Z E | T Z J E F;N
L F N C S T | N C T L F;S
X I Q Y B N | Q Y N B X;I
Z E J S C N | C Z S J N;E
C N D Q Y K | C K Y D N;Q
B O L F R E | E O L F R;B
P D O M I G | G M P O I;D
M L G I T P | G I T P M;L
A K W X Q M | K X M A W;Q
H M P V F L | V P L F H;M
D S C Y A Z | A D C Y Z;S
I Y G P V U | U G P V Y;I
Z R N H P T | N Z P H R;T
X J K G N T | X G T K N;J
K O P L D S | D O K P L;S
U K N A I D | D K U N A;I
Q L G N I X | G Q X I L;N
I G A K M N | M G K N A;I
P M G H D R | D H R M G;P
R A P Y U J | U P A R Y;J
R P G L A B | P B L A R;G
M I Y S R T | R S T I M;Y
J B E F I C | B C F J I;E
H N O T D K | D O N K H;T
O H T C K D | C O T D K;H
U F Z R Y A | Z A R U Y;F
V H X R F A | R X V F H;A
F I W G B L | W G F I B;L
T D X K R F | D T X K F;R
E A Y C B S | Y S B E C;A
H C U W B P | P U C B W;H
L R Y M W B | M Y L B W;R
Y Z X M H V | Y V X Z M;H
S X L A J M | S L J M X;A
O K R S J A | R A K J S;O
E X Z K T D | E X K T D;Z
O F Q L G V | F L O G V;Q
G X B E N U | E U G X N;B
Z I E V P Q | I E Q P V;Z
N C R P B U | R B P C N;U
O F V W Z K | F K Z O V;W
P A C M D X | X P M D A;C
V S U N Q M | N Q V S M;U
J B E R V H | R H B J V;E
N O U Y I L | L Y N O U;I
G E U P V C | C G V E U;P
U N J K L R | R J N U L;K
L U O V H F | U F V L O;H
I L Y S N A | Y L I S N;A
U I X A E R | I R E X A;U
M F W J N E | E N W J M;F
F B V D Z H | V B F D Z;H
M Y N I R L | M I R N Y;L
Z A N M X H | Z M A N X;H
U Y J W P O | J Y P O U;W
J K B D Q I | J D K B I;Q
Y Q E J L D | J D E L Y;Q
D G F A W K | F D G A W;K
Q Z A V T C | V C T Z A;Q
X T U D I H | T U I X D;H
Q S V N J K | N S K Q V;J
O Z D S G B | Z O G B S;D
K B I W H S | B H K I W;S
I W V D Y B | I V W B Y;D
M P Z S A C | S A Z P C;M
H P S W L E | E H W L S;P
L Y A N K Z | N Y L A Z;K
E Z H W J O | J H Z W E;O
Y V K U W O | O U V W Y;K
F X L B Z M | L M B X F;Z
M J L T G X | J M G T L;X
Q W V T I S | W S V I Q;T
X V Y A M R | Y M A R X;V
C X P R D Y | Y D X P R;C
V Z X E N M | X V M E N;Z
U J X W B I | X I B U J;W
B Z C V J H | H B V Z C;J
O F I Z R E | R E O F I;Z
Z W Y I U P | W P Y Z I;U
P O J G W Z | W J G O P;Z
L C I R N B | C L N R B;I
P H K U M L | M L K P U;H
F D J P B A | A D P F J;B
N T X O G J | O T X G N;J
X D T V U I | V U T I X;D
P H C U K I | U P I H K;C
T H Y R V I | V Y R H I;T
N D E R X Y | X E R D N;Y
R Y Z G E U | U Z E R G;Y
K L A S B C | K L A B S;C
D P H S T V | V T S P D;H
V W Z L J G | L Z W G V;J
X W L J K M | M K L X J;W
F P Z G H S | S Z P H F;G
V S C O N H | N C V S H;O
F R X Z H E | Z R H E X;F
P W J A L V | V J A L W;P
Y T X G Q W | X G T Y Q;W
T C S K F Z | Z C T K F;S
S N E L B A | S N A L E;B
Q A X E C F | E C A X Q;F
G E U C D F | G D C E U;F
N G U Z X O | X U G O Z;N
V A R U D I | U A R D V;I
C G A J V O | A C J O V;G
Z Y B U G F | B Y G F Z;U
W N A D K Q | Q W N K D;A
R Z L F B X | Z R B L X;F
D S P G X V | V S P G X;D
R Z O M N B | O M R Z N;B
K X H G R Z | G R H K Z;X
I B X K L W | K W X L I;B
N I A P E D | A N P E I;D
S H T V J D | S D T H J;V
H Q C Z I T | H C I Z T;Q
O K Q R M Y | O R K M Y;Q
X F J R O P | F O X P J;R
S V G W F B | G W S B V;F
Q F A M Y X | Q X M Y A;F
T E Y D X Z | E X Y T Z;D
D T R M A F | A T D R M;F
H T F J G S | F S J H G;T
W U C V H J | U H C J W;V
K V P I J E | K E P J V;I
A H U J R X | R A H X J;U
Y R V A W C | A R V C W;Y
C O R X V A | O A X R V;C
P J O C A R | R J O C A;P
S C W G A Q | G Q C A W;S
W R U L Q P | P W Q L U;R
E R D Q J M | Q R E J D;M
R W Q T F Z | T Z F W R;Q
Z G A I D Y | A I D G Y;Z
E Y K B J A | A B Y J K;E
Q U Y K A P | K U A P Y;Q
S T J B X L | L B S J T;X
M B O R W G | M R O W G;B
A V D P C U | C P V A U;D
Z J P G D H | G D P Z J;H
G H Z B W T | T B H Z W;G
Q C L O Z F | Q O Z L C;F
Y S N A W B | B Y A W N;S
A D J Y Q F | Y F D J Q;A
K B D A C E | A E K C D;B
S Z B R M G | G B Z M S;R
G D O P S L | P S L G O;D
X L O C M T | O L X T C;M
O N Z D Q K | K N Z Q O;D
L N V U P Z | L P V U N;Z
R X O N A Z | Z O X R N;A
X W O Q T N | X O N W Q;T
Q Y X U I F | U F Y X I;Q
T H R D I J | R I H J D;T
O A G M L U | G U L A M;O
X M H J I Z | M I H J X;Z
V N A H E Z | E N Z A H;V
Z X J L Q F | J Q X L F;Z
W C H S N E | C E H S N;W
D P N I W Z | D I P N Z;W
K Z F L B T | T Z B L F;K
Y E C Z G S | S G Z Y C;E
Q Y N V P B | Q N Y B V;P
O H R U M F | U O H F R;M
A P S U O Q | S P A U Q;O
G C B D J A | G A C B J;D
G X P R O U | X O P R U;G
J I D H X B | B J I D H;X
A U Q T L H | A L H Q U;T
B G T F R W | G T F W B;R
O E M Y X V | X V E M Y;O
C W A R F P | P R F W A;C
K Y I W N M | M N I K W;Y
Y C U E V K | V Y U E C;K
R Z J V Q P | V J R P Z;Q
V O R W B F | W R F O B;V
Z S M A H T | S T H A Z;M
F T V J Y E | F E T V J;Y
M H C R Z V | R M H Z C;V
Q Z D G R A | A G Z Q D;R
H X E Q K I | E K I H Q;X
Z H U X E M | Z U X M E;H
I B S P D R | B I R D P;S
S Q W T H X | H W Q X S;T
Y M H T E W | W M Y E H;T
X G B Y D K | X G K D Y;B
G Z D R U M | R Z G D U;M
Q L S H N G | H L Q S N;G
Q L N Y D K | L K D N Y;Q
A K Q J V L | J V L K A;Q
W K M L Q Z | W K Q Z M;L
F R K A S Q | K A R Q S;F
T H V Y S D | T H S D V;Y
Y O J K A D | K J O A D;Y
L M V Q E B | Q E M V L;B
W N Y G M F | F Y G W N;M
H T R Z L V | V T L H R;Z
W N F Z K G | G F Z W N;K
H W I A N J | H N W J I;A
P G K T V J | K P J G T;V
W L O A V T | L T O A W;V
L J P N T O | O T N J L;P
C I E W B S | S W B C I;E
M Q B I N D | N I D B M;Q
X A S H D Z | A H D Z S;X
Q J W S C U | Q J S W U;C
B K H W D P | D W B H P;K
A C M S I B | B C M A S;I
V X F N W A | F X V W A;N
A P M Y S K | Y A M K P;S
M N H O Z V | M H Z V O;N
P N R Q E W | W Q N E P;R
D R T U A I | U I T D R;A
E M I J Y T | J E I Y M;T
C P T Y G L | G L P C T;Y
X D B Y T C | T D Y C X;B
Q Z X R J Y | J R Z Q X;Y
N T L P Z R | L Z R T P;N
D Z S W P R | D W R S P;Z
Z L R N S D | D R Z S N;L
Z O B W S V | B S Z O W;V
G D C B S K | S D G K B;C
E I N C M Y | E C Y M N;I
N O P H L T | H O P T L;N
F B U L G N | N B L U G;F
Q C S Y B Z | B Z S Y C;Q
J M U W Z F | U M W Z F;J
O I P Y V K | P Y I V O;K
Z O G A C X | O C Z G X;A
D T B G P R | G R B D T;P
A E D U V T | E D V A U;T
L Q B D N G | L G D Q B;N
T X U A Y P | P Y U T X;A
F W S C M L | W C S F M;L
X J T S G Q | Q X J G T;S
O X H I E Y | X E Y O I;H
Y C N E M P | E P Y C N;M
M C E W P Q | P C M Q E;W
E R N L C M | L E R M N;C
L O J W Y Z | Y J L W O;Z
H X I D U A | D I A X H;U
W P I C D M | I W P C D;M
D M R F J V | D J V F R;M
Q Z P V Y D | P D Z Q Y;V
H G N B D U | N H G D B;U
N F K U C Q | F C K U N;Q
K N L Q M D | D M Q L K;N
V C K M B J | C V K B J;M
U Z A W R F | F A U W Z;R
Q K S V P J | K Q S J V;P
L W K Q M R | R K L W M;Q
F X U D Y G | D U G X Y;F
I Y G C A E | Y E G A C;I
C T R G H K | K H T R G;C
U G N W R S | N R U W S;G
P W V M D I | I D M V W;P
C U A N O Y | O A C N U;Y
N V R A O H | R A H N O;V
F S W L U H | S H U F W;L
O M A B U C | O M B C U;A
K H D B R E | H D E K R;B
O C T J B L | T C J O L;B
F K A L Z T | T F L Z K;A
L D G Z P K | Z P G D K;L
T I Q B O H | Q B H O I;T
P E N L G M | E M L P G;N
B T G A I O | B A O T I;G
B P L J X U | J X P L B;U
L C X G E Z | Z X C L E;G
G V L X F I | I V G F L;X
D J C R S K | S K R J D;C
I Z U C M N | M N C I U;Z
P H W C U M | U C M P H;W
H G R M B A | G B M A H;R
V X P K B F | F X V P B;K
J O S U K B | B U J S K;O
H Z C P J G | J P G C Z;H
G Y T R L P | L Y R T P;G
E X R J Q S | S J E X R;Q
I M C Q V A | V I M Q C;A
R A L I B W | I A W B L;R
H P Y V Q W | Q W Y V H;P
W L X S T F | F W T S L;X
G X T S M D | G M S X D;T
O V C X L P | P L X C O;V
Q U G D S V | V S G U Q;D
G Z X F K M | X F M G Z;K
P V O S U A | V P U A S;O
Q H B T D E | D H Q T E;B
F I Y N U M | U M F I N;Y
T E U G W Q | G W E U Q;T
X A F D H L | X D A H L;F
W A R U F G | A R G U F;W
L G P H I W | L G P H W;I
T Z D B C E | E Z D B T;C
Z H I O C A | H Z I C O;A
Z W E K H S | K W S Z H;E
F V Z B K S | B Z V K F;S
V S P D I G | D I V P S;G
Y L J F H O | J H Y F O;L
F Y K H G D | D F K Y H;G
K I P Y X E | P X E Y I;K
T J X O H A | X A T J H;O
M P Q H V F | H Q V P M;F
G E V U T O | T U G O E;V
A B X E W T | E T X W A;B
E Q D M F Z | D E F M Z;Q
A L B C O N | L B O N A;C
B P J L N D | B P J D N;L
L Z Q R M A | L Z M Q A;R
U G H F K Y | U H K G F;Y
F T E Y X U | U T E X Y;F
Y B K D T E | E T B K Y;D
J B A T V Q | B T V A Q;J
M N L E R C | L R C M E;N
Q Y X B N G | B G Q N X;Y
I R K A H Q | I A R Q H;K
J V K O A X | A J O V X;K
O R E U N L | U L N O E;R
Q L K M B Z | Q K L M B;Z
V Z I O G L | Z G V O L;I
M O Y K L C | Y L K C O;M
F K Y W E V | Y F W K E;V
I M H X U Q | H Q U X M;I
L D R F X V | R V L F X;D
Q S P N L D | L P S Q D;N
D J I F M B | J F I B M;D
F O D A C K | O F K A C;D
P Q B F J C | Q C B J P;F
D E Q T R K | D R E Q T;K
G X E R U H | H E G R X;U
V R N F D J | N J F R V;D
Y K T S J I | S I J K T;Y
L J I G P M | G M P J L;I
E A Q C W Z | E W A Q C;Z
D P J O I G | J O I G P;D
V Q H R P X | Q P V H R;X
F L J R A I | R F A J L;I
J S E M H F | H E J S F;M
M I K C L X | X K M I C;L
V N Q U D O | D V O N U;Q
R X U D I O | O D U R I;X
M G Z R P F | F R Z P G;M
X K B E D C | D K C E X;B
F H M L B Q | Q L M F H;B
Y T O F X C | C O T F Y;X
X D H F U P | P D F X H;U
Z U I Y T M | T M U I Y;Z
R L B W D O | W L B D O;R
X O U N L H | X U N H O;L
V D N K C G | D K C G N;V
X G V Q Y R | V Q G Y R;X
Y M P J S F | J Y F S M;P
S W F H K J | K H F W S;J
M C R S Z X | C X M Z S;R
F H W V E P | P W F H V;E
B Q A T F V | F V Q T B;A
F R S L B H | S R F B H;L
U E P Q J M | Q M P U J;E
M J O C G R | R G O C J;M
S P L W Z A | A S P W Z;L
P R F A V J | P V J F R;A
N Y X F J V | Y N V F J;X
O C U Q L B | L B C Q U;O
G Q L T N O | N Q T G O;L
Y T L W J A | T L W Y A;J
L S W N M C | S M N C L;W
Z M G A P K | P Z K M A;G
J Q P N R G | N P J R Q;G
U S M D Q N | S D M Q U;N
N G W A Y F | N F W A Y;G
W T P U O I | T W P I O;U
A K F D V M | M A D F K;V
V A P S L I | P I S V L;A
T O C B L D | L B D T C;O
Y P F V S M | P Y S M V;F
F N S J D Z | F J S D Z;N
W B J M K N | B J W N K;M
U H I C V P | P H U I V;C
A D O I K G | O D I G A;K
D F H A C B | F D H C A;B
N Y K U W B | B U K W Y;N
B R F K Y P | F Y K P R;B
T U W P H F | P W T F H;U
J F D O U M | U M J D F;O
E H U L O N | U O E H L;N
B V T Z L C | C L V T Z;B
A C F B U M | B M F U C;A
O U Q P T Z | T U Z O P;Q
K P T W S L | P L S W K;T
B Z F Y C S | Y F C S Z;B
W S T P U O | O S W T P;U
P T N I C K | C K P T N;I
Q R M V A K | V A R M Q;K
K V Z L T Y | Y Z K T L;V
N O R F Z I | R Z O F I;N
T W A K F Q | A K W F Q;T
E R T M F Z | T F Z E R;M
M W R D Q Y | D M W Y Q;R
I T V R P K | P I V T K;R
U L V I K X | K V L U I;X
R K V F P U | F U R V P;K
Y T C N L A | A Y N C L;T
Q U R P E G | G U E R P;Q
S C K G H R | R S G H C;K
F S Q O M G | O Q G S F;M
I W K O C D | K O D W I;C
J R P T I B | P I J B T;R
Y Q P L T E | L Q Y P E;T
P C M B E N | P M B E C;N
X O Y F C U | X U F Y C;O
M P Y D Q I | D P Y I M;Q
J M O C H G | M J G C H;O
I V K H L Z | Z H I K L;V
Q E D K B W | Q W B E K;D
Y G F M Q R | G Q Y F M;R
D O X P V J | P O V X J;D
O N F V U M | V M U N O;F
D M R Y T A | R M A T Y;D
C F T N R P | R F N T P;C
U H K F Y V | U Y K H F;V
K O B Q M R | K O M R B;Q
S N H T W G | W S T G N;H
Z Y M R S L | M L Z S Y;R
U B O X D C | O X C U B;D
G B P M N A | B P N G M;A
O G Z H N V | H O Z V G;N
Z C P M U E | Z P C E M;U
L M C F P E | E M L P C;F
M B F V C S | S F B V C;M
Y T J U H V | H J V T Y;U
W Z I Q B O | Z W I B O;Q
Z D A G U Y | G Y Z D A;U
A G X V D P | V A P X G;D
D A U W H T | A H D T U;W
T W S N K J | S T N J W;K
H X K Z F D | D K X Z F;H
X I V W H E | I X W H V;E
G T M W Q D | Q M D T W;G
C Q S I D M | Q I D C M;S
K P O R J L | J R O L P;K
U P D N L W | U W P N L;D
R O P E B W | R O W E P;B
E F V W T M | V M E F W;T
U P Q V I J | V U J I Q;P
A N T Z Q H | Q Z A T H;N
G Y M P A X | G X A Y M;P
I Q K C J M | K I M Q C;J
K N R S B Q | B N R S K;Q
E L G S A J | S L E J G;A
B R F I G A | I G B F A;R
T D N Y B A | T N B Y D;A
J E L A M R | M L R E J;A
O X J C P T | O T J C P;X
B X H N V L | V H B N X;L
S O A X N P | S N P X A;O
U O Q S D Z | O S Z D U;Q
M A Z B X Y | Y A B M Z;X
M Y W D N Z | W M N Y D;Z
P Y N H A D | P A Y N H;D
Z L I E Q N | I E Z N Q;L
P W G T U E | T U E G W;P
F C U T M G | T F M C U;G
M D Q K A E | E M K Q D;A
A Z Y K Q G | K Z A G Y;Q
A J B C Y I | C Y A J I;B
Z R P O H N | O R Z N P;H
A J Y P E W | E W J Y A;P
Y Z I J F A | F I Z J A;Y
E N P I M U | M I E U N;P
H E W Z R P | Z E P H W;R
J Q Z B K T | T Q J B Z;K
V F W L P D | L W F D V;P
B L V U F E | U V B L F;E
E O L Z D M | Z D M L E;O
R K O V A C | V K A R O;C
A Y J M X Q | X Q J M Y;A
V R L D Q Z | R D L V Q;Z
A I O K V J | K A J V O;I
W Z X S R M | Z R S W M;X
S A E P U Y | Y E P A S;U
L N J Q O B | B O Q N L;J
O T Z P J W | T O Z P W;J
Q Z D I U K | U D I K Q;Z
F M V D O C | D M V C O;F
O D F W M E | W O M E F;D
E J Y O T Z | Z O J E Y;T
U W H B M D | M B W H U;D
C X O N A K | N C K A X;O
I J Q R S D | I Q S D R;J
B W L C Y A | C L W B A;Y
K I A O W U | O I W A U;K
Z I L R O Q | O I Z R L;Q
I O T J U M | M I T U J;O
O M W S Z A | S M O W Z;A
S C P N K L | S N C L K;P
M O K Q Z S | M S Z O Q;K
K E N U I M | I M K N E;U
M F H S R U | H F M R S;U
Y T Q D L E | T Q E Y L;D
B L H F J X | L J H B F;X
A D S W Q N | W D N A S;Q
G N J V S L | V L J G N;S
H J Z V X S | Z S V X H;J
U G N V H M | G H V N M;U
E M A Q X F | Q M X F A;E
S N V U I A | N I U S A;V
E Q M K H N | N E K H M;Q
K Q E L B G | B E G K Q;L
K T V F O G | K F O G V;T
B W S J X N | J B X S W;N
I G A J Y O | I O J G A;Y
R A I Y P U | U A P I Y;R
G B D Y L X | X B Y L G;D
Q S M H O B | S O Q B H;M
Z F Y C B I | C I B F Z;Y
M W X V F L | W F V X L;M
E N P C R G | E C P G R;N
Q K N A B O | K B N O Q;A
J T Q C K A | T J C Q A;K
I F B X O G | B F X O I;G
B Q C L M X | L X B C M;Q
V E X P H D | H E P V D;X
G Z X I D R | D G Z I R;X
H D F A N L | F D N H L;A
T O G L P Z | G T Z P L;O
L D Y Q I U | Q L I Y D;U
T K E V N Z | T N Z E K;V
Q U G K D C | K G U Q C;D
H W D A Z B | B W Z D A;H
Z T D X P L | L Z P D X;T
H R Y E T L | H R T E L;Y
F L B R J X | R F X L B;J
F Y O D T M | T Y O M D;F
M F N R Q L | L Q F R N;M
R S I Y O U | Y I R U O;S
D S A F I V | I D F S A;V
M X S Y K L | M L S X K;Y
Y H T V M B | B Y V T M;H
F N W A R U | A R U F N;W
G S Q M F U | G S Q U M;F
P Y V I K B | V P K B Y;I
J D I S W K | D I W S K;J
A D U N G F | U G F N A;D
T V B P W K | T V K P B;W
P L O X W F | X P O F W;L
L B T V M P | V P B M L;T
U A I O T H | H A O I T;U
P X D F B K | F K D X B;P
S U B X K N | S N K U X;B
A C F M L T | C L A F T;M
Y W I O X A | A Y O X I;W
A T E P G S | A T E S G;P
S W K U D J | U J S D W;K
X F R B C U | U B C X F;R
A B E K J C | A K C E J;B
R H X E U C | X H C R E;U
W Q L K Z M | M L Z Q W;K
E B T I K D | K T I D B;E
S A T D Z C | T C D Z A;S
F D O V S R | V D O S R;F
Z T H P E I | H P E I Z;T
G N K Q C D | D N Q G K;C
I W V R H X | W H V R I;X
K Z P T E G | K G E T Z;P
S H V A Y U | U V S Y H;A
A U C M D K | C U D M K;A
A K Z L R X | Z R L K X;A
Y O M T S K | S O M K Y;T
P O Y X T Q | P Y T Q X;O
T E S N W G | W T N S G;E
Y K D A F N | K F Y N A;D
Y P V Z J U | Y Z U V J;P
V I Z P A O | O I Z P V;A
P U Y N H V | V H P Y U;N
X H U Y F I | Y I X U H;F
M U V I H Z | M Z U I H;V
W J C B F U | W C J F B;U
X W L V E F | X F W V L;E
F A X W D M | F X M W D;A
J A Q U K W | U Q W K J;A
A N I W V B | B I W N V;A
X T W L V F | V X F L T;W
S Z W H L X | S X L H W;Z
N S Z G X W | N W X Z G;S
U V P I Q D | P V I D Q;U
O S F J C N | S O N J F;C
O X V A B K | V A O X B;K
B I J L Z M | I J L Z M;B
J X B Y Z M | Y M B Z X;J
Y W O K R G | Y K G O W;R
Z V S I X E | S V E Z I;X
R O E K X D | X R O D K;E
Z C F W H B | Z W H F B;C
X E S R D A | E X R S D;A
A T S E K Z | A Z S T K;E
J Y E A C W | W Y A J C;E
A O T S K X | O K T X S;A
D Z B P C S | S B Z D C;P
E C X K J M | J K E C M;X
L O H T D M | T M L D O;H
N Z S O K R | K R S O N;Z
N H U C I Y | C U Y H N;I
P U W M D B | W P M U D;B
L C D Y J M | D M L C J;Y
E Y T X M S | X M S T Y;E
K J L N B T | N J B T L;K
K I V Q T D | T V D K Q;I
P V D G J T | V G D P T;J
H V Z S U O | S H O V Z;U
Y I H C U M | Y I H U M;C
Q G H P T F | G H F P T;Q
B Y S F T P | P B T F Y;S
W X C E B I | E W B X C;I
M C S B Y R | S M B R Y;C
O V W P H Y | W V O Y P;H
M D Z T P J | Z P D T J;M
S V W Y R G | Y S R W V;G
G Y P H E K | H G Y P E;K
G P E T H Z | P T G E H;Z
R G E S X A | A S R E G;X
I Z Y R N V | Y Z V N I;R
R K O Z A Y | R K Z O Y;A
G F R H L B | L F H G R;B
X B P U Y L | L P B Y X;U
V S O F X N | O X F N V;S
O C H M T K | H T M O K;C
D Z M U R G | Z M U D R;G
W Z C S L O | S Z W L C;O
U Q Z M H G | H M G Z Q;U
Z Q I W K S | S K Q Z W;I
E L N U D S | E D L S N;U
N M H Q U E | M H U E N;Q
L B R H O U | U L O H R;B
I V E X O L | E O V L I;X
F S C M O A | F A O C S;M
W J T D Z S | W D T S Z;J
T U E Z A V | Z E A U T;V
A Z X J V W | J V W Z A;X
E U S J V K | E S K J U;V
S Y G Z J I | I Y J Z S;G
D Z F C A V | A D F V Z;C
V O I W C L | O W C V I;L
T V C X E S | V E T C S;X
O A D N S Q | O Q S D N;A
G K R L M U | M R G K L;U
N D F Z S A | S Z A F D;N
G W O I U Z | W Z U G I;O
Y C H Q W V | C W V Y H;Q
L R U D V Y | L V D U R;Y
W F K Z I R | I W Z R F;K
C U L T Y O | T O L C U;Y
V T S A U R | V U S A R;T
V T A N D Z | D T A Z N;V
P B S C G F | S B G C P;F
F X E J U C | U J E F C;X
R S A T Y E | T A E S Y;R
C L N S B P | P B S L C;N
D O S H G J | G D S H O;J
V W I P O R | I P O R V;W
U Y C K M R | Y K M C U;R
J X Z F H Q | F H J X Q;Z
J V B M G Q | G B M Q J;V
K I Q J Y M | K Q I M J;Y
Q O K J R Y | O R Y Q K;J
W S V H G U | U G S V H;W
Q D G A X E | X Q E D G;A
Z I F M O A | F A Z M O;I
U E Z V P J | V U J E P;Z
G H Q S B I | I G S B Q;H
N I H J F X | X J N H F;I
F B H T O S | O H F B T;S
K H V Y I U | K I Y H U;V
C Z I R W P | P I W C Z;R
E Z N F M X | F E Z N M;X
X Q P I K G | G K Q P I;X
G Q A O K J | O K Q A J;G
S N Q P Z O | P S Z N O;Q
U L G R B D | B D R U L;G
N E K B P V | B P N E K;V
H B O D F V | D H O F V;B
F I O S G M | F S O G I;M
V I T B Y U | V T B Y U;I
T O I J F H | F O T H I;J
H Y J F I Q | J F H Q Y;I
A U I N Z C | Z C A U I;N
V G U S O E | O G U S E;V
O R T F I Y | T O Y I F;R
W C G T X F | C T X G W;F
Q C M R T F | T Q F C R;M
K G Z X M U | Z G K U M;X
Y V X M G L | G Y M V X;L
G C Z R Q U | Q G U C R;Z
J Z E V H F | H V F J Z;E
Z I V G L E | Z L I V E;G
B F X V P T | B X V P T;F
Z X H A U I | Z H X U A;I
R O L N G Z | L Z O N R;G
G V M T C N | T G C M N;V
L R X Z S M | L M R X S;Z
I W B K O Q | O I K Q W;B
O K E V I D | I K E D V;O
S W U K C Y | Y C U W K;S
S Q O Z V W | O S Z W Q;V
B O L G C K | G C L B K;O
N W K S B T | N K S T B;W
W X D E P R | X D W R P;E
Q X D A J S | S A Q J X;D
I A X O W F | A I W X F;O
S T B F O R | S T B R O;F
J G P N I C | N P G I C;J
L D M X H N | N M D H L;X
E H D L X S | X D L S H;E
I T R Q V M | I T V Q M;R
W Z H S I Y | S I H Y Z;W
E D I R F J | F R D I J;E
R U Z F G J | Z F U G R;J
P B E M K L | L M P B E;K
H Z G M U C | U C Z H G;M
J V A S G R | J G A R V;S
G B F S Q Z | Q S G Z F;B
L N A V B R | R B L V N;A
C X O A S G | X G C S O;A
X E J C B Y | B J X Y C;E
V M T Z P E | T E M V P;Z
J I D Y B L | I D Y L J;B
T U O F C S | U C F T S;O
V B J T P X | P V X B J;T
U X F R Q N | F R N Q X;U
I Y B F L U | I F U Y L;B
T X G A Z P | T X G P A;Z
Q O T J K C | K Q J C O;T
S D O Y M C | D M O Y S;C
V U Z P L S | V L S P U;Z
B U Q K Y D | Q B D U Y;K
O Z P Y B F | O B P Z F;Y
J G P N B H | H B G P N;J
L D I O W S | S D O I W;L
I B W Z T K | K B W Z I;T
E F M X C B | M F E C B;X
R V E Y Z P | Z R E P V;Y
O L J D W X | J D O L X;W
U M S T K B | U K T B M;S
A O K Y V X | V X Y O A;K
Q C U V O Z | Q V C Z U;O
X N Q I H B | B N Q I H;X
G D O K X P | K X D G P;O
Y M R V P X | M P X R V;Y
G X Q V W R | X R V W Q;G
R O T U B J | O T R U J;B
K P Y M D Z | Y Z P K D;M
X N E K I L | K N E L I;X
B V R G S A | A R B S G;V
F R H D O Y | F O Y H D;R
M W U K E S | M S U E W;K
L J Z E F X | J L F Z E;X
D L S E Y N | E S Y D N;L
M I X U C H | M I X C H;U
L T D H U E | E U H L T;D
M N T C B E | C E M B T;N
A S L Z W J | L J A S Z;W
W I V D F L | W D V F L;I
W T V M R I | V I T M W;R
P T S H G L | H P S L G;T
O X N V E A | E N V A X;O
C P A G K J | G C K P A;J
L D Q Y G B | D B Y L G;Q
P I E J G R | I J G P E;R
Z N P O V Y | N Y V O P;Z
I A M C G S | M C A S G;I
W Z A T P F | W P Z A F;T
L G E P Y J | Y L P J G;E
P O B J G M | O J M G P;B
Y R Q E D U | E Q U Y D;R
Y Z C T E D | T Y Z E C;D
T X V Y I L | X T I V Y;L
S N C L F H | L F S N H;C
N J Q M E I | I N J M Q;E
L X H T Y O | L O X Y T;H
G C N H T F | F N C H G;T
Y K H T W C | K H Y C W;T
O E D Q G A | Q A E G O;D
G C M J Y S | G Y M S J;C
X K Z E B J | B Z X E J;K
K N J L R H | H K N L J;R
U Y I P C D | I D C Y P;U
M G U S T P | T P S G M;U
B V R E I N | I R N B V;E
F H Y L C M | F M H Y L;C
C I A Z P F | Z I F A C;P
D R P G F W | W D G R P;F
B I S J P M | I M P B J;S
N H D T R S | N R T S D;H
Y S F N G U | S N F U G;Y
D N L P G U | G N D L P;U
M X U J F O | F M U X O;J
R H J N Y F | F J Y R N;H
Y C G W A P | W A C G P;Y
Y W C I R L | C W R L I;Y
J A Y O K C | Y A C J K;O
N J H W U T | W H N J T;U
B R L S H V | B L V R S;H
O S J Y D V | D O V J S;Y
S U J A P I | I U A J S;P
Z M J B S A | S B J M Z;A
S L C O A B | O B A L C;S
X E C L K M | L M C K E;X
G J L N T I | L I J G N;T
Y F H O C D | D C O H F;Y
R E J B L Q | B J E R Q;L
M A B R X U | M R X A B;U
I W V D S G | W V G I D;S
L O E F X G | F G X L E;O
Q M Y K S W | K S Y Q W;M
H U S W J Z | U W J S H;Z
K A G X U D | K G U D X;A
D M T R O E | R D T O M;E
Q F Y A E N | E A Y Q N;F
T Q A G C J | C A T Q J;G
O H F T D X | X D F T H;O
V Y A T U O | U A O T V;Y
V E R M O B | B V M R E;O
S C H D X I | S H D I C;X
V K O J Y F | Y F K J O;V
G V B U Q Y | U G Y Q V;B
Y O T G Q Z | Z Y O G T;Q
K Z R U M F | R Z K U F;M
D H N T C B | H T C D N;B
B V C L M G | C L G M B;V
U Y L P H F | U L F H P;Y
J P M G L H | P M L G J;H
B D F V Q Y | V D B Q Y;F
L W Q E P V | P Q W V E;L
R F P W M X | W P R F M;X
D I G F L J | G J I D F;L
S Q T F E U | T Q U E F;S
Y H S T A X | S X T H A;Y
J O G N X W | N J X W G;O
Q F U H A J | Q A U F H;J
X R E I L U | X I U R E;L
E A J D G U | J U E D A;G
W V G R I X | G R I X V;W
U V P F Q M | F U V M Q;P
H K W C Z Y | C H W Z Y;K
T M V I W B | B W M T V;I
Q V F L O J | O V F Q L;J
J T B S N C | S T N J C;B
F Z Y V X I | Z X Y I V;F
G D K I S O | D K I G S;O
T D L H B A | B D L A H;T
R L J C T I | C I R T J;L
I U Q V T O | I T U O Q;V
I S N Q L W | Q L N S I;W
T S K X F G | K F X T G;S
Z M O S J Y | O S Z M Y;J
O E I B P Q | B Q P O I;E
T F S L M Z | L Z S F T;M
I M U W X F | M I U F X;W
Y U A Z N K | N A Y K Z;U
V N Y L P E | P Y V E L;N
K V B O Z J | Z O B V J;K
E O R I A M | A M R I O;E
A D W O X J | X J A O W;D
K Y G E V T | G V T Y E;K
H G W O I L | L G O W I;H
C V U X I W | X W U V C;I
A Y R P T C | P Y T C R;A
O N I V D S | O V D S I;N
I E Y X M G | G Y E I X;M
C E A H G S | A S E C H;G
Y M O P S C | M S O P Y;C
M W J V T C | V M J C T;W
T L I A B M | A T M L B;I
M B C H U E | M C E U B;H
X P M J K W | X K J W P;M
K A F T J G | A J G F T;K
L S R G O F | L G F O R;S
T X Q S D L | S L Q X T;D
W S G Z J Q | G J Q Z W;S
E M R P H Z | R H E P M;Z
P X O U D K | P K D O U;X
B I Z M K H | I B H K M;Z
G O U C V W | G C V U O;W
U W J Y D H | H J W U D;Y
U Y H L A C | U L C H A;Y
E W I R K O | R K O I W;E
Y T Z D C V | V C Y D Z;T
T B P K H N | K N H B P;T
D R S A N G | S N G D A;R
G X W L Z D | G X Z L D;W
C Y H L N D | D L H C N;Y
E M A P R G | G M E R P;A
S G J D R O | R D S G J;O
N Z Y M R F | M F N R Z;Y
O L D H P F | D O F P H;L
G K F Y P D | D F Y P G;K
S C J Q X A | X C A J Q;S
Z B U L K P | B L Z K P;U
I U X F H W | U F I W X;H
Y D C X F P | P Y X D F;C
K R X A T O | R K A T X;O
R K B C Q X | C X R K B;Q
U Z Q G K O | Z U Q K O;G
V Z E H Y J | Y J V Z E;H
X N J L O Y | L O X Y N;J
Z H G T S M | H G T S Z;M
H V K C E M | V C H E M;K
L O D U R F | R L D F O;U
M W Q Z V H | Q Z V W H;M
N C T W H R | W N C H R;T
I G Y B M C | B G C M Y;I
J C U V Z A | U C V Z J;A
B G C W U I | W B C I G;U
Z J H S U D | H J S D Z;U
U S L R J Y | R J S U L;Y
Y E M G B U | U M G Y B;E
J R L X K E | R E J X L;K
C N L G E D | E N D L G;C
C V Y T D Z | Y Z T V C;D
Y I G E H J | I E J G H;Y
H X J Q Y E | Q Y X J H;E
B V M W R S | B M S V W;R
X I W V B N | X I B N W;V
E R H P N F | E F P R N;H
X Z P C G E | E P G Z C;X
T E M J F Z | F E Z T J;M
Z Q C M I L | Z L Q M C;I
E J H A R O | H O R J E;A
O Y L R G D | L Y O G R;D
K O D Y J R | D J R O K;Y
J Z G M L K | L G K J Z;M
Q R I L V O | R O L Q I;V
D V U H G K | U H D V G;K
X Y R P T Q | Q R X P T;Y
U O M T G F | F O U M T;G
G U A M N Y | G M U A N;Y
W C A V I F | F W V I C;A
R Q J M G T | J T R G Q;M
K J L X R Y | X R J Y L;K
H K R W T U | K U R H T;W
F D P V B J | V J D F P;B
Z L C F U O | C O F U L;Z
N E I R J Q | J Q N R E;I
M I H K W C | K H M W C;I
W Q S E J O | S Q J W O;E
T O N Z R L | O L R Z N;T
S M O A V J | S V M A O;J
P S A H V O | H A P O V;S
U A I S B Q | Q S U I A;B
M G E C H V | M V E C H;G
Q M Z L F H | H F M Z Q;L
G B Q H C E | Q E C B H;G
D U O Z H K | K U D H O;Z
A D N Y C R | D Y A R N;C
Q O F K T A | K T O A Q;F
H O X I P B | O I B X H;P
B D L P H X | D P X H L;B
H U T Y C O | C Y T O H;U
C T V Z U D | D T C V U;Z
V Y S C I O | V Y C S O;I
M V J D W R | R J W D V;M
U Q O M Y L | L O Y Q U;M
T E G U W C | W U G C E;T
E N Z I T U | T I Z U N;E
K Y B M W E | K E B M Y;W
W T N F D K | K N D T F;W
L R Q C I H | C H Q I L;R
U J O T N P | N O U J T;P
M T G Z D B | G B Z D T;M
D A C G Z O | G A D C Z;O
X K I L W J | I K J W X;L
P X G S W U | G X W S U;P
T O H K Z Y | T O Z K H;Y
F L A P J C | F P A J L;C
B S L F M R | F R L S B;M
C L A G D V | G C A L V;D
O T P I R X | O T X I R;P
P O A B N I | O A P N B;I
F G W H J P | J P G F H;W
O C K B D U | U O D C B;K
Q V O F W A | O A Q V W;F
M Y E D A I | D M Y A I;E
E Y C Q D O | C D Q Y O;E
N J D R T L | N D J L R;T
I J Z A Y Q | I A Q Z J;Y
L G M R K X | R K X L M;G
N O I C W M | M C I N O;W
Q V D G U M | U M Q D V;G
C I N U E R | R U C I N;E
V C I B A G | G A V B C;I
R F E D M K | F E R K D;M
N I K P O C | I N C K P;O
K I A P J U | K P I A J;U
O B M P T H | M P H T B;O
K M E J S T | S M K J T;E
C P Y B W U | C W P Y B;U
T U Z P F L | U F P Z L;T
Y O W R K P | R P W O Y;K
X K F M A O | A O F M X;K
N F E P W K | F E N W P;K
E R F B O D | F E O R D;B
K D I W O Y | Y K W O I;D
B F R G Y J | R F G Y B;J
Q G J M Z A | Q M G Z J;A
P Y D G K I | I G P Y D;K
Q F N X G O | X Q O N F;G
V Z L W R P | V P R W L;Z
J W I V S X | J S I V W;X
L N M H S K | K L N M H;S
L T B K D R | T R K B L;D
O X C T I L | L X I O C;T
J Y Q W K C | Q Y J C W;K
M Z T N G S | Z G T M N;S
J V N X U P | V X U P J;N
R N F M O I | I F R M N;O
K P N H L F | N H F L K;P
M Z X T B U | X M U B Z;T
G A J Q P H | A G H P Q;J
X P E A R N | P X A E R;N
F A C G R O | R O C F G;A
K Q Z Y U O | Z O K Y Q;U
K Z Q P D S | D S K Q P;Z
R I U F E C | F I C R U;E
Y J C B E H | H C B E Y;J
D F N B A M | B F M N A;D
O B V J H Y | J Y V H B;O
J Z A C U N | A J Z N C;U
N C K O S F | O C N S F;K
F L K Q E N | E F N K L;Q
L J E O A Q | J A L Q E;O
M L A Z X R | A M R L X;Z
I N H X K U | U X I H N;K
B A I K T G | K A B I G;T
X P E O Z F | X P O E Z;F
C B F V E N | E F N V C;B
F S V C J N | V F N S C;J
U P S N C I | P C I S N;U
V U B J S R | S V B U J;R
N C H R U F | N R F C U;H
C S I F V E | S I V E F;C
P M L D Q G | Q P M G D;L
X B L T S O | S X L O B;T
U X Y Z N J | N U Z J Y;X
K X W V Y O | O V K W Y;X
X H K Y Q Z | Y X H Z Q;K
Q V Z T C G | Z G Q T V;C
I F H E U V | F I H E U;V
Z H J O D E | J Z E H D;O
J M W F R U | R J M W F;U
Q J I U C G | U C J G Q;I
L S D U E R | R D E L S;U
S L H W O G | W O L G H;S
D I V A F R | I D V R A;F
J E B S L R | L R S E B;J
S Q D C B M | S C M B Q;D
N K U W Q D | U N K Q D;W
F D J Y E C | E F J D Y;C
T Y B M C V | B Y C M V;T
J O A M U B | O J A B M;U
B N V O C S | N V B C O;S
N L R H P B | B P R N H;L
X I J U L Z | L X U Z I;J
F J S Y G D | G J S Y F;D
X I Q V U M | V M I U Q;X
R N K F I O | F N O K I;R
V Y F Q T Z | Y Q T Z V;F
Q X C A W O | O C A Q X;W
O V T F K X | F T X K O;V
E K O C J G | E G K J O;C
X E W M U J | M X U J E;W
L U R T Y C | C U L R Y;T
N H T Q J K | J Q N K H;T
O C I U J R | U I C R O;J
G I S H E N | H I G N S;E
E N T B S P | T E P B S;N
D K F T E W | F K T D W;E
W O X H D P | X H O W P;D
V S R F I W | V F W R I;S
T S F Q N D | D Q N F T;S
U K F P X E | K X F U P;E
D V G Q I T | G V Q T D;I
T H N L P V | L N T H P;V
J F R L G B | B J R F G;L
D Y C E P X | X Y C P E;D
N Z G L M K | L G N Z K;M
D S B E Q V | E B S D V;Q
P O T L R H | H P O R L;T
D T B E A I | I E A T B;D
I D V F K L | I D L V F;K
W I H R K U | W U I R H;K
A X Q I M N | N Q X A I;M
L G U N S J | S U L N J;G
O Q V N S D | S V O N D;Q
E O H Z G F | H O E Z F;G
A X K E T Q | Q A E X K;T
J N I T V Q | Q T I N J;V
C E Z J P K | E C J P Z;K
A F R O K W | A R K F W;O
T R W C Y E | E Y T W R;C
F O P E T L | L P T E F;O
L G D H N O | H D O N L;G
N G Y E P I | E G P Y I;N
Z J L K E N | K N E J Z;L
Q O N W U V | N V W O Q;U
U X D I E Y | D U X E Y;I
X Q G T F S | G S T Q X;F
W G U R S L | R L U W S;G
L Y C R M T | C T L R Y;M
Q U H Y M P | M Y U P H;Q
I E O N H T | N O I T H;E
N L A H F T | N A F T L;H
K J V F A Z | Z A J K V;F
A I F E S N | A F S E N;I
H V G Y E M | V H G M E;Y
F P D Y X H | D H F X P;Y
D M A Q Z L | A D Z L Q;M
S K G C V U | U G K S C;V
U K Y A Q T | U K Y Q A;T
S D X C J K | D C K S X;J
W Y D T E H | W D E H Y;T
K E X C G A | G E K A X;C
X J D P M T | P D J X M;T
T X M I C Z | X T C Z I;M
J D Q F L S | L J S Q F;D
C U K J M A | U M J A C;K
Q N I O P D | O I P D Q;N
S O X C Q P | Q X C P S;O
Q H V E Y I | Q E I V H;Y
J I L A Z Y | Y J A L Z;I
J B H V O G | H V B O J;G
E L D U Z O | Z D U E O;L
L T B G N X | N G B T X;L
M T B P Z O | T O M Z B;P
W D I T Z S | I W Z S T;D
L T I D M K | D T M I L;K
D N B F V Z | Z N B F D;V
D R O V I K | V I O K R;D
T D W R G F | T W G F R;D
E Q C V H K | Q E C K H;V
N Q Y A J D | A Q D J N;Y
T R F V K H | H T K R V;F
R M A S U D | M A D U S;R
U I H B O L | U L B H O;I
H L J S A T | A J L S H;T
T R I S A Q | R T A S Q;I
B H G Q J Y | B Q G H J;Y
X D V T H O | X T V D O;H
A U M H D C | M C A U H;D
D Q A I E S | S I D E Q;A
A K O B J E | O J E B A;K
P B S Z Q W | Q P S Z B;W
C H V U D Z | C V U Z H;D
U N P A J Y | A P Y J N;U
W G E P T O | G T W E O;P
X E L T H A | T L H E A;X
N Y S B H F | H S F N B;Y
F M V R S A | R A F V M;S
Q H U Z E M | Z U E Q H;M
S J Q R H E | E H R S Q;J
B L Y H C F | C Y B L F;H
H X V Z T I | I H V Z X;T
A L I P U O | O A I U L;P
J P N H W K | J H K P W;N
F S M C V K | M C V F S;K
B A C F W R | F W B C A;R
M Z Y F N S | Y Z N M S;F
Y C B J S X | J X C S Y;B
M E T Z K P | P Z M E T;K
J E G Z L M | Z E G L J;M
S O C J E I | C O J E S;I
Z N A C B Q | C Q B Z N;A
U Y Q W C B | Y B U C Q;W
L U T A E K | L T K E A;U
B W U C Y F | F Y U B C;W
U X E Q S I | S X Q E U;I
Y P N V Q C | C Q P V Y;N
E P J K I G | P I K G J;E
C Z P D I V | Z D I V P;C
L H O U V M | M V O H U;L
Q U S W R I | R S Q U W;I
I P K W Q T | Q I W K T;P
P I R D Y S | D I S P Y;R
K L G P E Q | K Q E L P;G
N S B T C I | I B T C S;N
V G Y M O A | V A Y G O;M
X Y R B P F | F Y R B X;P
O Z W S U H | H W U S Z;O
N D K B A Y | B K N Y A;D
L B T V A R | L V B A T;R
Y C N X B F | B C F X N;Y
X I G P J Y | P X J Y G;I
P Z G W A X | A P W X Z;G
C J P Q Y L | J Y C Q L;P
K F Q G S J | K Q G S J;F
Y W F P E C | F P W E Y;C
P X H N U T | U P T N X;H
G T U J W R | T W U J R;G
E G P M F R | P R E M F;G
P G R W V N | N R P W V;G
P S R Y T B | B R Y P S;T
F I A V B K | V K F I B;A
Z R W C I L | L Z I C R;W
Y F D H L G | Y D F L H;G
G M B U O X | B U G O M;X
T C Q G O L | Q L T O G;C
D S Y M C H | H S C Y M;D
W C A L H X | A L X H C;W
V S R F Z B | Z F R B V;S
W O F Y R D | O W D F R;Y
N K Z X F H | H N K Z X;F
I L U F V J | F V J U L;I
T E H S U O | S T H E U;O
Y P Q I F O | P O I Q Y;F
S T Y U X V | X S U V T;Y
Z V A Q G D | Q G D A Z;V
G W U D P A | A D U G P;W
H R S U A L | A U S H L;R
O W T M H E | H E T O M;W
K O J V T Q | T Q J O K;V
Y X W K A C | X A K Y W;C
X A Q G F L | X G A Q L;F
D F O Q T Y | Y T D F Q;O
D M H K Q E | Q E D H M;K
L Z C Q Y T | C L Q Z Y;T
Z Q C T N Y | Z Q C N Y;T
D O G R H W | O W H G R;D
Z W F Y P H | Z Y P W H;F
V I Y Q N M | I N Y V Q;M
P K B S H C | P K C H B;S
X F O P R W | R F P X W;O
B W Y U J E | E B W U Y;J
G T Y V D N | V Y T G N;D
J Z T U F K | K J T Z U;F
G S M W K D | S W D G M;K
X T H J S B | H T S J X;B
U I L Z D Q | I L Z Q U;D
U Q P X S T | T P U Q X;S
D V X W A S | A V D X S;W
E K F Y O I | F Y K I O;E
D N R E P X | P N X D E;R
P N A K S Q | K N Q A P;S
F G U W K S | G F W K U;S
C H W R Z O | O Z W H R;C
J Y S G D C | G S Y C J;D
L U Y R Q Z | Y Q Z U L;R
M K N Y T A | M K Y A N;T
C V D R J K | V C J D R;K
X W B F T I | W X F I B;T
B V Z N U R | U B V Z N;R
N A Z U Q O | A Q U Z N;O
K P C L X I | P L X C I;K
U B A P Q W | U P Q W A;B
D T Y M W E | Y T W E M;D
E O U Y J M | M J E O U;Y
B D I C R E | C I B D E;R
D V G K E F | F V G D K;E
B T W H E O | H T B W E;O
L C J M E V | V E M L J;C
D R I Q C U | D I C Q R;U
O U K S Z E | E S O U Z;K
N Q V D J Y | V Q N D J;Y
B O Z K D A | K O B A D;Z
I G T O C D | I D C G T;O
Q H X I R V | X V Q I R;H
C Q F K R G | F C G Q K;R
V G P K J U | V K J P U;G
F N R Y U Q | F N Q R U;Y
I D K M A Z | D M A Z K;I
B T L V Y E | Y V E B T;L
V C M E G Y | M G E Y C;V
Z U L R I P | Z L I R P;U
T A B C P M | C T P B M;A
T G V Z J K | Z T K V G;J
R M H Y W G | Y G R M W;H
Y Q U L W P | Y P L Q W;U
R G O L T B | B O T R G;L
F C X P W E | X W E P C;F
L A B C M Z | M Z B A C;L
V M W D A F | W D V M F;A
G K B D U R | G R B K D;U
Y H K L T F | F L T H K;Y
Q J L Z R S | Z R J Q S;L
S E Y J K U | J S E Y U;K
T E M Y N V | Y E N M T;V
R S K H P M | S P R M H;K
Q B Y L C K | C K L Y Q;B
M O A R N Q | M R N A O;Q
D E S F C G | E F C S D;G
R T E Q U F | U E T F Q;R
P Q F L N K | K Q L F P;N
D I A O K Z | O Z K A I;D
F Y V O I T | I O T Y F;V
W N V K R U | R U V N K;W
A S H U B I | U I B A H;S
F D P G H E | G E P D H;F
X W N R M H | X R H N M;W
E L Y K H I | Y H E I L;K
G Q E P T U | Q P E T U;G
K E P O X L | O L X P K;E
N D H K W I | D N W I H;K
D G U N Q B | B D U N G;Q
W O D B K F | F K O W B;D
L R N J V O | R O L V J;N
M P N V C E | N E V C P;M
P W M T U R | M U W T P;R
T S V Y W U | V Y S U T;W
W Q D E T B | B E D Q T;W
K R G F L B | B F L K G;R
L T Q A X W | A W X T L;Q
M H X F R S | X S H R M;F
A N F J L I | I A F J N;L
T N D M A K | M N A D K;T
F B A Y M R | A R B M Y;F
T C R V S J | T C J V R;S
S H W R K I | S R K H W;I
L B N V A K | L A B N V;K
B Y X H D G | X B D Y G;H
T V R G X E | T E R V X;G
B H C D P J | J B C H P;D
D J U E G K | E G D U J;K
E P H D W R | W H D E P;R
P J R E V B | R B E P J;V
W I B C Q F | F W Q B I;C
X E G P F M | G E P F X;M
U V K J Q X | U X V J K;Q
O D N F B Q | N D Q F O;B
F N R S D B | D B S N R;F
U T A R W V | A U V T R;W
P H A D F Y | Y P F H A;D
S L E Z C B | S B Z C L;E
G U O P H W | U P H G O;W
N V S J P B | V J P B S;N
S R Q J K Y | Q R K J S;Y
X L J Y D T | L X D T Y;J
D F G Q W U | U F Q D W;G
M X C N I L | N L C X I;M
B F H S N Q | Q F H S B;N
Y T H X G S | T H X Y G;S
B P I O U T | B T I O U;P
W L M G Z N | Z M N W G;L
R O Y N A Z | N A R Y Z;O
Y T N V Z W | T Y Z N V;W
W H Y L N B | W L Y N B;H
Q J E R C O | E O Q C J;R
Q X N F D G | N Q G X D;F
P E V T S R | R T P S V;E
H U W C J I | H C J W U;I
U G A N L T | U A L G N;T
A M R I S W | M R I W A;S
Y E G I V K | G K I Y V;E
H Z S P K F | F Z P K H;S
J Y T Z D N | D Z N T Y;J
R E B I J A | R J E B A;I
Z D M A B X | A M D B Z;X
E A C Q M T | Q A C E M;T
Z W K V H D | V Z K H W;D
D B N I A R | N D R A B;I
R X C I Y A | X I Y A R;C
T X B J A Z | A Z B J X;T
E V P W I A | P I V W A;E
I D T Y Z O | Y Z O T I;D
P Z I J F X | Z I F X P;J
N V U O S Z | V U N Z S;O
F C T W L Q | Q C L W T;F
G U V B R O | O B G R U;V
L E O D Y V | V D O L E;Y
U B Z V M W | Z V M U B;W
K F N Z A S | Z F S K A;N
N K G F L V | F N K V L;G
K D T O C N | O D C K N;T
U I C Y O B | Y I O C U;B
X N C J E K | J K E N X;C
W D L Q G V | D G V W L;Q
G A D I P W | P I D G A;W
X W Y J K T | J W X Y K;T
R C N M L D | R L M D C;N
X W Z M A B | Z B X M W;A
D T C Z Y E | T E Y D Z;C
Z D L R Y Q | L Z D R Y;Q
T M J B L F | J B T M L;F
E T X U N G | E T U X N;G
O B M A N I | M A B I O;N
A Y G U O E | U G A E Y;O
J N K C O Y | K C N O J;Y
F S T Y G Q | Q Y G S T;F
J Y S F N U | J Y U F N;S
G A Q J P U | U A Q P G;J
K F O C Z E | E Z K C O;F
U K S J G Z | Z K S J U;G
Q V C T L Y | Q L V T C;Y
Z W R J F T | W R T F J;Z
Z H K D P J | H K D P J;Z
L U X G K I | I U L K X;G
J G P U F K | U F P J K;G
I P R H O N | N R O P I;H
M N P W O S | P W S O M;N
Y V H Z U X | Y U Z X H;V
E Q H L F K | F L Q E K;H
X B C H S R | H B S X C;R
S J V F L P | S P J F L;V
I N R X Y S | X R S N I;Y
F B A O D W | D W A B F;O
K Z D V Q R | K D V Q R;Z
W D Z Y G L | L D W Z Y;G
W K F A E L | A K W L E;F
L C M R O Z | O R M L C;Z
Q U Z G I X | Q X G I U;Z
F P X L W N | W P N X F;L
X G J B P E | P J X B E;G
T W E L J C | W L E C J;T
B U E T C M | E C B U M;T
E L D K Z H | K E H Z D;L
H B C Q L V | B Q C V L;H
G A E C V S | V S E C G;A
C F U S M T | C T S M F;U
T A G K V P | K T P G V;A
T R G Q A U | A Q T G U;R
Q P B G S N | Q N P B S;G
G S H U Z W | U H S W G;Z
A L Z F C O | A Z C O L;F
H I W F Z R | I W H R Z;F
J S W U M B | J U W S M;B
O P D K S Z | P K Z O D;S
B Y G T J C | J T C Y G;B
H C A L R B | R C L B A;H
K D B H Q Y | Y Q D B K;H
S I Y Q F Z | Z S I F Y;Q
V Z U W R D | W D U V Z;R
M C L W P O | M O W C P;L
V R I J L O | V J O I R;L
R H A S Z M | A S H Z R;M
I K L N Z G | N L I K Z;G
Z P B I H O | H P O I B;Z
O U A Q R X | R X O A Q;U
S I R N K L | N R S K I;L
P Y N C F L | F P N Y C;L
O B Q X Z S | X O B Q Z;S
F G Y A I N | A G N I F;Y
C B V U P H | C H U P B;V
O D U J S H | J D U O H;S
I C U G J T | I G J U T;C
F V I R H B | H F V B I;R
T F A G M I | M G I F T;A
Q D F L X H | Q F X D L;H
I N F H J A | J I F N A;H
N M Z G W H | M H W G N;Z
O E D J Z T | D E T Z O;J
Y V Q G C U | Q V G U C;Y
H T B R I K | H K T B R;I
L A O B S Q | S L Q A O;B
U Q A E C Z | A E Z U C;Q
C Z Y T D Q | C Y Q Z D;T
Q S T X V P | X S Q V P;T
V Q L W R J | J R W L V;Q
B R Z N P A | R P A B Z;N
X T V S E N | V X E T N;S
E J G R X V | X J G V E;R
J T O V C Q | Q V O J C;T
I J G Z X S | S I G J Z;X
Y Z F H D K | F H Y Z D;K
N V K A R W | K W R V A;N
N D K S M G | K N G S D;M
Z V C K D W | C V D W Z;K
U O B M D L | U D B L O;M
X T Q H Z C | Z X T Q H;C
U H Q W P B | Q H W U P;B
Y L H A N J | N L J H Y;A
V S D T H O | T D H V O;S
Y R H F S A | S Y F H R;A
J H X F E I | H J I E X;F
Z K V P F I | Z P F K I;V
D J F Z L P | J Z P F L;D
V I R E F K | K V E R I;F
K H P D A I | I P K H D;A
L S K V G J | L J V S G;K
M F A E O Z | M F A E Z;O
T F J E W G | T W F E J;G
N M R B X I | R M X N I;B
U P C Q B R | P R B U C;Q
P F K Q Z O | F O Z P K;Q
T J K G B S | K G J B T;S
W X G I O V | O X I G W;V
K U M F Z J | U Z M J F;K
I K R X L D | K R L X D;I
R A T H N L | R A T H N;L
C R V I U M | V C I R U;M
F X B W I Z | I F Z B X;W
D U P C O F | F P D O U;C
Q N B K A R | Q A R N K;B
N J G C R M | J C N G R;M
W H U G C M | H U M G W;C
I X E K P N | K I P X E;N
N C R T F J | J T N F R;C
H X Q E S Z | X Q Z E S;H
T U O L E H | U L O H T;E
O B J V T U | J V O U B;T
C S I Z L K | S L Z C K;I
I V U K R N | U K R V N;I
T H N A B E | N B H E A;T
D N E H W C | E D H N C;W
J L P A K I | J K A P I;L
K N Z W D V | W V Z D N;K
S O U T W G | T W G U O;S
R I Q B V H | V H R Q B;I
Z P J E H D | D Z E P H;J
K U O Q R I | U R O Q K;I
K G M A W R | M R G W K;A
B N L H S Z | L B Z S H;N
M N L Z J T | M Z L J N;T
N S Z K W E | K S W Z N;E
D W B R G V | W R V D B;G
R B Q F S N | B F N R Q;S
L X F T H W | T H X L F;W
F T X W Y D | Y W T X D;F
U D I E V S | U E V S I;D
B D A C M Z | D A C B Z;M
H D U L A M | U M A L H;D
M X J K P L | L X K P J;M
R G I E F Q | I E G R Q;F
B N U I O P | B P O I U;N
D A F V X U | A F U D X;V
U F E I V H | V I E H U;F
E J R U T Q | R J T E U;Q
G Z M W Y B | B W Z G Y;M
C K Q A G I | I G K C Q;A
Z P D S Q J | S D J P Q;Z
E V P Q X J | J E V P X;Q
J Z E X F L | J E X F Z;L
Z U F E J R | F J U R E;Z
P J X T L B | P L T B X;J
V Y T Q O R | T Q R V Y;O
Z Y P S W R | Y P W Z S;R
G J K L O P | L O K G J;P
J G S C E M | J S E M C;G
V M A S W E | V W A S E;M
J N D S A E | E N D S J;A
E J U R K N | K J N U R;E
F Q Y D T U | Q F D T Y;U
J K G D U N | U D G J K;N
S J B R Q W | J S R B W;Q
L S R C V G | V R C G L;S
Z R T A C E | Z E A T R;C
V Q M E I J | J Q M I V;E
Z P R D Q N | Z R Q P N;D
P W F Y M L | L M F W P;Y
Z T L X I Q | Q X I T Z;L
J C I K V L | V J C K I;L
J U Z F C K | C U Z F K;J
X J N S M H | X J H S M;N
N T J G O W | W O T N J;G
I V A F L O | F A V O L;I
P W C Q M R | R W Q M C;P
H P D V W Q | H Q W P V;D
T O N G V I | T O V G N;I
M D T L I P | L I P D T;M
J C W L T V | L W C T V;J
T Z L A G X | Z A X L G;T
G Y M B C O | M O G C Y;B
T A O G K R | G A T O R;K
U P Z I T Y | T U P I Y;Z
P K A I Q T | I A T P K;Q
Y Z D H T G | T Y D H Z;G
V N X Y C G | C G V X N;Y
P X F W Z E | Z F X W P;E
X G L S U P | S U X L G;P
Z S A G P E | Z S G P E;A
T H Z Q K N | K H T Z Q;N
P B Q R G X | B G R X Q;P
P D O S C M | S C O M D;P
U D R E O W | O R E D W;U
L Z U S M J | M L J S Z;U
H Y J D Z O | Z H D O J;Y
V F H C B I | H C B V F;I
E F K G B A | K G A B F;E
T I C G Z U | I C T U G;Z
W J G L B E | B J W E G;L
H V G C R A | V G R H C;A
B Y S V H C | B C H Y V;S
Q F H I X N | H N F X I;Q
O H K Y W V | W H K Y V;O
C H J F I X | H C F J X;I
J X H T N Q | H X Q T J;N
Q Y G S H R | Y H G R Q;S
F H N Y C I | Y N H C F;I
S I Y O J F | O J I S Y;F
C U B J Z Y | B J Y Z U;C
H J V R Q D | J Q R H D;V
Z K Q Y B F | Q B K Y Z;F
Y B O M H J | J M Y B O;H
M T P L F V | L T V P M;F
S W O A M C | A S W C M;O
A M P W O D | A O D W M;P
Z T G L O P | Z O P G T;L
R T I X H Z | I H R Z T;X
A N I X D R | I R A D X;N
I H U G W A | W I H G A;U
G F V B I D | I B F G V;D
M S N W I G | I W M S G;N
L G R B C I | R C G L B;I
D T J U H W | D J T W U;H
C P B D G V | P B D V C;G
H K I C U O | H I O K U;C
L X V J S Y | Y L X V S;J
F L V I J T | T L V I F;J
L G E C W H | E C G H L;W
M Q E R Y T | T M R E Q;Y
H W N Q S M | H S W Q N;M
A D C G P O | O G C D A;P
B G F W S V | G B W S F;V
I A W O Z N | I Z W A N;O
W Y Q V E J | Y E J W V;Q
Z G H P U M | M G H Z U;P
Z T K B N X | Z K N B T;X
G J D F W H | F D G W H;J
V K N R F P | P F V R N;K
I G W F Q A | F W Q I A;G
M K C V L F | F V K L M;C
A M N V X C | N V M X A;C
P F M T Q I | P F T I M;Q
L C E K H W | W E L K C;H
L X C M Q E | C X L M E;Q
X N D Q F J | D F N X Q;J
G E Q B T S | E T S B Q;G
G I K R H L | L R K H I;G
I G Q L H V | H G V I L;Q
W F O Y S K | O Y S W F;K
J H T A O B | A O T H B;J
W L O P I E | P O I E W;L
C Y J S P T | C S T P Y;J
S B N P H M | N M S P H;B
O R X H Y K | K H R X Y;O
Y W A G M R | R G W M Y;A
V J N I Y O | I O J Y N;V
Q U M V S E | V M S U Q;E
R G X Z B J | G J X R Z;B
V X Y O S I | O V Y I X;S
T G Q C Z B | Q Z C T G;B
D N Q H W J | J N W H Q;D
I G U T Z L | U I Z L T;G
X C D G L M | G X M D C;L
N Q I U K W | W U I Q K;N
J D E U O L | U L O J D;E
O Z M R V P | Z O V M R;P
T U H A V R | T H V A U;R
C F N D E K | C E D N K;F
P V G Q O F | O Q F G V;P
P K T C S A | A K T C S;P
S K Q C R U | Q U R K C;S
Z M R Y H V | V Z H M R;Y
U C D W A J | W A D U C;J
Z G T X N L | T N L Z X;G
F A D G N R | A N F R D;G
K J W E A C | K C W J A;E
I P Q N C G | G Q I C N;P
J O H M C W | J W C H M;O
P H O Z J M | Z P J O M;H
L X A T F O | O F T A L;X
L C H R T E | E L T R C;H
R M T K F Q | K M R F T;Q
D A T B C Q | B D T C Q;A
Q Z B D O M | Z D O B Q;M
D Y Q Z G F | F D Y Q G;Z
Q W M E G A | E W G A Q;M
F B U J C H | J U H F B;C
S J R D L M | J M S D R;L
W F B L P U | P W L U F;B
K B Y I D N | D I B K N;Y
K X U S L C | K X U L S;C
A L Z S B R | A L B R Z;S
O T Z Q M L | M L Z O T;Q
K J Z N X W | N X J Z K;W
Z T Y O V S | Z V O Y T;S
N C Q V F W | V F C Q W;N
X U I B G N | B N G X I;U
V R Y J E N | Y R N J E;V
N K I J X S | N K X I S;J
U T F D I G | F D I G U;T
J V H Y F R | Y J H F R;V
L K O M I N | L M N I O;K
D M P S N F | F D N S M;P
J A G Q I D | I D Q G J;A
V L F D J W | F L W D J;V
T O P U D C | C U P D O;T
O L W N D U | O W L N D;U
G V F C U Q | C F G Q U;V
J T U I Z L | I L U J Z;T
M P Q Y W V | Y V M W Q;P
X I N C Q M | M Q X C I;N
I L N Q E U | I Q L U E;N
H B M A Z J | H A J B Z;M
S J T Q I H | Q I H T J;S
L N J B F G | N B G J L;F
D R Y Z X N | X D N R Z;Y
M H D N A G | D M A G H;N
Q M G I X R | M R Q I X;G
J K B I Q E | B Q I E J;K
F B S N V J | N J B S V;F
L C W Y Q F | C Q F W Y;L
S Y V X I N | N S I X Y;V
A Z H W Q G | G A H Z Q;W
H B M G D S | S M B G H;D
G X V K Y R | R V K X Y;G
Q A C X V K | Q V C A X;K
M K N F E O | M F E K O;N
R L Y V W F | R V F W Y;L
L W F Y V K | K Y V L F;W
Q J R S A Y | S A J Q R;Y
S Q Z T H K | H T Z S K;Q
L P E Y I H | I L H P Y;E
A M F W O Q | M F W O Q;A
B I X W T S | I X T W B;S
S Y T R F I | Y I R S F;T
S V D T X G | G D S V T;X
W Z S E N A | Z S W N A;E
Z U K F P E | K F E Z P;U
J N F L Z S | F N S Z L;J
G Z C H Q J | J Z C G H;Q
V D F A R S | D V F A R;S
P S L Y C Z | Z L S C P;Y
A L T M X S | L X T S M;A
Y Q S B P D | P Y S B D;Q
Q V C T D B | D C V B Q;T
V S O Q B H | V S H B O;Q
O V T E Q U | Q E T V U;O
M Y R S H W | R M W S H;Y
G S J C X T | S X C J T;G
Y E T P O Z | Z O Y E P;T
N C W T G X | G X T C W;N
W X H S O Y | O X Y H S;W
S M H B Y X | X H M B Y;S
Q X D L P F | P F D X Q;L
Q U T W P J | U T P J W;Q
M A Z N Y I | M Y A N Z;I
P L M H S W | M P L S W;H
I O S L G D | L I O D G;S
M P C N T S | N C S T M;P
T E M J F D | E J M D F;T
U C Z G N L | U N G C L;Z
K C M P X E | K E C X P;M
J O D R H M | H R M J D;O
P R S E T Z | Z T S R E;P
H A R M X Q | R X H A M;Q
I O W F U K | I K F O U;W
N E K Q D V | K E D N V;Q
O Q S F I Y | Y Q S I F;O
A F H B R Y | A Y H F R;B
E L H W A D | E A H D L;W
F V P E W G | F V E P W;G
B R A Q U M | A R B Q U;M
V F G H Q M | M F G V Q;H
K T D G Y O | K G T O Y;D
A W I J U Q | A I Q J W;U
I U R Y O D | R Y U O I;D
C J T G L N | N J T L G;C
L U Z G D N | N G L D Z;U
A G T J H X | J H A T G;X
Y K B U A D | Y D U B A;K
Z Q M A R C | Q M A C R;Z
I F L J W H | L F W H I;J
G F Q H U A | F A U Q H;G
A T R D Q I | R I A D T;Q
A D M I L Y | D I M L Y;A
M V K T X B | K X V B M;T
H E T O Z S | O S E H T;Z
S H G B J Y | J Y G S H;B
D B I Y J X | J B D I Y;X
D R O A W F | D O A F R;W
Q N H D R T | H D R T Q;N
Q E S X W K | E S X W Q;K
Z B U P L J | U P B Z J;L
U Z Q K B D | B D Z Q K;U
F Z D N U O | N D Z O F;U
W V D T R S | V S T D R;W
H Q G J D Z | G Q Z D J;H
H U S I R K | S R U I H;K
Q O H G D A | G D A Q O;H
Z H T O L F | H L O T Z;F
H L S N Z V | S N H L Z;V
D J F O E X | E D J O F;X
R Z Q J O C | O J C R Q;Z
A W K Q Z E | E Q A W Z;K
J H Z R T K | H T J Z K;R
T W E Z A N | A T E Z W;N
K Y H T G F | G Y H T K;F
J F D E B M | D J M F E;B
E O X D M C | O M E X C;D
A Z Y O H J | A O Z J Y;H
L S N P Q K | K N Q P S;L
Z K H R F Q | Z K Q H F;R
R M F W K B | M W R K B;F
W P Z I D X | W D P I Z;X
C A B I Y U | U B C A I;Y
H M Y K J B | M Y J H B;K
I N C L X Q | Q I N C X;L
Z A Y E X W | Z W X A Y;E
I R N M K P | P M K R N;I
B V Q O P F | V O F P B;Q
E S N V Z X | S E N Z V;X
W F Y L D Z | F Z W Y L;D
F T E K J S | J T E S K;F
M P V R X K | X P V K M;R
D O R P N H | R O H P D;N
T X N K F C | F N K C X;T
I P V C T B | T B I C P;V
C X A Z T J | A J T X C;Z
U G M P A Q | U P G M Q;A
X I T F V Y | I X Y T F;V
H C Q X T L | Q X T L H;C
A I E C S T | I S C E T;A
Z E S R A V | S R Z A V;E
X Y Q T Z J | J T X Z Q;Y
X R W M U D | U W R M X;D
T C J I F O | F I T O J;C
D Q H E M S | M D H Q E;S
J Y D Q C H | H D C Y Q;J
V Y L N A O | L V N Y A;O
Q G Y X H M | Y H G M Q;X
M Z O I W P | O I P W M;Z
M B A Y X V | A Y V M B;X
V S G H Y Z | V Y G S H;Z
D Z N M E T | M Z D N E;T
V M R T W E | M E V W T;R
H E B K D U | U D K E H;B
F S J R Z V | F Z V J R;S
K X O H I J | K O I H J;X
O K B Q G L | K G Q L O;B
M H D Z J G | D J G H Z;M
U Z D E K G | U K G D E;Z
W Z N U K P | U K P Z N;W
W Q Y J T L | Y Q J T L;W
K R Y X B V | R Y B V X;K
D G V T F Q | Q V G T F;D
M F E H G K | M H G F E;K
Q J A E B U | Q A B J U;E
O E S U M J | S E O J M;U
R Z W O K V | W Z V R O;K
M K B L W C | K M W L C;B
S N G Y M E | N E S M Y;G
C L O W R E | C R O L E;W
A J N U R B | N A J U R;B
B W C F O N | B C F O N;W
B G E M C T | M C T B G;E
F I X Y C G | I G Y X F;C
E O I S A U | I U E O S;A
B T X F V M | M X B F V;T
W K N T Y E | T K W E N;Y
O U H B E M | U B O E H;M
X J M P W I | J P I X W;M
Z N M F Q L | F Z M Q N;L
H C T P O J | O T P J H;C
F R U Z G H | H Z F R U;G
X D S L G I | G L I S D;X
M U B S K O | U K B S O;M
S I Z J M K | J S I M Z;K
P N C U V H | V H N P C;U
F G D E U Y | U Y D G F;E
M V A Z J R | Z A V R J;M
A R E T O M | T E M O A;R
G B T L W O | L W O B T;G
J W X D R S | W J R D X;S
N E S B I W | E I W B N;S
M Y W Z V Q | Q Y W Z V;M
N K J I B D | I B K D J;N
C W G O N Z | G W C N O;Z
X Z L B G E | L B Z X G;E
U T B C F H | T U B C F;H
Q N L I G X | L N G Q X;I
U Q I W C V | C V I W U;Q
S E I Y F Q | E F Q Y S;I
M U W B T P | W U B M P;T
L C O T U I | I T L O C;U
Q V B W E R | W B V Q E;R
A D U Y G B | B U G Y A;D
G R J L B C | J B R C G;L
B K D G L R | G K R B D;L
I C J G Y O | G Y I C J;O
S V T C Y P | P S C Y T;V
D G I Y X R | R D I X G;Y
F L C R D W | W D L F R;C
R N E F H M | H E R F N;M
J W X N R O | R J X O W;N
C N O I L G | C L O I N;G
Q A M I C R | Q R C M I;A
W L U R D A | W L A D U;R
Q V O B X H | H B V Q X;O
A R B Y T W | Y W R T A;B
X C O Y F J | Y J C X F;O
R D G E Q V | V Q E R D;G
P D S X U I | U D I S P;X
W B L C U I | L B C U W;I
I P O S Q B | Q B P O S;I
Y Q W B G L | B Q L W G;Y
E W S K T M | K E M T W;S
S R T J C X | T X J S C;R
G E Q U P W | P U E Q W;G
M B W D Y T | Y T W B M;D
B P Y Z V U | V U Z B P;Y
B M Q I G P | M B I Q G;P
Q H A W S R | W Q S H A;R
C A V K R H | K C H A V;R
Y T R V Q M | M R T Y Q;V
Y F N Z T S | N T F Y S;Z
R P K J L D | R K P D J;L
G L B W X N | X N B W G;L
K Z E V H F | V Z F K H;E
W D R Y C H | Y C D R H;W
U Z D I W L | D I U Z L;W
I C M T Z L | M C L I T;Z
C S K G J F | S C F G K;J
J D A B G M | M A J D G;B
Y B Q Z S A | S Q Z Y B;A
X Z Y I D A | I D Z A X;Y
G D U K W O | O W G D K;U
L B C W U R | L U W B C;R
Q R K I S H | S I Q K H;R
F M L J S X | J L X M F;S
J V K X B S | J X K V B;S
W J U N F D | U J W N D;F
H R Q U W S | U W R Q H;S
J I H Q E S | J S E I H;Q
T N F H A D | H N F D T;A
H B D X J W | H D J X W;B
H D W A Q S | W H D A S;Q
P K V M W Y | K P V W M;Y
Q I P K N W | Q K I P N;W
O D W A C H | C D H O W;A
Z M C S E G | S M Z E C;G
Y Q J L Z G | J G Z Q L;Y
U Z W E S H | Z H W S U;E
G W A Z B V | V A B W Z;G
S Q H Y L B | L Q B Y S;H
K G S U H N | S K G H N;U
U I T L S H | S L H I U;T
P H J C T Z | P T J C H;Z
E Q U I B Y | U Q I B E;Y
U D O P V K | U P D K V;O
W J D I O L | I L O J W;D
W Q L J P H | L Q H W P;J
A T R B I C | C B R T I;A
G U Q T K X | X K Q G U;T
O X C S Z H | H Z O X C;S
M R Z X N K | R X M Z N;K
A H G S T O | O G A S H;T
A H I B D R | I B R A H;D
O Y J D K A | Y O J A D;K
U N T G C Q | T Q C U N;G
Z D P I V N | V N Z I D;P
V H D W R Z | W D H V R;Z
R T V L P F | T V P L R;F
M A E U R W | M U W E R;A
M X V K Z E | M X K E Z;V
O S W T G E | O W T G E;S
K U J L X D | K D J U X;L
D O I Q Y C | Y O I D C;Q
A H I T M G | I H M T G;A
A E N I L S | E L S I A;N
V E D K U B | B U K D E;V
H E R X V S | S H X V R;E
J Q F G D B | D F G Q B;J
E M I N B Q | B I N E Q;M
T F Y J I O | T F J Y I;O
K Q H D J X | K J X Q D;H
D S Y K E M | M K E D Y;S
C N E S Z T | S T C N E;Z
B Y H S F Q | F Q B S Y;H
P N A K R I | A I N K P;R
Q D P F Z T | F Z Q D T;P
M C G H N A | G C A M H;N
J E U X S Q | U X Q E J;S
B Q F P A Y | Y F P B Q;A
T L N G R P | L P R G T;N
M V P Z H W | V M H W P;Z
Q H O E C B | Q C E H O;B
I Z F A S L | A S I L F;Z
Q L H M J G | L H M J Q;G
Q T Z B P S | Q S Z T P;B
N E V L X D | L E V D X;N
F G A H R O | G O F R H;A
H V A D R Q | Q A D V H;R
F V G N U M | G V U F N;M
Y T N B V R | B V N T R;Y
N R K C D P | P C R D K;N
O Z I W D F | O W D F Z;I
F O H V W G | W H G O V;F
H Y U X D S | D H U S Y;X
E F X Q O N | F N E O Q;X
Q N Y F E P | P Q F Y N;E
G B D S E O | S D O G B;E
G P E D O J | E J O G D;P
I C S Y L M | M C Y I L;S
G S A B Q C | G Q S B A;C
E H Z W O L | L Z H W O;E
W R X B M H | M X H B W;R
J G Y Q E O | Q O G E Y;J
Q S P G T B | P T Q G S;B
W Y K L I J | I L K W Y;J
C D I U Y Q | Q D I C U;Y
C V H Q U D | Q U H V C;D
Q U K G J S | U J K G S;Q
W I M L P T | P L I W M;T
K H N V B A | B K V A N;H
W Z D Y V J | D V W Z J;Y
W Q R U H M | M H R Q W;U
K W O G U X | U K W G O;X
M P N Y J B | Y B J N P;M
C I E M O A | C I O E A;M
M P B V K S | B S P M V;K
R I X Z L S | R Z I S X;L
O T D V R U | R V U O D;T
B X M L E O | L B E O X;M
F R W H Y O | R H Y O W;F
D W Z N R S | D Z W S N;R
H A J C R V | V J A R H;C
H M A Q S X | H A Q S X;M
U L K I S Z | S K L Z I;U
N Z B G A W | N A W B Z;G
V P D Q A X | V X A Q P;D
Z H U I B C | U I B Z H;C
K A M E R S | S K M E A;R
A L M Y C E | C L A Y E;M
X R N W M D | M X R D N;W
V F O U H G | V O F G H;U
X D S B N P | X D B N P;S
E A J G D U | E J G U D;A
O Q M W J P | Q J P W M;O
H R A V L U | U R V L A;H
E X O H L I | O E I L H;X
T R W Y S K | S Y T W R;K
X J A M L R | R L X A M;J
I C Q M F G | Q G F C I;M
Z F V G J K | K V Z G J;F
W R Z I T P | Z R T W P;I
Z M D P X G | M D X G Z;P
O M D Y X U | M D O Y X;U
X Y I P L V | X P I L Y;V
T C K R W Q | T W K R Q;C
Q T J V I A | V Q J A T;I
O R B S K U | S K B R U;O
B O X K N W | K N W O B;X
X P V W B D | V X D W P;B
D V X U S Q | V Q U D X;S
B L H O F J | O J H F B;L
D Z T Q X C | Z D X T C;Q
W K T H E V | H V T K W;E
O N P R K T | R T K N P;O
Z R K Q B A | R A Z K Q;B
K A D V J N | N V K D J;A
D H O T Y Z | Z T H D O;Y
C J L Z I T | J I L T Z;C
V Q R H G U | H R G V U;Q
Z C T L U N | L Z T C U;N
W Q M D R E | E W D M R;Q
X J T D C O | J O X D C;T
O Y K M W E | E O Y K W;M
S V O G P A | V G O A S;P
L X Q P O V | L X P O Q;V
P B A S N G | G B N S P;A
O R N Z L V | O L R V N;Z
W U V T H K | V U W H K;T
N L W T U K | T L W U K;N
A D F N H Q | D H N A Q;F
B I W S J T | S T I W B;J
S N T Q X A | X Q A T S;N
D K F S Y R | Y R K D F;S
P V R N M S | R M S V P;N
X K F W P I | W I P X K;F
Q V C W G J | C Q V W J;G
U I W Q L F | I Q L U F;W
Y W P J A E | J P W E Y;A
D Q L K M Z | K Q M D Z;L
B Y E A N Z | A B N Y E;Z
C G I K T H | T H C G K;I
G C S R L D | C G R L D;S
M G T D N V | D G M V T;N
D B Q G M N | M D N G Q;B
D E I Q Y M | Y I M D Q;E
J R S Z B Y | Z Y J B S;R
Z X L Y A F | A Y X F L;Z
W M P C G N | C N W P G;M
N J E D M P | D P N J E;M
H B F J S W | W H F B S;J
X S N R I B | N I S B X;R
T Q P Y M J | M Q P Y T;J
L B A G R C | R A B L G;C
M J P Q H O | M Q H O J;P
K L P X S E | K E P S L;X
O H Y K A V | V Y K A H;O
U N L V Q D | N L Q U V;D
N R Y W P Q | Q R N P Y;W
Q P W F N Z | Z F W P Q;N
Y E T K D A | Y K E A D;T
O R M V K G | O K G M R;V
J W Y L U K | L U W J Y;K
D O F V A M | M V F A D;O
B H K X I D | X B D I K;H
W G P D T U | W D U P G;T
F K A C M O | C M A K O;F
L M G Q W T | M L Q G T;W
A P V H B U | P H V U A;B
N D C V A K | V A C K N;D
H W J G M L | M W L H G;J
O Z H S Y A | Y S O H Z;A
V Q A T L U | A Q T V U;L
T R G K F L | G K R L T;F
G U H A S L | S U A G L;H
F E Y A H D | A H E F Y;D
T L O F Z P | O P T Z L;F
W T C D B A | D C B T A;W
Y O Z L E N | Y N O E L;Z
B U S I T X | B I U X S;T
A D Q S V C | D Q C V S;A
E I G B O W | I G W E B;O
X F V L W T | V T F X W;L
Q S G D R U | R D Q S G;U
C S J U M B | C U M J S;B
A W Q N L V | Q W L N V;A
J B X G Z W | J Z B G W;X
G Y E U T R | R G E T U;Y
T P U D Z Y | Z U Y P T;D
Y D G X F J | D X J F G;Y
T Z D C G H | G D H C Z;T
V E B Q L P | P B Q L E;V
Z S V U X C | Z C X S U;V
H Y N Q M G | H M Q N G;Y
A E T D S N | T N A E S;D
Q P Z T R G | P T R Z Q;G
D T K V J O | D J V O T;K
J L A T B M | L J M T A;B
M W E J Z O | E M J Z O;W
P Q O J S B | O P J S Q;B
N A Q Z V P | A V N P Q;Z
J K U Y X O | K J O X U;Y
J Y E W L F | E W L F Y;J
V N H Q G Z | H Z Q G N;V
C X A W I V | I X V A W;C
A H S D C B | D C S B A;H
S P Q W F A | F S Q P W;A
P G J O Z Y | P O G Y Z;J
B M H F O W | B F H W O;M
U R H E G K | H E K R U;G
K S G C I L | L S C I K;G
N H A S F V | H F S V A;N
X W J A P Q | J A X Q P;W
K T L I S Y | S Y K L I;T
R T C U M A | A T M U R;C
N K L J Z X | J Z K L N;X
J G L P N H | H P N L G;J
Y M V S K Q | Q M V Y S;K
S Q X J F I | I F X J Q;S
N U O B R A | U R O N A;B
H Q G D E C | H Q C E G;D
P T G W Z I | G P I W Z;T
Y N C R Z J | N Z C R Y;J
A J V S Y L | L J V Y S;A
U I F P X M | F I M P X;U
U D X B K H | X U D H K;B
F V M I D A | D A F I M;V
M S D Y C J | Y C J D M;S
G W D Z M U | D W Z M U;G
X C Y E B P | E X C P B;Y
P W C K Y Q | P Y C K W;Q
Q V X D W O | D X Q O W;V
T Q P V L K | P Q T K V;L
D W S K V L | V W D S L;K
H U G W Q N | Q N G U H;W
R I D Y Z X | R I X D Z;Y
Z R U H T F | U H R T Z;F
M S Z K J O | Z O S J M;K
I O Y Z U E | I U E O Y;Z
M D F B K O | O F B D M;K
K G X V F R | G X R F K;V
R Q L M W X | R X Q L M;W
E C J I M N | C J N I M;E
U M R K G S | G R U M K;S
N L P B F A | P A F B N;L
X P K S I F | I X S K P;F
A J F V M Y | M F V A Y;J
D S E H P A | P H A S E;D
E V Y J F H | E H Y F J;V
M O J A P K | A M K P J;O
L A Z K V T | Z T A L V;K
J A B C M P | B C A P M;J
M F B Z Q P | Z F B Q M;P
W S L I X P | I S X W P;L
Y A D F E U | U D A Y E;F
E M A J G D | G D M J E;A
Z J A E K X | J E X K A;Z
I G C Z Q M | C Q Z M G;I
S O F Q B G | S F Q G B;O
T G E M F L | E M L T G;F
M P H V Z F | F Z M V P;H
N X V J Y L | Y N V X L;J
W G U H F V | F U G H W;V
B J W R I O | O R B J W;I
I S P C Z X | Z X P S I;C
A R E N Y H | A R Y H E;N
T U L B S I | T L S B I;U
H U G E D M | G U M H D;E
S A U T F I | I S U T F;A
B T R A W I | I B W T R;A
I H M Q T Y | Y T H M Q;I
H A N X J V | J A V X N;H
U X Y I G C | C G Y U X;I
S I N G P T | N G S P T;I
B O X M J U | O M J X U;B
Q M O F N H | F H O N Q;M
V F B Q O D | Q F D V B;O
D K N Y E O | Y E N O D;K
S O D B Z T | Z D S O B;T
U E A T N L | T L U N E;A
X C W L S I | C L W S X;I
N G Y I O D | O G Y I D;N
U Z P C T K | T Z U C K;P
I K P E X Q | P X I K Q;E
F U P A G R | P G F A R;U
Z B A W O Q | O B Q Z W;A
S I A N O C | I S A N O;C
W T J O I Y | I J W T O;Y
M H N B O Q | O Q B N M;H
A G B Y U N | U A G B N;Y
T I X F R C | T R F I X;C
Y O V P G K | O P K G V;Y
V T O X M C | C V M X T;O
M V Z X Q F | Q F Z V X;M
S N I Z L G | N G I Z S;L
U N X C W Y | U C X N Y;W
A W R N X V | X A V N W;R
H O C X F V | V O C X H;F
E B R A Z H | B H R E A;Z
T G S D F N | S F T N G;D
B O F U D A | D B A U O;F
I R H O W P | O W P R I;H
S G J O T E | S T E O G;J
H O T V W B | H T W B O;V
D B S X J R | S J B X D;R
U N S V L A | S A L V U;N
W X R E H M | M W R E H;X
F D H O M J | M O J D F;H
J V G K P Y | J Y V G P;K
R J S M O P | M P J S R;O
C Y L F R K | K R F L C;Y
J G B K V I | B G I K V;J
Y L X J F Z | L J X F Y;Z
L C T B Z P | L B C Z P;T
C G K I R Q | R G K C Q;I
T L K P V S | T K L S V;P
C G E J T A | E T C A J;G
X U K M Y Q | U Q M Y X;K
Y X E G S Q | E S Y X G;Q
S B V W O P | P W B V O;S
C R N V M S | C M V S R;N
G Q T V J W | Q T J V G;W
X R Y U O T | X T U R O;Y
G L B W A J | G W A B J;L
O N G V P L | O N V G P;L
N E W Q T S | T E W S N;Q
V P I H L M | V H I L P;M
H U G B Y V | H U B G Y;V
M Q H X N Z | M Z H N X;Q
G D N B P L | L N P D B;G
N T Q R L E | E N T R Q;L
L S A M E D | E L S A D;M
Z R C M S L | M L Z S C;R
A B Q K P L | K B P Q A;L
Q V I X W E | I X V W E;Q
W H E K S M | K W E H M;S
U Y E R W G | U R E G Y;W
F A N Z G B | A N Z F G;B
R Q P N G I | R P N G Q;I
Z C J G O W | O J C G Z;W
J K O C I W | I C W J K;O
J X R U T P | T J P R U;X
W O F G C V | W V O C G;F
K S U Z P A | K U A S P;Z
O M I Z F W | Z F I M W;O
H I E F V N | H E N F V;I
J N Z L A B | Z J N A B;L
R N F W T J | T N R J F;W
A X O H K M | X O A H K;M
E A Z Q J L | Q A J E L;Z
O I W Q N V | W N Q V O;I
E B F S U I | U F S E I;B
O B F C W P | B W P O C;F
M D Z W E R | R M D E Z;W
J A P L W G | P W J A L;G
H A K W O E | A O H K W;E
X Z B R W I | I X Z R B;W
J C I W Q Y | W I Q Y C;J
T L S H I M | S I H T M;L
J A Y O L S | J A Y S L;O
I T Y F E L | E Y F T L;I
G N M K R X | X N R M G;K
Q Y F G P U | F Y Q U P;G
Q T X H D O | X D O H T;Q
B P X J V N | V X N P J;B
H I J Q C W | J I W H C;Q
M G E L Z C | L M Z E G;C
G X T M C R | M R G X C;T
U J X M K Z | K U X M Z;J
A Y L M F Z | L F M A Y;Z
Y Z U H K T | Y T H U Z;K
I J C G Y Q | C I J Q G;Y
P W I V S J | J W P I V;S
T S G F J R | R G T S J;F
E N S O K U | E U O S N;K
O U A M V B | B U O M V;A
B V N F A H | V H F B N;A
U I P Z A D | A D Z U P;I
G M Q X C R | C X Q M G;R
S Z X K M H | K H X S Z;M
G H R V Y L | G V L Y H;R
R E A M B L | E R M B L;A
C K U V O P | P O V U C;K
V W C K S B | S C K B V;W
J Y O N H G | G J Y N H;O
D I C U W Q | U C W D Q;I
A S B Y V E | Y B S A V;E
E H R P O C | P H R O E;C
Q I X R P E | X I E R Q;P
D J Y W O B | Y W D J B;O
X U H F Q W | Q H X W U;F
U F L R M Q | M R F Q U;L
X N O H E R | H O E X R;N
Z D R O U C | D Z R C O;U
Z A K B E L | A Z K B L;E
U H O J R Z | U R H O J;Z
T A L Y Q X | A L X Y T;Q
J I E H D W | D J I W E;H
Q R B H J V | H J B R V;Q
G E M I D U | D U E M I;G
W H F D X J | H J F D X;W
T Z P U I B | I T P B U;Z
N X V W R D | D V N W R;X
O B R S F G | B G S R O;F
A Q E H V F | F V A H E;Q
A P E X O K | O X E A P;K
S V H C Y B | S C Y H B;V
Z W C X S K | C X Z W K;S
M X Y P R Q | P Q Y R X;M
Q A R X S L | S A L X Q;R
N M S D J C | N D J M S;C
B H P Z G U | U P Z H B;G
T U L O F C | C T O U L;F
L W Z Y Q U | U Y Z Q W;L
D F R L O S | F D S L O;R
V Z J W L A | V J Z W L;A
R F Y O M Q | F R Y O Q;M
J H M Q N B | N Q J B H;M
R Y X D A N | X R D Y A;N
M J Z X G R | M Z R X J;G
Z Q F U K W | W U F Z Q;K
H Q Y F V O | O H V Q F;Y
Z A T S K R | T S K Z A;R
B H M C I A | C B A H I;M
V K E W B M | E M W V B;K
W Q F D P G | G D F W Q;P
H U Z I K C | U C I Z H;K
O T G S W H | G W T S H;O
D P Z I K S | P I S K D;Z
U R L E F A | F A R L U;E
I W R K V Y | K I Y R W;V
D Z H O Q C | H Q D C O;Z
Y G F B D L | G B F Y D;L
M O R C B Q | R B C M O;Q
N M I J E L | J I L N M;E
Y S U H R J | J R U Y H;S
K X H I S M | M X S H K;I
F M Q L P B | P Q B M L;F
N Q V E D I | E Q D V I;N
V U C O X M | M X O U C;V
D R V O Y X | D X O V Y;R
G L E J T D | T E L G D;J
X O N D J B | N O X D B;J
H N K T V P | T P H K N;V
E N B O Z K | E Z O N B;K
L H B J N C | B J C N H;L
S X U R V J | R S V J X;U
S F W G V Z | F S W G V;Z
M F S J I E | S F M J I;E
E U P K S H | H U K S P;E
O J F T Y V | F J V Y T;O
N E B K L W | E W B L K;N
C G T Y Q J | Y C T J G;Q
K M G O F X | X M K F O;G
H R I A L U | L U I R A;H
W Q X H J C | W C X H Q;J
P F O U X E | F E O X P;U
D X K J G N | J D X K N;G
E N U G J P | P G E U J;N
D N C M F Z | Z D F M C;N
W N D G C K | K W G C N;D
M K L Z C E | M K L E Z;C
L D S V M Z | M L S D V;Z
E S J F R P | F S J E R;P
K Q N H J W | N K J H Q;W
S J B G I R | R S B J I;G
R L C G Z W | R C W G L;Z
V R B E K T | T B V K R;E
R D T U W H | T R D W H;U
P H Q S Y T | H T Y P Q;S
C J N M P F | F C J M N;P
N K H T G X | G T X N H;K
U D A B N L | U N D L A;B
Z V R I Y H | I Y H Z R;V
C Z W D P J | Z P J C W;D
G M S E X F | E X G S M;F
V B T N M C | V B M C N;T
R X O I B Q | R X B O Q;I
F Z U C B K | B U C K Z;F
N Y H U S M | Y U H M N;S
F N L H S U | S F N U H;L
K S E U L Z | L Z K S E;U
S X Z P L Q | P Z Q X S;L
N V E X P W | V X P N W;E
L X R F S G | G R X L S;F
T O J I D K | I J T K D;O
A T P O L B | A O P B L;T
L W E R Q U | R U W Q E;L
Q U E H S M | Q U H E M;S
J C H G I O | I O C G J;H
Y S M W I B | W S Y B M;I
H S B M P Q | M H S P Q;B
X Z A U I J | J Z I U X;A
S D B K T H | T S H D K;B
G L R K N Q | N G K R Q;L
X F G Z E L | L E Z X F;G
R Q J O N E | Q R J O N;E
O C B H Z Y | C Z Y B O;H
Y J L S Q B | Q Y L B J;S
Z Q I T L C | I T Z L C;Q
Y J S R V C | S V R Y C;J
S P D T L V | L P T V S;D
D N M U O E | M O E N D;U
I H O P M V | V O P H M;I
B K E J Y G | E Y K G B;J
T V F Z N J | N V J F T;Z
J D T F Z S | Z F J T S;D
V Z E K D C | Z C V K D;E
T E D Y I B | B I T E Y;D
V Y G M O N | O M V Y N;G
Y F N P G I | P N I F G;Y
E D H I J M | M H D J E;I
O K A X T L | L K T X O;A
D K M N A R | M A K D N;R
K A D W Y V | Y V W D K;A
V C K W D Z | K V C D Z;W
F D U V J W | V F D W U;J
G A P X S K | X S A G P;K
Y U D E O G | U D G Y E;O
E C J S A W | C J S A W;E
I B V T F Y | Y B I F T;V
B V G A T X | A V B X T;G
O S E A R T | O R A S E;T
K M Q L Y J | K M Q Y J;L
Y C B U I X | X B C U Y;I
M Y P V U G | M Y V P G;U
S Q C U A I | S U Q I C;A
A H E G V U | E U H G V;A
S R G D K Q | Q G D K R;S
E I K H P T | P I E H T;K
L W Y C J A | A J Y C L;W
A U Q K R L | L U K Q A;R
L I D V S X | V S X I D;L
N A I C J P | C N I J A;P
L O J X C Y | Y C X J L;O
T R U F M B | F B T M U;R
W O D J E B | B D O W E;J
H G F Y Z N | N Y Z G H;F
J M L P H R | J H M R P;L
B C A H K N | A C K N H;B
P O B T M K | O P K M B;T
G L Z Y E O | O E Y G L;Z
F X T E I S | X I T F S;E
K N C A G Z | A N G Z C;K
T I M Q Y J | I M Y T J;Q
C E Y A P B | E C Y P A;B
W Q R V X C | R V X W C;Q
U T E H V P | P V H U T;E
K H Z V O J | V J Z O H;K
D G F C U O | O U F C G;D
T G Z R C K | T Z G R K;C
O N B C V Y | O Y V B N;C
D L U F E I | F I L D E;U
B W H X N D | B X N D H;W
V K F C N W | V K W F C;N
C A L G P O | O G P C A;L
E Z B N S F | Z E F B N;S
E H G D W I | I E G W D;H
K J O W Z A | Z O J A W;K
Y E Q H P T | T Q E Y H;P
I M F N J U | N M J U I;F
C Y I A Q K | A C K I Y;Q
D B K U Y W | B W D Y U;K
Q Y V U I K | U V Q I K;Y
B J I C L W | I C J L B;W
H V N Y J Z | J Y H Z V;N
A Q G Z N I | N G A Z Q;I
T J W U V I | J U T W I;V
Y T S Z A P | Z Y S A P;T
U J A O T R | A O T J R;U
I B D V S T | I T B S V;D
V J S B X N | S V N X B;J
A N Y V M L | N V A M Y;L
C T I D L Y | Y C D I L;T
I W J Q P M | P I W M Q;J
Q F U O T G | G T U F O;Q
S M J X R T | S X M T R;J
G E L H U X | G U X H L;E
Q B Z C A U | C Z Q U B;A
P N R F X Q | P R N F Q;X
E Y Z R J L | R L Y J E;Z
E J F R W I | E J R F W;I
J S Y I Q G | Q S G I Y;J
J B N Q X Z | Q J X N Z;B
K W H I G J | W I H J K;G
T Y J V O X | T X O V J;Y
C G J U P Y | J U C G Y;P
L B P T A H | B T P A L;H
L J V Q Z C | V Q C J Z;L
W L Q I R X | L I W Q X;R
Y X E Q D I | I Y E X D;Q
G H J F V R | V G R H F;J
M Z E G F Q | M G F Z Q;E
Q U V F P D | P D U Q F;V
T B M A D V | M V T B D;A
H Y I K T E | H E T I K;Y
D H S P L F | P S D L H;F
S C L O K X | C S O L K;X
V E F A B P | E F P V B;A
N X P S M L | S L N M P;X
B P U C Y N | C Y U P N;B
B N A G L R | G B L A R;N
L O Q S H Y | Q O L S H;Y
B Z Y R F M | F Z M B R;Y
W T I Y C F | T I C Y F;W
A C Z D W K | A W D Z K;C
D L K G Y I | G K I L D;Y
G W M T A X | G A W X M;T
Q L G J M H | Q H G L M;J
P H N L X Q | P Q L H X;N
K V G O W U | G U W O V;K
U E Y H O T | U E T O H;Y
B U O R V Y | U Y O B R;V
Y X V C K O | Y K O X C;V
V I D N R S | D V N R I;S
V C Q F O L | O Q V L F;C
J K H W E C | J E H C K;W
C D G Y O V | O C V Y D;G
S X F G L N | G F S N L;X
C U O F R W | W C O U F;R
Q L G I H K | Q K I L H;G
H Z U P I D | H P D I Z;U
F N P I L H | F L I N P;H
H B Z M J R | R J Z M H;B
E I B V Y Z | B Z E Y V;I
M R Q Y O S | R Q Y O M;S
O T A K D L | L K D A T;O
Y K G U L E | K G U L Y;E
S X L Z D G | Z S X D L;G
Y I W V J G | V Y J I G;W
H O R C J U | H U O C J;R
O P X I J Z | I O P J Z;X
A G H W E T | H W E G T;A
U H Y M Q N | U M Q Y N;H
K D L Q O Y | O K Q L D;Y
M U E T B L | L E B T U;M
X V N S Z R | X V Z R N;S
N Q U G J O | N G J Q U;O
V U D M B W | V W U B M;D
E G F L M I | G I L M E;F
N Z W K Q Y | Z Y W Q K;N
D S L P X C | X C S D L;P
A Q S P H W | P S A W H;Q
T X I S O U | S T U I X;O
N L E Q A K | Q N E A K;L
L X J K F A | L K F X J;A
I S T Y B V | B I S Y T;V
M I P N F D | F P D M I;N
A V G X Q L | L X Q G V;A
J C O B H W | B C H W J;O
Q X Z K H O | K O Z H Q;X
E N B X V D | D V N B E;X
B T S V H Z | V H B T S;Z
T X Y W C L | Y W C L T;X
W L A Y D F | L F W D Y;A
N I F S O X | I S N X F;O
C H G L D N | D G L N H;C
D N O T G J | N T J D O;G
B Y H V E T | V E T H B;Y
K Q W M I H | Q W I M K;H
P X E R H N | N H X P R;E
M P L I R Y | M I P L Y;R
P A X W J F | F J P W X;A
Q I H M N Z | Q Z N I H;M
F B Z D G P | D B Z P G;F
M C U S G O | M O C S G;U
X J M P V S | P M J S V;X
D Y V A Q L | Q V D L Y;A
X A J F N S | S X A J N;F
S D H G C V | C D G S H;V
M J W B F X | F X M J B;W
Z M R O A E | E R A O M;Z
C T O V M Q | T V O M Q;C
F Z R O P Q | Q P F O Z;R
H U P J F V | H J P F U;V
A E C M W G | M A G W E;C
Y T S Z I O | O T Z I Y;S
P O D K B X | X B K O D;P
V T I O Q S | I Q S O V;T
A W B L N E | L W E B N;A
V H Y J I P | H J I P V;Y
Y K R H D P | D R P K Y;H
Y F N E A K | N F Y K E;A
H V X P E T | V T E P H;X
N X R P F L | L X R F N;P
F O V X Y B | Y F V X B;O
T B W P H J | H B P J T;W
S P U I O L | P L U S I;O
D M E C S H | E D S C H;M
O P V K E T | P K T E V;O
D E G W Q M | Q W E M G;D
Q J H V B O | O H B J V;Q
X G L S P V | G L V S X;P
M V D T O Z | D Z M O T;V
H I X Y Z K | Z Y I X K;H
V G Q C J R | J Q R C V;G
U V T W R Q | W U T Q R;V
O C M F J L | C M L F O;J
J Q D F W T | F D W J Q;T
E Y D I P V | P D Y E I;V
I M Z P S D | Z D S P I;M
A M U T G Z | M T U A G;Z
A H R E V J | H E V J A;R
T J F Q Z M | Z Q J M T;F
R Q Y H X U | X U Q R Y;H
A L M Y H Z | M L Y Z H;A
J G P Y O R | O G R Y J;P
N V Y M R B | M V R N B;Y
C X D W S I | W I C X S;D
G X Q U Z C | C Q Z U G;X
S L Y W J I | I W L Y S;J
Y A T K D E | A Y E D K;T
A T I Q C U | T U I Q C;A
L Q J G B I | L Q I J G;B
R C Q W E V | W R Q C V;E
K L D B N U | U K L N D;B
D T W Z S Y | W S Y D T;Z
N Z O E T K | E T O K Z;N
R S C B G N | S C N R B;G
P B I H M X | P B I X M;H
R K N U X H | X K R H N;U
E T C Z A V | E T V C Z;A
Z G V I X O | X O G Z V;I
Y T O Z F J | F T Y O Z;J
A T R V U O | U V O A T;R
O W V H P T | V H O P T;W
T K X J B W | J W B X T;K
N F D C T B | T B C F D;N
U S E I W B | B U W S E;I
Q Y R V I E | Y I R Q E;V
Y K T A O E | T O K Y A;E
P X N Z S R | R N X Z P;S
P E N W R K | W N P R K;E
M G O Y S F | S O G Y M;F
P A U E Z C | U Z C P A;E
Q G Z T H Y | Y H G Q Z;T
X D K W O Z | X D W K Z;O
B V Z C E W | E C V B Z;W
K A S J B E | J A E K S;B
T A Z H O K | O T K A H;Z
E S P H U M | P S U E H;M
B X T H Y F | F H X T Y;B
Y K O S W N | O N K Y S;W
Y V N H R W | Y N R W H;V
B D X E U G | B E G D U;X
W J T H N Z | H Z N J T;W
V K S U X W | U V S W K;X
V W X F E S | S W X V F;E
L T G B R V | T V L B G;R
O U F Q A B | F B A U O;Q
K E D F U H | D F U K E;H
M D C Y K P | Y D C M P;K
Z Q B E M Y | M Q Y E Z;B
R E I Q B C | E B Q C I;R
W P Q E O A | O W E A Q;P
O F K P T J | T J P K O;F
B R A Z Y X | X Z R B Y;A
X U F G R H | R X G U H;F
C J X D M A | A X M J C;D
W L B E V Q | L W Q E B;V
S O T N K L | N T K O S;L
W H G Y F T | F H W Y T;G
B S E G Z Y | S E G Y Z;B
Q G M Y P X | M Y X Q P;G
G W R Y V P | G R Y P V;W
U S N O E C | U E N S C;O
Z Q S L E C | Q L E C S;Z
D O T I C E | T C E I D;O
Y Q S A N K | S N Q K Y;A
K G S U C M | U G S C M;K
Y L D J Z E | E J Z D Y;L
W K D Q I E | D E K Q I;W
P Y J A E V | E P J V A;Y
E W R U S J | U J W R E;S
O Q K U Y R | U K Q R Y;O
Q G J I F M | G I J M F;Q
H J P I Y O | I P Y O H;J
K D I Y G Z | Z I Y K D;G
Z T C D F Y | F Z C Y T;D
A F Z Y P I | I P A F Y;Z
E R K M T J | T M E R J;K
E U N W M T | T M U E W;N
V P B S N O | P N V O S;B
R D A M S U | U S M A D;R
F N L R T H | N H L R T;F
A F S T C E | F A T E C;S
Z H E N L G | L N G Z H;E
D G Z P Y W | W Z D Y G;P
A E O I H P | E H I A P;O
N D G W S Q | Q D W S N;G
R T F L Z H | L R T F Z;H
L N Z E G S | E G S Z N;L
P S J Y T X | J X S Y T;P
R G F E N Z | F N E Z R;G
S U Q C T Y | C Q U T S;Y
A G B O M T | T A O B M;G
E I G V M L | G I V M E;L
Z Q N P B L | P B Q Z N;L
M J Z U I B | M I J U B;Z
Q V B T J K | B K Q V J;T
D S R I O N | R I S D N;O
Q Y V T K U | V Q Y T K;U
P T R M G K | G T M R K;P
W G K A D C | C W G K D;A
W S X E C L | S E C W X;L
O Y M T K C | T Y M C O;K
P U K A Z M | A M P U Z;K
U T P W E H | P H U T W;E
C Q O S Y P | P S Y C O;Q
M F H S L E | E L S M F;H
C Z E Q I F | C I Z E F;Q
T A E S I W | T E S W I;A
O K L Q T H | L O K H T;Q
Z C S V B R | V B S R Z;C
D A F H Z V | A Z F V D;H
W Z J E I K | W Z E I J;K
X P T F Z S | P S T X F;Z
W H G Q F X | W G X F H;Q
R C V K Z J | R K J C Z;V
Q P L G K I | L G Q I P;K
V Z B L X I | B I L V X;Z
O Q H I M S | M H Q S O;I
K C S R P F | F C R S K;P
N S H L F K | L H K F S;N
D F P M J A | M P F A J;D
M Q K C P G | Q K G M P;C
R S B N J F | J R F B N;S
W Q N A M O | M O A Q W;N
X Z F W T R | F W T R Z;X
U C M X S P | P U C S X;M
H X R U N Z | Z R H U X;N
M W P B L U | L P W M B;U
G Y D B M J | M B G J D;Y
Q H E L B Z | Z L E H Q;B
E K L B W Q | K W E Q B;L
L H R D S T | R L H T S;D
Q G K N T R | T Q R N G;K
X J D I V Y | D J Y V X;I
Y Q D H R C | Q C Y D R;H
M S E Z Q R | Z R E M S;Q
K S X T Q U | T K S U Q;X
H O B J P I | I O P H J;B
Y G B W M N | W M B Y G;N
M P K Q C S | Q M K P C;S
C N M D I X | X M I C N;D
C G A M F Q | M Q A F C;G
E V M K W R | K W E M R;V
U H Q K R M | Q K M U H;R
L I K U T D | I D T U K;L
V U Q M T D | T M D U Q;V
E Z K L W H | H L Z W K;E
H T S G P M | S P T M H;G
W A J K Y Z | J Z W K Y;A
B W Z I T H | T H Z W I;B
H I X T O N | I N X O H;T
L A U R X Q | L Q X A R;U
W M H B L U | W B L H U;M
D P A U C E | D U P C E;A
E F N Y Q T | T N E Q F;Y
J L Z R I P | L J R I Z;P
D F U L W X | D F U X W;L
V Z E P N Y | P Z E Y V;N
Y I D G N W | I D Y G N;W
M G K T H N | H G N M K;T
V N J K Q C | V C K J N;Q
T O I E L A | O E T I A;L
G Y L K B U | L Y G B K;U
F V N M W P | V M P W F;N
R L H G N B | G B L R N;H
M E F P K J | P F J E M;K
N H R L M V | N M R V H;L
H N A T L Q | N H L Q T;A
H B C Z I R | R I C B Z;H
C B T S N W | B T C W N;S
X B U O K Q | B K O Q U;X
Q S D T Z X | S T Z Q X;D
Q A T R W Y | A Y Q T W;R
Z E T I N C | N C I Z T;E
X Q N V L M | Q L N X M;V
W O U R N H | N H W O R;U
Q S T F P D | P F S T D;Q
I T S F W A | I T W F A;S
H M F T L Q | H L T Q M;F
W S V J A Y | S J V Y A;W
E U O I W D | U I E D O;W
E P N L Q S | S E L Q P;N
W F L P C J | C J W F P;L
H D A L V R | R V L D A;H
D Y H N I F | Y I H N F;D
R L T G E U | G L T R E;U
Q C R P M S | Q M C S R;P
O F V G H E | V O E G H;F
A W P F X J | A W F J P;X
V A M X N E | X E M A N;V
H R V M S Y | S Y R V M;H
O G L A J B | B L J G O;A
I C S O G D | G S D I O;C
U A M F J R | F U A J M;R
M N G I R T | R N G I M;T
O M S V A E | S M A E V;O
G C R V S U | V R G U C;S
Z P B Q M I | I Q M P B;Z
T V K I H E | I V H T E;K
F L N T V H | N L F V H;T
O C X E R U | R C X O U;E
C R W E Y A | Y W C E R;A
B C T L P W | B T P L C;W
A N D G U M | M N A G D;U
D B U V P C | B V U P D;C
N Y Z B O F | N B F O Y;Z
L Q K J O D | D O K J L;Q
S C Z T H F | H S T C F;Z
S X G K W C | X G K S C;W
Q Z U R P N | N Z U Q P;R
N X U G E F | X U N F G;E
I X R M A N | M N R X A;I
Z Q L D W P | Z Q D L P;W
O C H M J I | I J O C M;H
G O A L Y B | A O G Y B;L
V Z A O U T | Z V U O A;T
E B F S P W | W S E F B;P
Z P N M H E | N P H E Z;M
W X K F I Q | Q I K F X;W
M I U Y G W | Y I M U W;G
H K J G Y C | K Y J H G;C
D X H V S I | H D I V S;X
G K V U N L | K V G U N;L
Q I D S J V | J I V D Q;S
T D R W Z I | R I W D Z;T
B W Q M C U | W U Q M C;B
U R C M P L | C R U M L;P
Y O Z R T K | T O Z Y R;K
S F Q U X H | X S H F Q;U
M P D I A Q | M A P I Q;D
Q K G E T R | T R E G K;Q
X Z H G Q E | E Q Z G X;H
V W C B H I | C V W B I;H
L Z W K I U | Z L W U K;I
V U P M G L | U P M L G;V
A J I M B T | A M J I B;T
X P A I N U | X U I N A;P
K X J D S R | J R K X S;D
Y C X N O I | N I C X Y;O
H M J W O X | X H O W J;M
W P U O A F | F O U P W;A
D X M L K G | K M L X G;D
H L Z Y Q A | Q Z L A H;Y
J W I C V L | C V W L J;I
E V H M Y C | M E Y C V;H
S K A Q J P | A P J Q S;K
D E M K P N | K N D M E;P
I C E D F X | I D X E C;F
R G Z U C J | Z J C U G;R
W N M K I F | W F I M N;K
B J C F N Q | J N F C B;Q
A T H Q V W | W Q A H V;T
I H Y F U T | T H U F I;Y
Q W L D H R | D W L H R;Q
I B R L J H | R J L H B;I
N V U Z S O | S V U O Z;N
B N X I D A | N D I B A;X
S Y V E R I | I S E Y R;V
A U Q G C E | E U A C G;Q
Z S U R T A | T S Z U A;R
A L C K R E | K E L A C;R
R C M Z L X | R M C X Z;L
B U A T Z K | K B U A T;Z
L X P V M T | T V M P X;L
O E J P V C | J P C V E;O
V H I F B M | V F I M H;B
K S J R L N | S N L K J;R
C S A W D F | F W D A S;C
P G I K Y F | G Y P F I;K
D B I Y S R | I S D Y B;R
Y K P U B R | P B U K R;Y
E Y R A S B | Y S E R A;B
Q J C T U W | U J Q C T;W
F G T D Q R | R F D T Q;G
W M I A S C | I C S A W;M
Q I P R X J | P J I Q X;R
D F V B S M | V F S D M;B
I B O S N V | N O S I V;B
N S Z I M O | M O N Z S;I
R E C I B H | I R H B E;C
B A X R C V | C R A B V;X
H S W X L V | V W X L H;S
S D W T N Q | S W D Q T;N
M S Z G Q P | Z S Q M G;P
M P C A N E | M N A P C;E
G O Y X D L | Y L D O G;X
Q A V W R H | H Q R A V;W
I J W O N X | J N X W I;O
E D K F U W | W E D U F;K
T B E X Q F | F E T X B;Q
G M C K Y S | M S C Y K;G
B L U D H M | B D M L H;U
E Q N D V S | V E Q D S;N
C E J Z V G | V G C Z E;J
M A T K R L | T M A R K;L
W V D F Z R | Z V D R W;F
E Z D C X O | X C D Z O;E
S I K Y E U | S U K I E;Y
G Q N O U R | R Q N O G;U
C H Z G O D | H Z G C O;D
R K C L B E | R K B E L;C
C M Z P K Y | C Y Z K P;M
N R D V X E | D N X V R;E
G O J V X M | O J G M X;V
V A X P O D | P O X D V;A
U J E C Q F | F U C Q E;J
Q A W S B R | A Q S W B;R
L B C M K S | S C K L B;M
D X Q J F I | J Q X F I;D
G I X U W H | U W X G I;H
V Z L B M P | P V L Z M;B
L W C Z J S | L C Z W S;J
M N Q F D X | Q M D X N;F
C Y H B Z U | H Y C Z U;B
W P L U R A | P U L A W;R
L T I U E B | B E I L U;T
C N T P H K | K T P N C;H
Z D W B M O | M W B Z D;O
G M J F N K | N K G F J;M
G Q T B R L | T Q R G B;L
Y R B E S K | K E S Y B;R
K D X F M N | F M N K X;D
R P J Z O Q | P Z Q R J;O
V X O G Q W | O V Q G W;X
D U A Y L G | A D Y U G;L
N G T Z C F | T C N G F;Z
B R G N Q O | R B O N G;Q
P D C W Y G | W Y G D P;C
J O T M C S | C J O M T;S
X N Y L J V | L N V Y X;J
L G A N Y C | Y L A G N;C
Y Z A S H M | Z S Y H A;M
L W H K Z P | Z K W P L;H
S P H J C A | S C H A P;J
V Q G J P K | J K G Q V;P
J V P S X B | S P V J X;B
D N S J T H | N J D H S;T
Q X F P O K | O P X K Q;F
Q B G Z R O | B G O Z Q;R
N G A X Z I | G Z X I A;N
L D T E N R | L R N D E;T
Y I R X V T | T I V X R;Y
B E K A S H | A E S B K;H
R B T X M A | T B X A R;M
Z P M E R Q | Q P M Z E;R
F Z T M K R | M Z F R T;K
E I J K G W | E W K J G;I
P T V U W B | B U T W V;P
F V Z L R Q | R V F Q Z;L
D R Q K C S | K R C S Q;D
D T B O R Q | Q R O T B;D
H I L W M T | W I L T M;H
U B N A P J | B J A N U;P
F U N B S J | S U J B F;N
N O X P Z C | O C P N Z;X
E N O I M U | O E U I M;N
Q N K H X M | K M Q H N;X
F T Y W M U | M F Y T U;W
I W S K M O | O M W I K;S
Z Y T B N E | Y E Z B T;N
D A K J P Z | K D P A J;Z
V P Q D U T | T Q U V D;P
S N W F I L | I L F W N;S
M S R I C U | U S I M C;R
D H J S F Y | D F Y H J;S
E K L R F J | K F L J R;E
X O C I V U | X I U O V;C
C H P A S Z | P Z H A S;C
P R H V Z L | V L R H P;Z
R X C Z Y S | Z Y C S R;X
S Z V J M D | V J D M S;Z
F O Z Y H E | H E F Z Y;O
Z B Y F T W | Y F W T B;Z
F W D X M J | X D M W F;J
T R X Z A Q | Z X R T Q;A
W K F X J L | J K L X W;F
Z F D X T Y | D Z T F X;Y
Y R A E C V | A Y V R E;C
M K L I V F | L M F K V;I
L K P V N R | L N R V P;K
C T P L F I | I L T P F;C
M I K F B A | F I K A B;M
J E K R U P | U R E K P;J
A L D U J K | K D J L U;A
C Z M E L A | E Z L M C;A
G I X E A R | R G X A I;E
D R N A H I | D H R I A;N
I X T U Z K | K U X I Z;T
D L P C Y S | S L C D Y;P
A X P J W D | X P A W D;J
A F H D M P | D F P M H;A
Y K S V G I | I G V Y S;K
R I F T B M | F T I M R;B
F U Y P X T | P Y U F X;T
P O V M U A | O M P U A;V
F Y G B W U | B Y U F W;G
E K B N S Z | N S B E Z;K
K Q V F R X | X R K V Q;F
Q S E V N W | V W Q S E;N
F L K I C Z | C K I F L;Z
Y C T V Z N | V C Y N Z;T
W D L Q I O | D W O L Q;I
N Q U S F L | S N L F Q;U
B K P R V A | K A P R B;V
R C J X N S | J N S R X;C
H Y O D Q R | O H R Q Y;D
S K W E N Y | Y K E W S;N
H D F R T K | K F T R H;D
C J P B F I | C I B F P;J
H C G M O Z | O Z M H C;G
N X Y O I M | Y N I M O;X
F E B U Y Q | F Q U Y B;E
E J L S X Q | J L Q E S;X
K F Y Z N Q | Y Q F Z N;K
V N K F G H | F N V G H;K
C K H S T Z | H C Z K T;S
X W C H P V | P V X H W;C
H U F C R T | C T F R U;H
L E S Q N P | P E L Q N;S
W D X Q E O | E W O Q X;D
D U H O N Y | O Y D N H;U
G U D P C W | W P G D C;U
M S R E K J | E R S K M;J
P R E F M A | E P R F A;M
Y Z L F W T | F T Y W Z;L
V A O M L Q | O V L M Q;A
V G L U I D | V U L D I;G
T N G C H V | N T H C G;V
G E V A K D | V K G D E;A
R Q C J S B | C B S Q R;J
A R V E D K | K D E V A;R
N W K D F I | D F I N W;K
A Y P O M L | O P Y L A;M
X B M P K I | K P B I X;M
N Q Z L V H | Q L N H V;Z
R U J G C X | R X U G C;J
E D H Q I P | D H I Q E;P
V I O Q Z S | O I Z V Q;S
E W L B H Y | B W H E L;Y
S U C Y Z J | S J Z Y C;U
I C A Y F X | A X Y F C;I
X J V Q L K | V J K L X;Q
C B X D Z P | B D Z C X;P
H F O J K U | O U J H F;K
C D M K B V | C B V D K;M
W U T G Z S | W U G T S;Z
J R L Z S Q | L R Z J Q;S
J L E M P X | X M L P E;J
C H U E V G | V C E G H;U
J R Y T H X | J Y H X T;R
G Y D W M A | Y M W A G;D
J A E L V O | L E V A J;O
W K H B C J | B C H J K;W
B G Y E T R | R E G B T;Y
W O K X Q V | X W K V Q;O
U P Q Z X B | B X U Z Q;P
N S G X R B | B S R G X;N
R W J I L S | I W J S L;R
K O D H V P | V K D O P;H
E Y T N G U | N E Y U T;G
M H V G J R | V M R H J;G
E F X U C Z | F E X U Z;C
H I Q U B G | U I Q B G;H
D K N B W S | D N W B K;S
Z R E G M W | Z G E M W;R
M O V G U R | G R O V U;M
J W C F X M | X F J W C;M
S X H U L N | S X L N U;H
D O I F C N | O F D I C;N
X E B V Q T | T Q X E B;V
W R O C Q V | C W O Q R;V
V J F M Y D | F V D J Y;M
L A P V O M | L O P M V;A
B W H G O D | B D W O G;H
S U G T B Y | S G U Y T;B
X U H F G J | H U J G F;X
B M H V A X | M H B A V;X
S R J F K E | F K J E S;R
C P E Q G J | E G C J P;Q
O Y V J B F | Y J B F V;O
U P X C O T | U X T O C;P
T R K O I L | O R I L K;T
F R Z C D N | C R F D Z;N
H Z V L P O | P O V L H;Z
W O E F J P | E F J P W;O
Q Y R F W B | Y W B F R;Q
D A W K I R | R I D K A;W
O G F S Y X | O Y S F G;X
Q O V M A W | W V M A O;Q
L W E A F N | N E L F W;A
W R N T Q V | T W N V R;Q
W I L K V P | L P W V K;I
P B T S Z W | T W S Z B;P
R D F H B N | F N R B H;D
J H G B D R | G H D R J;B
T E P V M A | M T V P E;A
U X C T I J | X I J U C;T
U Y V Q P K | V Q Y K U;P
A T X H R C | R C A T X;H
N C Y Z L X | C Z X Y N;L
P W D U O M | M O W D P;U
K R Z U H C | R C Z H K;U
H O E B I G | H I E B G;O
S N L A J I | S L N I J;A
C W F S D K | D S C F W;K
E O P W X U | U W P E X;O
Q I V J M Y | M J V I Q;Y
W H M A V B | W A B M V;H
M W R G I D | W D M R I;G
Z P R M I Y | Z P R M I;Y
U Z P E G S | P Z U S G;E
Z Q G L X A | X G Z L Q;A
J G S L Z P | S Z L J G;P
P S L T Y I | P I S Y T;L
O N U J C V | V O C U N;J
E K Q Y R F | E F R Q Y;K
H N P R E C | E C R H N;P
U K I G M Z | K M I U G;Z
M O A H Z Q | Z M A O H;Q
K O F T Q R | K O R Q T;F
P G C V T Q | V T Q C P;G
S N T X O M | X O M N S;T
Q D T S H F | F S Q T H;D
A H Y Z U K | U A Z Y H;K
P S F R K M | R M P S F;K
U X A B Z C | Z X A C U;B
G D Y Q U B | U G Y D B;Q
Z C W N M V | Z V W N M;C
W Y G H B Z | B G Z Y W;H
Y G M C B T | Y B G M T;C
A P H E F R | R P A F E;H
N M T V K Z | K Z N T V;M
U Y T N C L | T Y U L C;N
B K S N Z F | K N F B S;Z
X F Q B A M | Q F B A M;X
I A M F O V | F V M I A;O
K R T L X N | N R X K T;L
E P X N W R | E X W R P;N
Q I U F E J | I F J E Q;U
W K D V A R | K W V R D;A
E O N F U A | N O E A U;F
I N Q R O D | O Q R I N;D
A B N I K P | I K B A P;N
T I H L E J | L T H E J;I
Z D R G T V | D G V Z T;R
L O P I Z D | I P L Z O;D
U Y Q E D A | U A D Y Q;E
Q L F G U R | L U G F Q;R
J M A N K Z | Z M A J N;K
N F E S R W | S W N R F;E
Q X R D I C | I D C R Q;X
K S L B J T | K T J L B;S
V Y W R T Z | R W Y V Z;T
O L J Q U D | J O Q D U;L
L I T P V C | C V P T I;L
U D K S N O | N U K D S;O
T J R X G M | T M J G R;X
T C K W B V | V B T C W;K
G R D N P J | D N P J R;G
N Z V X S K | X S Z N V;K
F V W A B K | B W A F V;K
F J S W A X | F J X S A;W
L U X R I S | X R S U L;I
E O L S K Q | O S E K Q;L
Y J U V G O | J V U O G;Y
T W E P M D | E W P D M;T
M Z O C W F | Z W M O C;F
H X N C B S | S X C H N;B
H A G L B C | B C A H L;G
A J T V C I | C V J T A;I
P C Y L S X | L P X S C;Y
W U O I A E | A W I E U;O
M E O H U I | U M O I H;E
H T U W B M | U W H B T;M
J C L G R I | J I C R L;G
E G B Q F J | F G B Q E;J
O K Q J P S | Q K S P J;O
G S D Z N P | D N Z P S;G
C J O Y K R | Y K J R C;O
L F P U C B | L P C B U;F
C S W J O U | C J O S U;W
M G C O T W | W M C O T;G
A J N R O B | J N O A R;B
A O S D V F | A O D V F;S
X Y A H W D | Y A W H X;D
E J I T O P | O J T E P;I
G U L I H C | L C H G U;I
O F H Q V S | S Q V F H;O
D W U A X Y | A Y W D U;X
Q V D N J Z | J Q V N D;Z
Z S W E R A | R Z S A E;W
D M U R N Q | N Q U D M;R
Z Q C Y M V | Q M Z C V;Y
E J K Q P V | P V K J E;Q
J Q V O I Z | J I O Z Q;V
P S Y K U G | U P S Y K;G
E Q R W Y L | L E Q R W;Y
Y F P H W Q | Y H Q W P;F
X I S Z K G | G K Z I X;S
Z C V A U K | K Z C U A;V
W Q D M Z S | S W Q D Z;M
S T H P V U | P S V H U;T
V F G Z D C | Z G C D F;V
K S G D W M | S G K M D;W
Z W V F U A | F V A Z U;W
G V Y P O I | Y V I O P;G
A Q N I V P | V A I Q N;P
R G S C N A | C S A N G;R
N L A W J B | J A B N W;L
N D T C S V | S T N V D;C
K M I F U Y | I U M K F;Y
V T S N B F | N B S V T;F
V F J U Y P | V J F P U;Y
Z U D K A H | K A H U Z;D
A M B K R Q | A K B R Q;M
G R B Q O F | F O G B R;Q
D C V U S Y | C U Y S V;D
X A R D G T | R A T D X;G
H R E F J Y | E R H Y J;F
W Y L S G K | G Y K S W;L
O W C Z E R | Z R C W E;O
F P Y L H I | H I P F Y;L
P T J V B G | J V G P B;T
V P G C R Y | Y G V R C;P
S Q R V A J | Q A R V J;S
P Q A S T N | N Q T S A;P
K U E W I D | E K U W D;I
Q Y S Z G O | Y O Z S Q;G
H O Q F G K | F G Q K O;H
H W R D Z F | D Z R W H;F
L Q S O R Z | L S Q O R;Z
K I D Y S P | P Y S K D;I
Y Q A X V P | Q P A Y V;X
R T M A X V | X A T M R;V
P M Q H A O | H A M O Q;P
E G T L N B | E G N B L;T
H Y R F N C | R Y N C F;H
V T Q N D X | T V X D N;Q
D Q S I V L | Q D S I V;L
P I O D M N | D P I O N;M
A W P R G M | W A R G M;P
W Z O T E X | X W E T O;Z
Z D A F T Q | Z D Q F A;T
J Z U I V Q | J I V Q U;Z
V A N F G D | V A N G D;F
Z X E D J H | X H D Z E;J
A T R Z Y B | R T Y Z B;A
M F G L J H | G F H J L;M
S I X L P W | L X I P S;W
S J U A B D | A S J D B;U
W B O H F I | W B I F H;O
R P E H N T | H T R E N;P
Q B E Y V I | Y E Q B I;V
U V K B G R | V G U R B;K
L G F I S M | G L I M F;S
R Z I T L A | L T I Z R;A
K H Z Q J U | Q H Z K U;J
B D O Q K C | B O D Q K;C
T L R E N D | D T N L E;R
Q K O E M T | K O E T M;Q
S U Q N J K | Q N J S U;K
Z G O L J B | O J Z B L;G
B K H M Z S | K B H Z S;M
A D R F L H | F H L D R;A
C Y J X K U | Y K J U C;X
R Y U K G Q | K U Y Q G;R
M X U D W H | X W D U M;H
R T H S C U | S H U R T;C
E C S R T X | R T C S X;E
Z B I K Q T | Q Z K B T;I
R N X D P Y | X R Y N P;D
U C N A F O | A F C U O;N
B F D E Z J | B F Z E D;J
O U C N M K | N C K U M;O
T A N X D J | T X D A J;N
I D H F E Z | F Z H D E;I
U C X Z O J | J O U C Z;X
A F N X K O | A K N X F;O
B K U R P Z | R B P U Z;K
L R C H I U | L C R I H;U
Q A X P L R | X L A R Q;P
V J B P F K | P V B K J;F
X P W M Y S | X P M S Y;W
I L T K S B | L T K I S;B
H R G Q C I | C Q H I G;R
E U B T L C | C T E L B;U
Z R O S J E | Z J S R E;O
E S U K T J | T S K J U;E
T R J L U P | P R T L J;U
U K M X H V | H V K X U;M
Z S Q F N Y | N Y Z S F;Q
L A I T P E | T A E P I;L
D B R G W Y | G Y D B R;W
Q R C P H U | R C Q P U;H
U Z L W S P | S Z P L W;U
U H A I V X | X H A I U;V
Z B R Y A S | Z S R B Y;A
H C Y J G M | G Y H J M;C
L U K I R X | I L U R K;X
H E Z P W D | Z E D H W;P
C T D M A P | P M D A C;T
D B R H J G | B J D R H;G
F O R U V S | R F O U V;S
O R Y P B C | R Y C P O;B
M R J O S U | R S O J U;M
S K A Q U F | A F Q S K;U
Q Y E K A C | A C Q Y E;K
N Y I Z C W | N Z I C Y;W
Q L V D A C | V Q C L A;D
W F D E M Y | W E M D Y;F
V B U Z M F | V F Z M B;U
L K B Q F W | K F L B W;Q
F D N T O Q | T F O N Q;D
G S Y K B W | B W S Y K;G
G D L R W O | O L R G D;W
M P G W O Z | Z O W G P;M
Y Z R J M F | M F R Y J;Z
B H G I W D | W B I G D;H
F L X S W P | F S P L X;W
A W F V C E | E W V C A;F
S D P J V K | P J K D V;S
I P R M Y C | R I C M P;Y
I M K X A G | I A G X M;K
Y H R C E K | Y E R K H;C
K N Z Y C G | Z N C K Y;G
Q I K N P U | U K N P Q;I
X F W N I H | H F X W N;I
K B A Z X R | R A X B K;Z
E H V X G F | X H G V E;F
Q J P A S L | J S A P L;Q
L G J P V K | K L G J V;P
V H Y N L I | Y N L I V;H
