U X P W M Z | P X W M U;Z
Z S O N P H | P O H N S;Z
K S D G X V | G K V D X;S
S C P J K M | C J S K P;M
B Y L M D I | M L D B I;Y
N X Z I W B | W X Z B I;N
A U V L W N | V N U A L;W
G Q D I M K | G K I D M;Q
A G V Z Q K | V Q A G Z;K
B X M Q Z K | K M X B Q;Z
I N G P R Z | N G I R P;Z
L N W X R C | N L C W R;X
H M J P X E | J H E X M;P
Z R B V L H | Z L V R H;B
Y Q L I H E | I Q H E L;Y
E U K M Y I | U K Y I E;M
Z V B P K E | P V E K Z;B
H U N O B A | B A O H U;N
S Q D H E J | D Q J H S;E
K W B X R P | B R W X K;P
U T M N L O | N U M L T;O
D A Z P C U | C D Z A U;P
T S A L C W | S C W T L;A
V B G N A T | V N T A G;B
M L I B T Q | L Q B M I;T
W B Z A V I | V W B Z A;I
Y S V D Z O | D O Y Z S;V
Z E J I Q D | Z Q I J D;E
R U Q T H M | M R Q H U;T
K Y O M U J | O M U Y K;J
R E N A H V | N R A H V;E
M Q O E Z K | M O Z E Q;K
A J Y I E O | O J I A E;Y
T K P M U W | K P M T W;U
F L C H E J | L E H J F;C
G T F B V O | G T V B F;O
D P S N O Q | Q S D P N;O
Y H Q N I T | H Y I T Q;N
W G V Q P Z | Q Z W P V;G
G O J K P N | K O J N G;P
J A B Y N Q | A J Q Y N;B
X K V H P R | K R X P H;V
U L O N S H | N S H O L;U
N Y W F K R | N W F Y R;K
Y X A I S K | K Y S A I;X
G C I X S E | X E S I C;G
B Q Y C Z S | S Z Y B C;Q
W C N S L O | W N C O L;S
G K R N T Q | Q T R K G;N
U Q B N T V | T Q N B V;U
H T D I P M | I T D H M;P
F T D K U S | D U F T S;K
E T A K O F | K O E F T;A
I Z O S H D | H I D Z S;O
K H Q U V I | Q V I K U;H
N U Q A D M | D M A N Q;U
G A T L E O | L G A T E;O
E J Z Y F Q | Z Q Y E J;F
B Z A J S H | H B S J A;Z
P X I D V Z | Z P I D X;V
V Z O X N H | H V N O Z;X
H T D R U S | D U T H R;S
N T W R S B | S W R N B;T
A T K V Y X | T V A K Y;X
J D O I U S | S I J O D;U
F Z X H S U | U S H Z X;F
A Z M P C W | M W C Z A;P
Z K T N W Q | W T Z Q K;N
D T X Z W Y | W D T X Y;Z
U N E X V J | V J U N X;E
B P W H E M | M E B P W;H
N X F I E T | E N T F I;X
Q B D C N O | O Q B N D;C
O N E X R L | L X E O R;N
A Y X H N C | X N C A Y;H
R D S A N K | A R S D N;K
R N Y W J B | B J Y R W;N
W J M X S I | S W X I J;M
S Q M Y W F | M F Q W Y;S
G P C X O B | C B P O X;G
I C E S J X | E C J I S;X
K M W T L O | W T M L O;K
Y F C U Q P | C Y P F Q;U
S C P J O Z | C O S Z J;P
D R G A M L | L M G R D;A
T Q N H M G | H N Q G T;M
S X M H U K | S U K X M;H
D N H M I W | D H N M I;W
F V Q A L D | A D Q L F;V
P N U G S D | P G D U N;S
K B W G T D | W K T D B;G
I K X P V W | V I K X W;P
J T K H O W | T K O H W;J
C R W L T A | R L A W C;T
L A O E C H | L H A O C;E
A Z F L Q Y | A F L Q Y;Z
J K R O F I | F O R I K;J
I O R U X H | H X I U R;O
N E C J Q A | N Q E C J;A
J F Y G P N | P F J N Y;G
U P M H S A | M P H A U;S
F B O V Z N | O F Z N V;B
L H P O G B | G B O H L;P
I Y W B H P | P W B Y H;I
I L D Y G N | I L Y G D;N
N E D S W K | K E S N D;W
C J M I P Z | I M C J Z;P
V P T Z F R | P T R Z V;F
S W A E H R | E H R W S;A
S M E L Y P | Y L E S P;M
I S J M F X | J F X I S;M
X W M Z R Y | W R Y X Z;M
T L I B F X | X L I T F;B
R W F J T P | F P T J R;W
C S T B H Y | H C T Y B;S
A N H K X R | N K H A X;R
K L Q T J N | K L J N T;Q
M C O X V B | B C M V X;O
I S V U G N | N G V U S;I
T L S Q Z E | S L T E Q;Z
G Y T Z O J | G O Y T Z;J
W A V G N D | V N W D A;G
G Y B I M S | S B G M I;Y
E P Y A K O | A P K E Y;O
Z H A V U L | U Z L V A;H
E I F L X V | E L V X I;F
P N O J X G | P G N X J;O
Z K W H T R | H R K W Z;T
R H I M T G | I M G H T;R
R D G E F B | B E F G D;R
J W U L N H | J L W U H;N
X A N R O L | A N L O X;R
T A N S C E | T S C E A;N
W K G N Q S | Q W N S K;G
A L E Y C P | C E P L Y;A
E W F T O D | W E D O F;T
I R Z O H G | I H O Z G;R
Y O M L D P | M Y P O L;D
Z W O M B I | O B Z M W;I
F X J T H Z | Z J F X T;H
Q F U X V O | Q U V O F;X
S Z D J T F | J T Z S F;D
Z I M W E J | E J I Z W;M
W L D C Z A | C D A W Z;L
V Z T G X J | V G Z X T;J
Y Z E A J G | G A Z J Y;E
Q Z V S G T | Z G S Q T;V
W C B N Q F | N Q B W F;C
I H M T F Y | I Y T F H;M
T P C Y R W | T C W P Y;R
W K G V B N | G N K W B;V
N Y K L H D | Y D K N L;H
U C P K G W | G W U K C;P
C Q B E X D | C E B Q D;X
E B D A V T | B T V A E;D
X M R T V F | T F M R V;X
K S Y Q N T | N Y Q T S;K
U P N Y O I | O P U Y I;N
E F H W C K | E F K W H;C
X E F Y A N | N X A Y E;F
A C H L N M | M H C L N;A
T W Q C M V | V M C Q T;W
H T E I J P | H P I T E;J
G L N C V X | C G N X V;L
L E F B Z D | F B L D E;Z
S V Z M U L | M Z L U V;S
W E L H D J | L E D W J;H
U I V M W G | V W U I M;G
H F Q A D E | F D E H Q;A
E T V S M X | X T V S M;E
D V L O A W | V D W O L;A
D P K O I S | O K S I D;P
Y I X Q L S | S Q Y X L;I
S K R T Q G | Q R G K S;T
H L B T C G | B C L G H;T
O V G X H I | V G O X I;H
O R I T P V | V P T R O;I
V F T X S M | S F T M X;V
U Z M J G R | R J M Z U;G
U D Q V O E | O U E Q V;D
D M Z U F P | M Z U D F;P
A S L W E D | S D E A L;W
R W P N Y M | P R M W N;Y
A D H F M E | E F H D M;A
E P W A D X | D A P W X;E
Z U H S J C | S C Z H J;U
Z Q N B P A | B N P A Q;Z
K E I S F N | S E F K I;N
I O T Q A X | Q A T I O;X
K W H V U Q | V W Q K H;U
Q T W A Y B | T A W Y B;Q
F N Q K V M | K M F V N;Q
J K T N X O | O T K N X;J
D S N B E H | H D N E S;B
L J Y A O Q | A O L J Y;Q
S W P L M C | C P M L W;S
G S J E Y X | Y X J S E;G
U L A R X V | R U V L X;A
A B X W H O | X B H O A;W
D N G R L Q | G D L R Q;N
J A S L W Q | W A Q S J;L
R X M K W F | M R W F X;K
V Z X B O S | S Z X V O;B
G V E I Y M | G V I Y M;E
I K A V E B | V B A K I;E
R D A M J T | M J A D T;R
R I H W L A | L W A R I;H
K T Q W H F | K F Q W T;H
C T N K L A | T C A N L;K
C D P E V Y | V D P C E;Y
I O H W R X | O W X I R;H
Q U R D J I | R Q D J U;I
V Y R H J U | U Y H J V;R
H X K J O R | X K R J H;O
P D C S I R | R C I P D;S
O P U R W T | U T O W P;R
J H O R D C | H R J O D;C
J Q F B V M | B M Q F J;V
Y W M J Q O | Y W Q J M;O
N A X C B E | X B E N A;C
W C T H D A | A W T D H;C
P L Y T C B | L C T Y B;P
Y I D B U Z | Z I Y D U;B
N W D A Y G | G W Y A N;D
O A T M J B | O A M B J;T
L A O B Q I | Q B O I L;A
A C E N Z X | C N A E Z;X
Z S R D O J | O D S R J;Z
G J A P U Q | U A J P G;Q
A X B V K L | B K A X V;L
C K L J E Q | E L Q J K;C
A W C H F N | H W F N C;A
S N U W T L | L W U S T;N
U J O C B R | R C J B O;U
S H O I M J | S I O H M;J
A F C B G U | U B A C G;F
T L W B Q G | B W G Q L;T
G X P I E F | G F E I X;P
F Y R T E I | I R E Y F;T
S B L X F U | X F U S L;B
B P R Q U A | Q B R U P;A
Z F D T Y B | Y F B T D;Z
D X S T P I | D S X P I;T
C X D P U J | U P C X J;D
J K T E L Q | Q T L K J;E
C G A V Z Q | Z C G Q A;V
G A S Q I E | I E S Q A;G
I D W S J N | S D W J N;I
R F C M I U | I R F C U;M
F Y W V S D | S W F V Y;D
F R P N M B | F M R N P;B
L N S T E G | N T S L G;E
W H D Y M R | D M Y H R;W
X R D A E U | R A U X E;D
Z M O V P Y | V O Z P M;Y
G I M W Y V | I Y G M V;W
T U X C G D | C T G U D;X
T Y C N Z Q | T Q N C Y;Z
M X Q K Z O | Z O M Q X;K
B M L E I P | E B I L M;P
F D U H Z Y | Z H U F Y;D
A D Q J K C | A D K J C;Q
T E G I C L | I G T L C;E
P U S E Q B | U E P Q B;S
L S H U E A | S A H U E;L
R L A M B Y | A R L B Y;M
E Q W Z R N | E N W R Q;Z
E Z G F A D | D F G E Z;A
Z E W T H S | S Z E T H;W
E W U S I F | E W U I S;F
V B N A C L | C B L N V;A
T G Q W L B | Q T L G W;B
N X T A U P | X T P N U;A
N E W G F U | W U G N F;E
E D S Q T P | D P Q S T;E
I G T O V A | V I T O A;G
U S X D Q V | D U S X Q;V
P Q E C I B | B E I C P;Q
I T F P X S | S I P T X;F
G N S J U M | G U S J N;M
B A I O T M | I B A T M;O
H I S T N U | H I T S N;U
K R S L N U | U R L N S;K
H C E F Q Y | E F Y Q H;C
G R C S Y W | G Y W C R;S
H S K Z G I | G S K Z H;I
F G E Z C B | B Z C F E;G
A Z C O H N | O N A H Z;C
J H A T N R | J A N T R;H
P T Q G O J | O T Q P J;G
U T F X B V | F X T B U;V
S W Q N A G | A Q S G N;W
P K N S M T | K N T P S;M
P L W C B G | P L W C G;B
U K C W L J | K L W U J;C
R Q A C T K | Q K R T A;C
T D U A I Q | U D I T A;Q
L R U X C G | C R U L G;X
X E L Y V N | X E N L Y;V
J K X M B Z | M K J Z X;B
R W S A E X | W X A E S;R
J D Z F Q W | W Q Z D J;F
N A S X V U | S X U A V;N
W M K S N E | E M W K S;N
W H V L O J | O J V H W;L
Q H I K B J | I H J Q B;K
S N H A L B | S H N L A;B
V E U I L Y | E U Y V I;L
D G O J T C | O G T D J;C
M I Q R D H | D R I M H;Q
J U F V W D | U F D V J;W
Y D Q O J S | Q Y O D S;J
K H M L F B | L M H K B;F
E F G L V K | V F L K G;E
G Y V K L T | G V K T L;Y
Z L O S J T | S J T L Z;O
W K C P U Y | Y U W P C;K
P O H D Y S | Y S H O D;P
H F Z R Y O | O H F R Z;Y
Y F D B Q X | Y B X D Q;F
V P S F G X | F S X P G;V
O D I K Z B | I D K Z B;O
M F G I V Q | I G Q F V;M
B Z P R N L | N P L Z B;R
V Q M G I B | Q M I B V;G
R Z A C K F | K R F Z A;C
Q O D S J Z | D O Q S J;Z
Q P T R S Y | Q R T P S;Y
W Q M L P Y | Y P L M Q;W
W O E B G N | G B W O E;N
N T W X L O | N L O X W;T
H M T Q I A | A H M Q T;I
L J C W D K | K W D C J;L
V D J O S P | S P V J D;O
Z V P A T E | V E P Z T;A
F L U T X S | U T X F L;S
S L I Q R Y | Q L S I R;Y
X Z W F B E | B W X F E;Z
R F D L C M | C R F M D;L
N A S B W R | S N A R W;B
N T I G W B | I T W B G;N
H J P I L C | L H I J P;C
D P W E S C | P C E D W;S
V R M I U Y | M V R Y I;U
V Q G U T Y | G V Y U Q;T
E T U P M L | L E M T U;P
A E I O R S | I S E O R;A
P H T C E J | C T H J E;P
X G P J D N | G N X J D;P
U C S R F E | R C F U E;S
E B X V T K | E T V B X;K
G O A S B I | G B O A I;S
U I T A N W | U T W N I;A
M J G R Z P | P J M Z R;G
P K R O E B | B O E R P;K
C T E L I S | S T C I L;E
W M F V B A | W F A B M;V
N A G P F J | A G F N P;J
N U F V B Y | B U Y F V;N
Y Z X E P G | X Y E Z P;G
K Z G D Y N | D Z K G Y;N
L G Q X R W | R L W Q X;G
R L N G Q S | G S R Q N;L
G H Q E A W | G A Q E H;W
Q B I L T K | B K T L Q;I
E Q O P M H | E H Q O P;M
B S Y P E V | E B Y P V;S
I W N B Y S | B S W N I;Y
Q V X K G Z | Q K V G Z;X
Y D E J R T | D T R E J;Y
G S C L V D | D C G S L;V
X N M O D K | M D X N K;O
J X W M F B | M B F J X;W
V C X L N W | L N V C W;X
V W K Z J G | G K J W Z;V
B J Z X W U | W J Z B X;U
S L U R K H | R H U K L;S
F Y L T I Q | Q T I Y F;L
V Y R H I A | I V Y A R;H
S O J R T F | R O T S J;F
E W M K Y L | E L Y K M;W
J Z W N U E | Z E N W U;J
F V U T X N | F N U X T;V
E Z P T B U | Z B P E T;U
M N S U R X | N R X S M;U
W Z V N B S | Z N B S V;W
Q C V U M D | V C D U Q;M
Q K E A P U | A U P E Q;K
O R K S N I | S K I O R;N
M T P C X Y | C M P X Y;T
D R N J G Q | G D N Q J;R
E N W X V Q | Q N W V X;E
T W Q I U F | Q U W F I;T
M B X P Z W | X P Z W B;M
M U F C T N | M C U T F;N
Y F B N P V | B Y N V P;F
N Y I K J E | J E I N Y;K
A N M B D Q | B N A D M;Q
L F X J B V | B F X J L;V
V R G N Q X | N V G X R;Q
I K Z V P R | I K Z P R;V
C L O N M W | C M W N O;L
N F G C W A | C W F A N;G
M K S Y V X | X K S V M;Y
U C Y O F J | F J U O C;Y
Y R I E L C | C E I Y R;L
K E G F W I | K F W E G;I
T C Y Z U O | O C Z U T;Y
H L B W P X | H B X W L;P
M B K T I A | T M A B K;I
N Z W U C K | W Z U N C;K
H L D N Q E | Q E N D H;L
D O A W X P | O W P A D;X
R D C K M S | M C D K S;R
J F S B K A | S J F A K;B
K Z D C H A | Z D K C A;H
L K A W V Y | L A W Y K;V
Z L X S Y M | Y L M S X;Z
S E Y D F G | S F D G Y;E
J Y V Z D O | V Y J Z O;D
U V K A E P | P E V U A;K
W Y O K T R | Y T K O W;R
F N J Y I E | Y I E F J;N
Z O E K M T | K O M Z T;E
N Z C J H A | N Z A C J;H
W P X L B G | L P B W G;X
I K X Z G A | G X K I A;Z
W U F V Q N | U N F W Q;V
A C B Z R P | B Z C A R;P
W C S O L X | X W O S C;L
L J I U T K | U K J I L;T
B L V Z R T | L R V B T;Z
N A B W V O | W N V B A;O
Q X R M F A | F Q A R X;M
W F P V R A | W V F R P;A
G V Z I M E | M I G Z V;E
L H U N O Z | U Z L O H;N
N J Z G F S | N Z F J G;S
B I C V R W | R C I B V;W
Q M Y F Z C | Q Z Y M C;F
Q E C Y R U | E U Y C R;Q
N J P S K L | L J S K P;N
Q R D W V T | V T D W Q;R
K M J W R Z | J K R W Z;M
K I J B V S | K S V B J;I
N G W P X R | N X P R G;W
J P O U M E | J M O P E;U
Y O M N K A | A N Y O K;M
E O W P Q H | Q P O W E;H
I R O M E F | E I R F M;O
R H O I A F | F I H R A;O
P W H E N Q | E Q P W N;H
L A M N O I | L O A I N;M
M C L B W D | L M W D B;C
N W L Y E X | E X L W Y;N
T S C U F D | C U D T S;F
X F O N J P | N P J X O;F
U E D O T Z | D Z U T E;O
A C O X M F | A M O X F;C
E M R A N U | A U N M E;R
N K Q H Y W | H N W Y Q;K
H S O D M Y | M O Y D H;S
A J P K D N | N J D P A;K
I P H Y D J | H Y I J P;D
E R H A M Z | Z H A R M;E
S A P J Z U | U J Z P S;A
L O P J Z Y | O Z J L Y;P
L R Z E Q F | F R L Q Z;E
L K C P M D | M D K C L;P
B F J U A I | F J A B I;U
L C Z I R N | Z R C N I;L
C J A T B S | B J T A C;S
H P O S U E | O H E S U;P
T J Z I F P | P I Z F T;J
I O A W K C | K I W O C;A
J W V F H A | J A F V W;H
N E T V P B | B P N V E;T
Y U J F G A | Y G A U F;J
S L D K G J | D J S K L;G
K L S P H Z | S K P Z L;H
R F A N P M | A M F P R;N
W N Z A C R | A Z N R W;C
U Y A R H W | Y H W A U;R
J F C H V M | H V F M C;J
P H A O Y D | P H O A D;Y
W L D V A G | G V L D A;W
M O F Y B U | Y O F U M;B
V I A X Q L | I X V A L;Q
X B V Z R M | Z V M X B;R
I F N V Q O | Q V N O I;F
J X W E Y U | W E Y X J;U
N D P A C E | N P C D E;A
R V X O C Z | Z X R V C;O
K R P V Y D | R K D P V;Y
R T O H A K | O K A T R;H
B E D A X W | E D X A W;B
G Z X C N A | C G Z X N;A
L D Z T A P | Z A T P L;D
Q V O A H G | G V H Q A;O
R U X S H E | X H U S E;R
U H L O Y Z | O Y H U Z;L
B L N K R E | E R L K N;B
Q E V J C B | C V E B J;Q
W K N Q X R | N Q W X R;K
B H E W X D | X B H E D;W
A C E W G J | E W J G A;C
T M S D R W | S T D M W;R
V M X Z C O | V Z X M C;O
I S B E X K | B S E K X;I
D O T Q I P | P O D I T;Q
E M P U Y H | P H U Y M;E
U Y K W Q L | W K Q U Y;L
S G Y P I O | O S I P Y;G
T M G N B P | N T G P B;M
S Z I R X U | I S R U X;Z
X A F K Y Q | Q X F A K;Y
H T N C F Q | N C Q H F;T
F G Z J A I | J Z G A I;F
F B R M Z T | B T Z R M;F
H B R G U M | U G M H B;R
O D X A H S | H S X A O;D
D B I C O V | D C V I O;B
T D E K L Y | L E T Y D;K
G Z F N U E | Z U E F N;G
D Y L C B J | C B J Y D;L
A O E I Y X | X I E O Y;A
X O F S J R | X J R O F;S
N W C B O G | N O C G W;B
D O F C Z J | F J D Z C;O
I X M Q O R | R O X I Q;M
P G C S T H | C S T P H;G
U O W B R E | B R E O W;U
Q H Z I A O | O A I Q H;Z
M P U W V A | U A P W V;M
I L A X K C | C I K L X;A
T I F V A Y | Y T F I V;A
W X C G D F | D G W F C;X
U T H J Q F | J U H Q F;T
I M X K B L | M I L X B;K
Z N A Q L T | Q Z T N L;A
W S I M Y N | W I N Y M;S
L M K W Y J | Y L J K W;M
Y Q X H U R | H U Y Q X;R
T H Q P W K | K W Q H P;T
A C P I X Y | X I P C A;Y
L N G I O M | N G I O L;M
D N O U X G | U N G D X;O
J L H D E O | O H D L E;J
S W C K U Q | W Q U K C;S
C W X A J Y | J W X C Y;A
S I Y Z E T | E Z S T I;Y
W H Y A G T | W T H Y A;G
D M T J E Q | T J E M D;Q
H C L F R N | L F H R N;C
L Q R H A E | Q R L A E;H
P B A V K X | K A B P V;X
T U V N O Z | T O U N Z;V
Y B O L K M | Y O M L K;B
T L P M U Q | L P T U M;Q
S N G U M B | N U G B S;M
E D Z R P L | Z R D P E;L
S E J V Z H | E J S V Z;H
L C B W N G | W B N G L;C
T S V O I E | O I E V S;T
H P R G J V | H G R V P;J
Z T A W S M | Z W S A M;T
Z U I O M V | O Z U I M;V
T H E Y X M | X H Y T E;M
F K I A V X | A V X F I;K
C K W U T A | A K C W U;T
R G M C T P | G T P R M;C
J L F D A Q | F L D Q J;A
K N P W M B | P W K M N;B
A B Z R U C | C R A Z B;U
B Y J F M X | F B M J Y;X
Q D A E W K | Q W E D A;K
X V J T N U | V U N T X;J
F P W Y U B | P Y W F U;B
D Z B S T I | I T D B S;Z
V F C Y Z W | Y C W Z F;V
B P H I F W | H I P F W;B
L D Z G I Y | D Y L I Z;G
W J L R T U | L T U R W;J
R B D K N P | B P N D R;K
A X O N F B | B F O A N;X
C T V J H A | T V A J H;C
W Z U Y K P | P U Z K W;Y
O A R G N D | N D A G R;O
A B Q H M F | H Q B A F;M
U Z G Q M I | Z U I G M;Q
H O T M B Z | H T M Z B;O
A W V X G L | W G X V L;A
P M B N F X | N F X B P;M
I M N C T B | N I M B T;C
U K M Z W C | C Z U K W;M
H L J G K Y | J Y L G K;H
H A T F M O | O M H T F;A
D W R A N J | R W A J N;D
J K E X I V | X K E I J;V
W A B K O T | W O B A T;K
H K J X L R | X R J K L;H
F N H P D L | F H N D P;L
R W M L B D | L R B M D;W
U G V L P E | U L V P G;E
O R T Q W P | O Q P T W;R
B R M I Q A | Q A I R M;B
K N U S Z B | U K S B N;Z
U M Y D C O | Y U M O D;C
T I Q X W J | W J I X Q;T
A X H D K Y | A X D H Y;K
R U B W C V | R U V C B;W
A U V F X O | V F A O U;X
G I F N R P | R F P N I;G
J Y Z H S L | L S Z H Y;J
X M Q Y C N | Y N X Q C;M
S P Z H C Q | C Z S H Q;P
F J G X V H | V F X H G;J
N H X D Z Q | Q D N X H;Z
S Z C Y I Q | S Z Q I Y;C
X J F T C Y | Y X J C F;T
E Y U M L V | U Y M V L;E
U X M R A Z | R M U A X;Z
V F W X R Y | X F V Y W;R
Y H Z G I K | Z I G K H;Y
B I X D L C | X I L B C;D
L A M S G U | M U S A G;L
I O C A D Z | C I D Z A;O
Y F Z J T H | H Z Y T J;F
M T I U R K | R T M I K;U
V S R O B U | O U S B R;V
G M T Z L D | T M G L D;Z
X B M G H K | B X M H G;K
W P O E A F | F E P W O;A
E Z Q Y A X | E Y Z X Q;A
L H F Z E R | Z H F E R;L
D A V B T Z | D B T A Z;V
Z F L X K M | K M L F Z;X
R Z G E X F | G Z X F R;E
L U A G X J | J L G A X;U
G C H N E O | G N H C O;E
C I T H V E | C H E I T;V
V F Y A J C | V C J Y F;A
K V B A M P | V K A P B;M
C M U J Q S | Q M C S J;U
F Q Y O S R | O Q S F Y;R
P C Q T O M | P M C Q T;O
A K J T Y B | B J Y A K;T
X L D Z Q I | X Z Q D I;L
D V F K U Q | U V F K Q;D
B A T X H E | X T H B A;E
D Y Z A R W | W Z R Y A;D
P Z D U H A | P D H U Z;A
W Y K J O T | Y T K W J;O
C M U R S G | G R U S M;C
M D E O P G | P O D M G;E
T D L Q F P | D P L F Q;T
F H R T W Z | Z F R T W;H
O C G T V H | T G O H V;C
I U J E B C | I U E B J;C
Z N O U H S | N U S H Z;O
T S G F L C | C G F S L;T
F K D A W C | C D A W F;K
W A K P X B | X W P K A;B
C B L K Z N | L B N K Z;C
O Q L P I J | O I Q L J;P
X S L T W F | W S F T L;X
Q K M I Z V | Z Q V M K;I
W G O U P L | O W L P U;G
E Q I O L V | V O E L Q;I
R C H V Q J | H J C R Q;V
Y A I X F K | A Y K I X;F
X F L Q S K | K L S F X;Q
R C I Z N E | R C E Z N;I
L A J N Q T | L N Q T J;A
F K R D S A | A D F K R;S
U T O Z M B | U Z O T B;M
H Q K E C A | A C K E Q;H
R V W J E U | V W U R E;J
Z H F E O Y | H Z F O Y;E
Y F U R T D | D U R Y T;F
D A P J N R | P D J N R;A
X Z S M B K | B M S X Z;K
X J A K H Q | H K X A J;Q
Y Z W H P U | H U W Z Y;P
V S W A F Q | Q V F S A;W
V W E B R U | U E R V W;B
V K N E S Z | E N Z K V;S
D Z B F A J | F D A B Z;J
Y S R V B U | S Y R B V;U
S E Y N I V | V Y S I N;E
L S P R Q F | S L F R P;Q
X G D N C W | G X N D C;W
C G I Q E O | E I O G Q;C
A H N P M K | M P K N A;H
L O K D V U | D O V K U;L
O Z M J B W | W J M O Z;B
V F I Z E J | J Z F I V;E
W L S Q V C | Q V C S W;L
O L B P V Y | Y P B O L;V
L D S E T X | L D E S X;T
P R E M Y G | P G R M Y;E
G N P X I C | P I G N X;C
O E U P X Z | P U X O Z;E
Q I J N D A | D A I J Q;N
D V G U O H | O U D G H;V
W J Q D O M | W Q M O J;D
J K F X G R | X G J K F;R
B T L F D S | F L T B D;S
O G B M U S | M U O S G;B
H O A I J B | I B A O J;H
H Q W X P S | W S H P X;Q
C Q H S N K | K H S Q C;N
B J Z W E P | P E J B W;Z
L R Z P C Q | Z Q R C P;L
G S X D R V | D S R X V;G
T Y B P D C | B C P Y D;T
F R K Z M I | F Z R K M;I
Y P X K M A | X P K Y M;A
N W V Z T I | V N Z T I;W
F P W M S T | M W T P S;F
R S Y J F M | R Y S F J;M
O Y X B I J | I O X Y B;J
K O V W Z E | K Z W V E;O
F Y I S C Z | F Z Y C S;I
N Q W G J Z | J Q G W Z;N
X L G Q V B | Q X V G L;B
O H V W X R | O R W V X;H
I C W Q O N | O Q W N C;I
E Q D H M V | D E V M H;Q
B L Y G M W | L B M Y W;G
V U W T C J | T C V J W;U
D H O W Y R | H Y D R W;O
Z K V T H B | K T B Z V;H
Y D L B J V | Y B L J D;V
G O T Q K V | V O K T G;Q
C A Y H G K | C G K Y H;A
V U B I X H | H I V B U;X
W Q R D B P | P D R B W;Q
Q Z P O I L | Q Z O I L;P
L V F N P Z | F L Z V N;P
S Q F P O X | O X F S P;Q
J Z P F T C | P Z J C F;T
T M X K Y P | X K M Y T;P
Z W V Y A P | Z Y P A V;W
O H X E T P | X E T O P;H
U H E A N L | N L H U E;A
C O J E G I | G J O C I;E
J G R S D X | X G D S R;J
H K S Y G T | S G Y H K;T
O R H E B Z | B E H Z O;R
A Z T K M B | M A Z K B;T
A C T W M G | A M T G C;W
K D U H T Q | Q D H U K;T
U C S A H J | J A S C H;U
Q W R N E M | E Q R N M;W
D T B G L A | A L B G T;D
K Y F G O L | K G Y L O;F
X Z V D R H | R D Z H V;X
D Z K Y P V | D Y K V Z;P
O Y W T E Q | E T O Y Q;W
X W Z C Y D | W X Z Y D;C
Y U W R J C | Y C R W J;U
G I W L J D | J D W I L;G
L K P B A U | B K L U P;A
E T P B G H | G H B T P;E
V Y I G J A | G I J V Y;A
E T I P R N | E N I T R;P
H D C P F B | P B F C D;H
S P G F K B | F P S B K;G
X H R J F P | X H J P R;F
D X F M P J | X D F M P;J
D B F P U W | B W U D F;P
L W D J K C | K W L J D;C
Z X D E J Y | D J E Z X;Y
Q F D Y U I | I F U Q D;Y
E M O S J Z | J S M E O;Z
O D H I J B | H B J O I;D
F R O U X Z | F U R O X;Z
G Q K V U N | N G U V Q;K
L R W B M Q | Q M L W B;R
Z Q E L M V | V Z E Q L;M
Y N T E S J | Y T N J E;S
M K O Q L J | L Q O M K;J
N T K Q P C | Q P N C K;T
T V R D P B | P D B V R;T
Z S U P E T | Z U P E T;S
E L K D H G | L G D H E;K
G C P I Z R | P Z C R I;G
K B R V L C | K B C R L;V
U L T O E V | V U L E O;T
Y R M I Q T | R I Y Q T;M
E J O A C L | E O J A L;C
C F D E K A | F A E C D;K
E G N U K O | E U O N G;K
A E I G D K | G D K A E;I
X B R L D A | B R A L D;X
D H W S U X | W D S X U;H
W Z L A M I | W M L Z I;A
F I H S V C | S C H I F;V
D T V Q F O | O T Q F V;D
U M H K X Y | Y M H X U;K
W S O N A K | S K W O N;A
D N E H I F | N D I E H;F
O I P R F U | F R O I P;U
D N V A Q X | X V A N Q;D
H U N G P B | H B P U G;N
X J L S N T | S L T J N;X
L C K I J A | J L C I A;K
L F B I K Q | B Q K I F;L
G L I C T B | L B I T G;C
E Z R G C P | P R E Z C;G
B C V A T S | C T B V S;A
U N B T Y P | T N U Y B;P
N V O B I G | O N G V I;B
C S R D Q Y | Q C D R S;Y
O J W D C A | W O D C A;J
D N Q I Y S | Q I N S Y;D
X H V J K Z | V K J Z X;H
W O X Y Q H | Q H Y W O;X
W F C H U Z | F H W Z U;C
U Q N Y I L | L Q U I Y;N
N G B A T H | N A H G B;T
P E R K J G | E P R G J;K
W F B A H S | F A W S B;H
Q R V F I O | I F R V Q;O
S N X W V B | W S V X B;N
O Z U T L Y | T Z O U L;Y
C D B T R P | D R P C T;B
Z P F B J W | Z P F B W;J
T Y K H M C | M Y K H T;C
U M Y X B Z | B Y U Z X;M
Z C X R Q Y | Z Q C X Y;R
S U N W O F | F W U S O;N
K I X V T L | L X V K I;T
Z Y D J I O | Z Y J I D;O
Z D J N P M | P M N D J;Z
E V A W Z P | E Z V A P;W
V Y F R U H | F H R V U;Y
X D I J U W | U J W I X;D
G O C V I Q | V O C I Q;G
W Y Q A J Z | J Z Q Y A;W
L K G P R O | P K O G R;L
X K J L Z D | D Z J K X;L
I Q V F R W | R F W Q I;V
V G A X T Y | G V X A T;Y
H C E O G K | E K H O G;C
H S G I J F | G J S I H;F
M P R E T S | R M S E T;P
D N B R A H | A D B R N;H
D E L M U X | E U M X D;L
Z L F U J Q | U Q F L J;Z
B P W M A H | B A P M W;H
F D U X J T | F D J U X;T
T O W J M B | M O T W B;J
L Y J F H E | H J E L F;Y
L Y B S U Z | Z B U L Y;S
A C X E G D | X D G A C;E
V B M N L G | N M L G V;B
Z B R F A T | R T F A B;Z
B E H N Z P | P E B N H;Z
U N C T X H | N U T H C;X
Z E B M W Y | Y B E W M;Z
H U E O R B | H E B R U;O
Q A Z T G K | Q A T Z G;K
Y B P A C M | C P M A Y;B
Q C B Y P Z | Q Y B C P;Z
I E B R V H | V B I E H;R
O K L N X P | P N X O L;K
X S R A D C | D A R X C;S
X K O U Y N | Y N U O X;K
W V R C A U | V U A R C;W
J L V T K Z | Z J L V T;K
G I X K T Y | X I G Y K;T
M Y I U X Q | M U X I Y;Q
D P E J H X | H J P E X;D
J G C Q H X | J G C X H;Q
Z M H A N U | N H U Z M;A
X Y P K O V | K Y P O X;V
V I K J E S | I S E V K;J
O I Q E D H | Q O D E I;H
H V E L C F | H V L E F;C
S A L T K W | A W K T L;S
Y C P Z X M | Z P C Y X;M
W I A J C L | I L C J W;A
G J X K W V | V K J W G;X
W Y V X D L | V D L Y W;X
C J Y G A T | T Y A C J;G
L V T Q D W | L W D Q V;T
B R N U O I | B U I N O;R
U B S A I X | I A U X S;B
X D A L W K | W X D A K;L
X Z A C M B | A Z M C B;X
E Y V U N J | J V E U N;Y
T Q Z E H V | V E Q H Z;T
F U R N B T | F B R U T;N
N Z S V Y B | V Y Z B N;S
G F Q P I S | I F P Q S;G
C E X Q T O | E O Q X C;T
T E Z X D J | X Z E J D;T
V Y M G U C | M V G Y U;C
M X V Y E G | M G Y V X;E
A I V M X E | M V A E I;X
G I R X F P | F G I P R;X
Y N M I C S | N M C Y I;S
B E H M S A | A E S M B;H
Z A N O U F | U A O N Z;F
F A P Y Q R | P R F A Y;Q
B Z F W C D | B W C F D;Z
R N Z H U Y | R N H Y Z;U
P O Z N E I | Z O N I E;P
K X A W S Z | S A X K W;Z
P I S D T A | I A T D S;P
L I Y Q P S | L S Y Q I;P
S P Q J Y B | P B S J Y;Q
Y X T O A Z | Z Y X O T;A
X V Z T P Y | T X V Y P;Z
W B G L V K | B L G K V;W
F Y A B T G | B Y T F A;G
E X C F S W | E C S F W;X
C B V H D A | C D B A H;V
A R N Y S C | R S C A Y;N
E T K M I V | M E I T V;K
S G P C A Z | Z A C G S;P
H P R V Y A | P Y R H A;V
K J M D U I | U J D K M;I
C U K M T L | C L T U M;K
F B R Z C U | B R Z C U;F
I W H D M A | A D H M I;W
U A M E N K | N A M K U;E
B A P W H O | A H O W B;P
Y B F G W A | G B Y A F;W
A Z E V X G | E Z A X V;G
X R A I F O | O A X R F;I
C X W S L H | S X H C L;W
K E P O I V | P E O V I;K
N B G H V S | N G H V B;S
F B Q K T I | B K T F I;Q
N X Q U Y M | M Y U Q N;X
G B Y T V E | G V Y T B;E
U T F Z S E | S Z E F U;T
C D J W B Q | C J D Q B;W
Z Y B F T W | Y Z B W T;F
F K X J S M | M F S X K;J
K L U J W O | K O W U J;L
C K I E M W | M E C I K;W
A S J M I O | O J A M I;S
I S B H A P | P B H S I;A
C L D J F N | D C F J L;N
X F L G V B | G F B X L;V
N A X S B O | A N B O S;X
V M S F I U | M S F V I;U
R Z G A D I | Z G A D R;I
B H O A Z D | Z O A B D;H
X R F N U I | X U F N I;R
U N Y E O J | Y U N J O;E
N T L Q U W | T Q N L U;W
D E C B G R | D B E R G;C
S L F B T P | F T L P B;S
P E J G W L | G E L P J;W
X H L D M C | H D C L X;M
U I P K O Y | O I P K U;Y
R A H J G P | A J R P H;G
L Y N U B O | Y O L N U;B
X D V G B Y | Y D B X V;G
K O Z Y V R | K R O Y V;Z
K X H S Y Z | K Z X Y S;H
O L B T Y M | T L O M Y;B
X G A S U Z | Z X G S A;U
D A X B L T | A L T D B;X
O R A E F N | O N R E F;A
W E R F O P | W O F P E;R
M E B N A V | N A B E M;V
B E A H S M | B A S M E;H
Q O R C V P | Q C V O R;P
Y N D A Z G | G A Z N Y;D
W Y D R X P | W P R X D;Y
G T J Z S X | G X Z J T;S
S U A V N M | U M V A S;N
S M G D K T | S G M K D;T
H O V L Y J | J L V Y H;O
Q W T R L X | L R W X Q;T
G N T U P W | N U W P G;T
V Q U L A S | S A U Q V;L
D F J X M Y | X D M F J;Y
Y N W D B F | Y W F B N;D
D Y N K J A | D K Y J N;A
L M W X Q T | L T X M Q;W
N I T P Z E | N T E P Z;I
H U M V N W | U M N V W;H
M K Y U I W | U K W M I;Y
M J W Q K D | D J W M Q;K
W L N C V R | W V R C L;N
M X B J Y N | X M N B J;Y
E B Z C U X | C X U B E;Z
R X U F O D | U X R D F;O
E H L Z J A | E A H J L;Z
K V J D A X | D X K J A;V
D J H O L F | F J D H O;L
A G I K R P | A G R I P;K
P W T X E D | W X D E T;P
B M T J S K | T S B J K;M
D R P Y M T | D R Y P T;M
P D V C N J | J C P N D;V
F S Z N J E | S N Z E F;J
D I V Z G R | D Z G R V;I
C F Y V L H | V L C Y F;H
D I B O G C | I O B D C;G
J L B T A F | B L A F J;T
C L V O T U | L O T U C;V
I U K D A V | D V I U A;K
O P R B T Y | R O T P Y;B
G S C I X Q | I G X S Q;C
Z A I O M D | O D A M I;Z
U T R D J F | J T U D R;F
D G Y L X K | K L D X G;Y
N A Z I X P | N Z I X A;P
N E Y R Q T | Q T Y R N;E
T R V Q M H | H T R M Q;V
C F Y Q B J | Q J B C Y;F
Q O K W E T | K Q O W E;T
X Z U D V J | X J D V Z;U
B X D G M I | G D I M B;X
N W Y P S E | S P W N E;Y
S I M Z T J | S I J Z M;T
K L O V X N | O V N K X;L
M Q W G I T | I T G M Q;W
R G D X I Q | D X I R Q;G
L B V X Z Y | B X Z V Y;L
Z B M L W I | L I Z B W;M
K Z Y S L B | L B K S Z;Y
Q H T B W J | T J W Q B;H
P T S X G V | T V X S P;G
E O P V Z A | A E P Z O;V
M U A H C X | M U X C H;A
T I X G C S | T G I X C;S
U B F N W L | W B F L U;N
R F Z G J K | F J Z R G;K
J O U P E K | P U K J O;E
V E Y S Z H | S Y E Z V;H
A Z W P N Q | Q W N Z P;A
Y N W C L U | C Y L U W;N
C P B Y A M | M A C Y P;B
W O Z E S Q | S Z E O W;Q
T Q D G E C | G T E C Q;D
Q N G E Y F | Y G E Q N;F
B R D Y J U | U R J D Y;B
N J L V K T | K J N V L;T
J N K X G W | G W J K X;N
I F N H B K | B F N I H;K
V K O H P J | P K O H J;V
Q H W I F C | C F W Q H;I
Y B X J V M | X B M V Y;J
P B J T F C | F P B T J;C
T S Q I C O | C I Q T O;S
F U Q W P Y | W Y F U P;Q
O U B P D I | B D P O I;U
I M L H V Z | M Z L H V;I
O E F K P V | V K E F P;O
L Q J I O W | L J I O W;Q
I P R B K T | K B R T I;P
J E U D A I | E D J A U;I
F K N H W D | K N W D F;H
T C H Q N E | T C H E Q;N
Y R W B J N | N W R Y B;J
L B J E P S | J B S P L;E
L X H W D N | N D X W H;L
F Q U R V E | E V R Q U;F
B O X U G Q | Q X O U B;G
M R Y A V E | R M V A E;Y
P R L D V Z | Z L R P D;V
I Y L A C W | W A Y L C;I
A F C X E O | X F A O E;C
Z G F I Y R | Z G F I R;Y
A R O M J C | O R C J M;A
K G A F L C | F G K C A;L
G C L S Y Z | L Z C S Y;G
X T N L V M | M T L X V;N
Y R D T O X | D T X Y R;O
Y G J A F M | Y G J M A;F
K S E N I L | I K L N S;E
E Z K T H S | Z E S H K;T
G M U D Y W | M D Y U G;W
Z B C X A L | L X C Z B;A
O E N S T B | B O N T E;S
L S T M U A | A L U M S;T
W L D Y H K | H W L D Y;K
S M J F L R | F J M R L;S
Z A L Y Q B | Z Y Q B L;A
P V S E T L | T L E S P;V
N C U X H G | X H C G U;N
Q A U Z C E | U Q E Z A;C
J P E N O Z | N O P E Z;J
D C N Q U X | U Q C N D;X
W J N G C S | N J C W S;G
V K P I Q G | Q K P V G;I
E D V T F J | V T J D F;E
C N Z K F U | U K Z C F;N
T P H F R G | T F P H G;R
I J O K C P | K I C P O;J
O H A J T U | T J H O A;U
B P S T J A | A B J S P;T
V T B H C K | C B T H K;V
C G J N W V | G C V N W;J
Y D V E P A | P E V D Y;A
R P K X E T | P R E X T;K
A D U Q X T | A X Q U T;D
H P Q U F A | H P F U Q;A
R M G J H X | G X J R M;H
H G E D O J | E H J O G;D
E J I A N F | A J N F E;I
R C Y D Q B | Q Y B C D;R
T Y Q F V N | Q F Y V T;N
D Q K B W R | Q D R B W;K
E W Z R K J | Z E K R J;W
V H S U G J | J G H U V;S
S Y B H P Q | P H Q Y B;S
W Z J F D R | J R W F D;Z
D K M I N C | K D M N I;C
X E W A T B | E W B T X;A
I C L U F G | I F U C G;L
R X U L V E | L R X U V;E
B P X Z J S | S J Z P X;B
H C D S R I | S R D I C;H
R M B L P Q | P B M R Q;L
P Q U Y G H | G Y H P U;Q
J X F P N H | N X J P F;H
U A T C D G | A U T D C;G
M W A K H J | H W M K J;A
C J A P X R | P R C X J;A
I Z T S J A | Z A T I J;S
E O G J B D | E O B J D;G
O X T R J S | X J T O S;R
W G L D F Y | L G Y D F;W
H X A F E V | H X F A V;E
C P S Z K D | P C S Z D;K
D O E C V X | O V D E C;X
C P J G E H | H J G E C;P
N H Y J G S | S G N Y H;J
L J F G V A | V J A G F;L
A P H U W M | H U W A P;M
D O P B U E | B P O U E;D
B W X A C G | A W B X G;C
O Q N R E D | D O Q E R;N
F P J A W N | F P W J N;A
O Q W F M N | N F W O Q;M
F R Z X J G | R X G F J;Z
Q N X E J V | Q E X N V;J
R I P A J Y | Y I P R A;J
G A M X U Q | G U A X M;Q
J T S H I X | H S J X T;I
L S M C A T | C M S T A;L
F P D T A I | P F I A D;T
E J D F R Y | J D R Y F;E
U L E K X H | H E X K L;U
Y V A T O H | H V A T Y;O
R F D T Y G | G D Y R T;F
I M U S E J | S I J M E;U
B I Z W C T | W I C T Z;B
A G F V N W | F V N G A;W
K E Z D M R | K D M E R;Z
V E N O K J | J E N O V;K
M H L Z X T | M X T H L;Z
T A O H U R | H U A O R;T
Z B Q D R M | Z R Q D M;B
Y F I T B K | T I Y K F;B
U V M E T I | M E I V U;T
C B O V Y H | V C Y H O;B
D T X F Z S | Z S T D X;F
R J X O Z Q | O R X J Q;Z
H A D S L U | D L H S A;U
R T O F J W | J R T F W;O
X E O R Q U | R O X E Q;U
S W G V R P | G S V R P;W
K J L T W H | H T K W L;J
T J V B H N | B J N H V;T
C Z I Y V W | W V I C Z;Y
X D V P G E | G X V P E;D
O M Y Z R X | O Z X R M;Y
Q U K J B S | K U B S Q;J
L E S T O J | O J T S L;E
Q R W F A T | T W A F Q;R
V L G F W H | W H V L G;F
K S A H U D | S U H K D;A
Z M U I H K | M H K U Z;I
F Z O B T C | T Z B C F;O
F Z W O S E | E F Z W S;O
T S K L D C | C K T S D;L
O M R Y V D | V D M Y R;O
S Q F H W Y | H F Y S W;Q
E L I O Y T | Y E I L T;O
B H Q U G L | G Q H U L;B
X S O W R N | N X O R S;W
T L O R U S | O S L U R;T
B D R I Y F | R D Y I B;F
Z V O M G N | O N Z G M;V
M U A R G O | A O G R U;M
G Q E O L Y | L Y E G O;Q
C Y A S V W | A S W C V;Y
Z X Y A D K | Y K D X Z;A
K J W P N S | J K N W S;P
K N C U Q A | Q U K C N;A
K W T R M B | B R K M W;T
X O T F Q E | O X Q T F;E
O H J C T S | J O T C S;H
P X L Q S Z | S L Q P X;Z
K F A Q Y L | Y A K F Q;L
T Q A C U P | U Q T C A;P
A H L V C B | C B L V A;H
S D Y W O K | K D W Y O;S
Y P Q M H S | Y M Q H S;P
Y H P I B D | P Y D B I;H
M I O Z R V | O Z M I V;R
C F O X A L | A F X C O;L
N K W E X B | W B K E X;N
H G F Q Z L | Z G L Q H;F
B R X V A F | A X V B F;R
Z H K R P A | R P K Z A;H
X H Z I L S | S H L Z I;X
I H S O U G | U G S H I;O
X K A T F D | F A X D K;T
J X F O H U | F U H O J;X
F N D Z O X | O F D Z X;N
H U O C T V | V C H O U;T
J M X B V K | X J K M B;V
U Z W B C M | Z U C W B;M
B J M Z H S | J S M H B;Z
R K U Y S C | U R C K S;Y
N R Q U B D | B U D Q R;N
O D C F I M | I M O C D;F
E W L H S X | W X E L H;S
C B F A Z K | F A Z B C;K
U Z L B K A | U K B Z L;A
I Z N A B P | N B Z A P;I
K F T U Y S | U K Y T F;S
C Y R G D X | G X R D C;Y
P K N D V J | V J D P N;K
A L U W B X | W U X L B;A
Q I W P G D | P D W G I;Q
B A G S Z F | G F B Z A;S
E G P R B X | E G P X B;R
R B U Z T O | R U T B Z;O
J Z L C K Y | J Y L Z K;C
V E P M Q L | P Q L V E;M
Y U S P L E | L U Y E P;S
V L H R Z O | R O H Z V;L
I R B H V T | R V T B H;I
X Z E R H S | X Z R S H;E
W N L B O S | B O W L N;S
A S Z M N O | S M O N Z;A
M C O F K I | O K I F C;M
X M F G B K | K X F G B;M
M E G Q F V | G V E F M;Q
G B N O Y E | G Y O B E;N
H A M P O N | M P H A N;O
K P V D M J | K J D M V;P
J F X Q R L | Q R F L X;J
T W I Y R A | R Y W A I;T
N U V D F X | X D U N V;F
J T E S X G | J G E S X;T
Q H P I Z U | P Z H Q I;U
M O B C H A | B A M C O;H
M R N B K P | R M P B N;K
H N G D E C | H D C E G;N
N I L Z T A | L N T A I;Z
T A P Q Y U | Q T P A Y;U
L B T V P F | F T P V L;B
S R Y M X T | S X M R Y;T
E C D I L U | E C L D U;I
W R K C J D | K R W D J;C
Q C M L H U | H Q U L M;C
J G A C W Y | W Y J G C;A
P D H Z G V | G P H D Z;V
Z M N E C A | C Z M N A;E
C M K O X L | M O K L C;X
M H I A X Z | M Z X A H;I
Y N A I Z K | N Z Y A K;I
Z R H Q A I | Q I A H Z;R
T Z L U R V | V R T U Z;L
S I W D V J | V D S W I;J
W C D Z N G | C D G N W;Z
H N M U R D | M D R U H;N
A G H T X M | A X H T M;G
W K N M V G | W N K G M;V
Y U B C N D | N U D C B;Y
L G R Q I P | P Q R I L;G
W B L Z A T | Z B L W T;A
M P X K F I | F K P M I;X
N A J K V P | A J P K N;V
J O F Y R X | F O J Y R;X
T Y A C E G | T C Y E A;G
X G R F A U | A G F X U;R
K H I B X Q | B K H X I;Q
U H F Z S G | S U G Z H;F
P D Q F W M | M Q D F W;P
J U F P Z M | J U Z P F;M
Q G M R Y D | D M Q R G;Y
O Y P F H S | F S P H Y;O
U C L S W F | W C L U S;F
O Z E J K S | J Z E S O;K
Q F T B G L | G F T Q L;B
M L O Q R X | X O R L Q;M
U L B E G F | L E B U G;F
Y J M B U D | Y D U B J;M
Z L K J M N | J K M N L;Z
D V P I J H | D V P H J;I
C J G F W N | N W G J F;C
A B J W H X | B W A J H;X
C L S Z Q P | P Q S Z L;C
V G Z B W M | G Z B V W;M
K G V P M E | V G E K P;M
U T M D X N | M U D X N;T
K C V E P Z | K Z E V C;P
A Q T G S P | Q G A P T;S
B L G A K R | A K B R G;L
Q T K V O Y | Y O T V Q;K
O V G S M T | T G M O V;S
O P R F H T | H R O T P;F
J U P T Z V | V T J U P;Z
A H B G X P | A B X P G;H
F X G O B N | O B X F N;G
Y B X A U L | Y A B X U;L
O Q Y F X W | F X Q W O;Y
C O U H M B | B U H M C;O
U L M H B F | B H U L M;F
H A Z C K E | E A K Z H;C
H K I D S V | K V D H S;I
Z P V X J M | V M J Z X;P
X C W I R L | C W R I L;X
B Q M G E S | G B M S Q;E
A H T R O L | R H L T A;O
I U H B X J | I J B H X;U
I C Q G P R | C P R I G;Q
X L U R V P | R X U P L;V
B Q M Y F P | Y Q P M B;F
A V E Z J I | A J E I V;Z
W L B I R U | B R L U W;I
N B U L D A | N L D A U;B
X R U H F G | F H U R G;X
B W K V P I | P W B V K;I
T R E H I W | E T I R W;H
R S U B K D | K R U D B;S
U I X H P M | X I H P M;U
T F U Y W Z | U Y Z T F;W
H G J V E Y | V E G Y J;H
W R F C S N | R C W F S;N
N B X Z Q R | X B Q N Z;R
R T M Z X U | R X T M Z;U
V G L J E T | G V L T E;J
Q N D Y L F | D L Y Q F;N
J W F H O U | H O U W J;F
C P S W X D | D S C P X;W
Y W H C F I | Y C I F W;H
U X E T Q W | T U W E X;Q
U N B C Z H | C B U N Z;H
O Q F G J Z | Q Z F O J;G
S Y Z J K I | Y I S Z K;J
V K U B Y R | Y R B V U;K
S B Z X W L | X S W L B;Z
W R H Z F B | F H B W Z;R
I Y B Z O U | Y B O U I;Z
Q T R F N I | N Q F I R;T
A U L V R C | C R A L U;V
L X T G Y R | X G Y L T;R
C Z X N L G | C Z N G X;L
D X O A V Z | X D O V A;Z
W X K L C Q | L Q X W C;K
J K A V D R | J K D A V;R
D M R X Q G | R D M G Q;X
X U B M D Z | B Z D M U;X
N A U V J K | N A V U J;K
R V D T A N | N D A V R;T
M F R J L V | L M R J V;F
H S U D B R | U B D S R;H
H W O X Z F | X W H Z O;F
I F D Y X Z | F I X Y D;Z
M Q Y C V N | C N V M Y;Q
A K G Y D W | A W G Y D;K
D M B C F P | M C P F B;D
B E H N P U | E P N H B;U
U W B H I E | I E H U W;B
O D L V I Z | Z O I L V;D
T R L E X I | X I R E T;L
P K G N O F | G K P O F;N
Q O P I Y W | P Y Q O I;W
W B E V A O | V O A W E;B
E I C F Z T | T I C Z F;E
V E S H M R | V M S H E;R
W J C P T G | W J P C T;G
U B Z C Y H | C Z Y U B;H
W B J Z O U | Z U B J O;W
Q R F B M L | L B F Q M;R
C J S P W L | C W J S P;L
W C I L Y H | W I C Y L;H
P I D Y X C | C Y I D P;X
C Y H W B U | W B H C Y;U
K S A I R V | V R A S I;K
E N Z Q O Y | Y Z O Q N;E
V H Z P C W | C P W Z V;H
F R C E Y U | Y U F E C;R
Y D S L K A | D S A L K;Y
Q J O H S F | J O H Q S;F
H S X P T G | T S G X H;P
D E W C F L | E F C L W;D
E S O C L T | S C O L T;E
Z J A S R N | A Z N R J;S
Q O D B K U | Q K D O B;U
Z C G M V S | G S V C M;Z
P Z T V D M | Z T M D V;P
J L E X S W | J E S W X;L
L Z C I R J | Z R I J L;C
O Z Q N D G | Z O N D Q;G
E W Y P K T | K Y P E W;T
N P K X G O | K N O G P;X
K N H U F Q | U H F Q K;N
D B R L K U | L B K D U;R
H Y U O Z L | Y L O Z U;H
Q P O R B C | P C R B O;Q
A Q J S L N | L Q A S J;N
P Q K Z R Y | K Y R P Q;Z
K Q J F O M | J F Q O M;K
T D E U F Z | E U T D Z;F
J S Q H C E | C J H S Q;E
D O N B G S | D N B G S;O
D Y A J V I | J V I D Y;A
R L G Q Y A | R L G Q A;Y
V N Z C J S | C J Z N V;S
P R Z U F Q | Q P F Z U;R
H W E J D T | T E J D W;H
J N E T I F | I E N J T;F
G M K R T E | R M K E T;G
B D M C T H | T B H D C;M
Z E I N F G | Z F I N G;E
V A X R S D | X A S D V;R
T S Y M E B | Y T B E S;M
V H J C F G | F C H J V;G
L H D B S Y | D Y B L H;S
A P S E O C | C P E S O;A
O H M C E I | H I E M O;C
U I K J L Z | Z K I U L;J
A N O Q H P | O Q N A H;P
X Y N H J W | W Y H N X;J
C G Z D L H | L D G C Z;H
Z V X U W P | U V X P W;Z
W S L T Q X | X T L W S;Q
E U R Z X G | U X Z R E;G
M P L N H X | M P X H N;L
T W X F Q P | T Q P W F;X
D J Y F N U | U N Y F D;J
M T V A H E | T M H V A;E
N V R L A S | A R S N L;V
K X D F L R | X D K F L;R
K L A M O C | M O L C K;A
X V H K L I | I V H K L;X
X O B P Z K | X O B K P;Z
N I U J F H | J F I N U;H
C A U S W T | T A C S W;U
C H S J N T | J H C N T;S
W R X V T M | R V W M X;T
L K F V T Z | L V Z K F;T
M X U D P V | X D M V U;P
I T W G L Y | G I L W T;Y
J O Q E I P | I O J E P;Q
T Q O I P E | E T O I P;Q
X P Y E V Q | E Q P X Y;V
V K U E L T | V E K L U;T
F T R I G N | N F G I T;R
Q W S M C Y | Y C M Q W;S
F X K I T W | W X F T I;K
M O X N K E | M O X K E;N
U R H J V B | H V R J U;B
M L G H X V | X H V M G;L
O J I B S N | J N I B S;O
E N O X I Y | Y O X I N;E
M T X Z N U | U Z T N X;M
X N U B M H | B M N H U;X
K J F M N T | F N K M J;T
S P C T O W | T S P W C;O
I E M F V C | I F C E M;V
C M A X I G | I M C G A;X
L G X R C D | L G C D X;R
P I B Q L T | B Q L T P;I
I B K F J T | B J K T I;F
K A Y O R D | Y D O R K;A
I Q G S J D | Q G S I D;J
N A I U P Y | A P I N U;Y
D C S Y N V | D N V C S;Y
V X W G F N | X F G V W;N
D E K Q P M | M D P E Q;K
I V Y K J W | I Y J W K;V
K J B Z T M | M B Z T K;J
K G M Y H Z | Z H G Y M;K
W Z E L R K | E R W L K;Z
N T F M B X | B T M N F;X
D Q X A M G | Q D G M X;A
D Z T I E M | Z M I E D;T
Z P E T C W | W E T Z C;P
P K Y O S X | X S Y O P;K
F H J M C B | F B J H C;M
F G M D R C | D C G M F;R
R D X V E M | V E M X D;R
X O F K E G | K X O F G;E
G T O I N U | O U T G N;I
Q S X T I E | E T S Q I;X
H J A Y U N | Y J H A U;N
D O U E C N | D C N E O;U
R M Z X A O | M A O R X;Z
P H E K N Z | E K P Z N;H
Z M K N B O | N M O Z B;K
L Y R P T F | L R F P Y;T
F G M L Z Y | Z Y L F G;M
J U M H K C | H K C U J;M
P J X C F K | P X J F C;K
S W Q R U Y | Q U S W Y;R
A I D C X M | D I M A C;X
O E R L F P | R F E L O;P
G P J I R Q | G I J P Q;R
U A X N M G | A G X U M;N
W B T M K S | W S M T K;B
Z T J N R S | N R J S Z;T
W E X D B T | W D X E T;B
S U H C A T | A S C T H;U
S U O T Q Z | U O S T Z;Q
T Z B L Y A | Y B T L Z;A
H A B W J Q | J H Q A W;B
N U Q C L A | A L Q C N;U
C I M V O R | V M C R O;I
T K G A Z H | A H G Z K;T
X U K J L A | L J K A X;U
K U F Q R X | R K U Q X;F
N D J O B I | J B D N O;I
L S X E D V | E S L V X;D
N D U L E P | E L N P U;D
H A J B L G | B G L H J;A
Q Z G S B I | Q B G Z I;S
N G I Y L D | N G L I D;Y
G M R Y T C | T G Y M C;R
W H M E C S | S E C H M;W
M G U A T I | T U M G I;A
P I K S E G | I S P G E;K
B M U T S Q | S B M U Q;T
G P H M U V | H V U M P;G
Z N D E C M | E Z M N D;C
A V D G K Q | A D Q G K;V
K Q G W P V | K V G P W;Q
N T K G D I | G N T I D;K
E R A I U Z | E A Z R I;U
Y U O L Z J | Y L J O Z;U
R Q C W K M | Q R K W M;C
P K S Z A B | Z P K B A;S
S L Y K E A | Y A E S K;L
W U X C B L | C L U W X;B
B I H C O L | O H L C B;I
V Q A S B P | A V Q P B;S
V R J C B T | V J C T B;R
K G D H Y M | Y M G K H;D
J Q H G U E | H G E Q U;J
H Y E Z S U | U E H Y Z;S
O Y G A Z N | O G Y A Z;N
N U F J Y S | S N F U J;Y
E G O N W H | E W O G N;H
M N F T Q L | N M L Q T;F
Y L C N A I | A N L I Y;C
A O Q I M F | M A F I O;Q
N D R H Y E | H Y N E R;D
I H J T Z G | G H Z T I;J
U D F Q S W | U S Q W F;D
R P E J M B | R E B J P;M
X N O G E T | N X O G E;T
T H I W O B | O T W H B;I
O C J W N E | E J C W O;N
G P Y F B N | B G N Y P;F
X P Y U M S | Y X S M U;P
F I W D Y M | Y I M F W;D
N H Z X T B | X T Z B N;H
A K U C Y X | K C U A X;Y
I C S L O V | I S L V O;C
Q W S G X V | W Q G X V;S
U S Z W A X | U Z A X S;W
O B J M K V | B K O V M;J
S O T P Z U | Z U T P S;O
F K M E B W | W E K M F;B
C B F U N L | F C B N U;L
K R Y Q W E | K R Q W E;Y
R A Y D E K | Y K D E R;A
K U M Q S J | S K M J U;Q
X H D E R U | X E D U H;R
Z Y H Q S E | Y Z E S H;Q
U Y A G M B | Y B M G U;A
J P K E X F | P J X F K;E
S D W H I G | S G I D W;H
L W A D C T | C A L D T;W
O H K F T L | L H K F O;T
H V N Z K F | Z V K N H;F
R M H L Z G | M G R L Z;H
B P M O A L | A M B L P;O
G V F Y I N | F V I N Y;G
G B O D Y X | G Y X O B;D
S A U T M J | M J S U T;A
W R U X P C | X P C U W;R
O X H Y N B | Y N O X H;B
Q L X H I R | Q H L R X;I
Q L N Y I J | Y J L N Q;I
H Z K Y S P | K H P Y S;Z
G X E P O T | O E T X G;P
A T W X L J | X J A T W;L
H O T C I U | C I H T U;O
N W Z Y M J | N M Y Z J;W
L B Q Y M N | B L M Y N;Q
I Y A T O R | A T I O Y;R
Y U F O Z L | L F Z O U;Y
R A M P J G | P G A M J;R
E S A L K C | L S E K A;C
C E N Z I K | Z C K I E;N
Y C N L F H | F N H C Y;L
M K F R H D | D K M F R;H
A Y U W M K | W A M K U;Y
A T F Z G C | F C A Z G;T
L S X O N K | X K O S N;L
J H F Q I A | F Q I H J;A
F I L S V H | V I H L F;S
M R U S Q J | U S M J R;Q
L K H T N G | K L G H N;T
Q G X U L J | U X Q L G;J
P E Y X F J | E Y P F X;J
L V Y E R W | E W L R V;Y
R Y V H J E | R V Y J H;E
W F I N D Y | I Y W F N;D
O A G Q N V | Q O G A V;N
D T C B F S | F S C B D;T
F J W A Q P | A J W P F;Q
H R P Z X S | X P R Z S;H
D S Z G Y K | K Z Y S D;G
R Q W Y Z E | Q Y Z E W;R
T N C Y J F | J N F T C;Y
S M A D W I | S W A M D;I
U K D Z I O | I Z O K D;U
N D P A X T | A D N X T;P
T X N Y I V | X I V T N;Y
E H Q D V C | Q D E C V;H
W R V H T B | V R W H B;T
M L C E Z H | M E C H Z;L
P J Y S L H | H S J P Y;L
M Y A C W I | Y C W A M;I
U Q G L S Y | U Y Q S G;L
O H G I Z F | F I G Z O;H
Z Y R F E B | R F Z Y E;B
J E B K G H | G E B H J;K
G R P W F H | R P G H F;W
J R H X Y Q | H R X J Q;Y
M U F P D S | M F D U S;P
M P K L T I | K P L I M;T
C L O X R T | X T O L R;C
G D J C K E | J C E G K;D
Y Q X J T H | H Y T Q X;J
F O X S E A | E S F A O;X
Z Q J G I M | I J G Z Q;M
U B M K T F | M K F U B;T
I D P F H M | M F P H I;D
A N V E Q Z | E N Z V A;Q
W V P Y T H | V T Y H P;W
Z H C F O Y | C H O Z F;Y
C T W B I R | R I B W T;C
P Q J B F I | Q J B F I;P
B T V K F Q | T V K Q B;F
F X V B R M | B F R M X;V
P I Z E D V | E D P V I;Z
C O B I Q F | Q F B C O;I
W M S G Y D | D Y M G S;W
Q K A M B C | M C Q K B;A
M O V F R X | O X R V F;M
K F I M Z X | X K F I M;Z
A Y G C P O | P Y G O C;A
W X K S D E | D S X K E;W
W S D H C R | C W S H D;R
O J K I N H | K O N H I;J
X P D W F I | D P I W X;F
L T M S Q D | D L Q M S;T
C R U T W S | C U R W S;T
E K W P B Y | K B Y W E;P
H P J L T R | J R P T H;L
N H F V D P | F H P V D;N
J W M F V C | V W C M F;J
F B J D N K | F J N K D;B
W E Z L V A | E L V A Z;W
V F X R M Y | R X V M Y;F
L K F Q U J | J K L Q F;U
B Q Y F U M | Q Y M U B;F
L Q H W J A | L Q W J H;A
Y K E W P M | E P Y K W;M
B I M X L A | X M B A I;L
Q L Z W Y J | Y L Q W J;Z
C V Z S U M | U V S Z C;M
N E I K M R | E N R M I;K
A U R D W V | U A D V R;W
G P T I L R | L I R G T;P
B T G K Y A | Y B G T K;A
I M H T P A | T H M P I;A
X E G F S H | X E F G S;H
R S J C A T | T S R A J;C
B E H U I X | E H X U I;B
S Y U Z T K | S T Z U K;Y
B K V N F U | U N V K F;B
O N T F E G | G T F E O;N
N O Y X L W | O W X N L;Y
U E A L P M | M E U P A;L
R Z H B M Y | B Y H R M;Z
Z L W R G P | W L P Z G;R
Z U A L V F | A Z U F L;V
F J S I W N | I N F S W;J
J W C Q P E | J P Q W E;C
H X R O J M | X H M J R;O
D I G W T P | T G I D P;W
Q G X M A B | X M B A Q;G
C G O L H V | O C H L V;G
P R E W K O | E W O K R;P
Y A H R X Q | A H Q X R;Y
K D U E B N | E K D N U;B
E U R I L X | E R L U I;X
B X W J R N | N B W R J;X
F T E Y G B | G T F Y B;E
E N W Q G T | E G Q W N;T
F Y N K X D | F Y N K D;X
Q B P G X A | X P G A B;Q
N Y O D I A | N D Y I A;O
S K U E R V | K U R S V;E
R L I A M X | X R A M L;I
L H K U N P | U N K L P;H
Z B V Y Q C | Y B Z V C;Q
H I R B W G | I H B R G;W
T H B X D E | T B D E X;H
R L O H C E | L C E R O;H
C X W K H F | C F K W X;H
H B V W Q L | B W V Q L;H
B K V M Y U | B Y M V K;U
O R B F W A | R W A B F;O
K V A N O E | O N A E V;K
M C Y A S B | S C A B Y;M
B F M O R U | O U R F B;M
K E O L G C | O K E L G;C
B K F I W N | F K B W N;I
U E K V T A | U E T K V;A
B K S Y X G | Y B G X K;S
O K T Z Y X | T Z O X K;Y
F B D X A R | D A R X F;B
P R Z J F B | F P R Z J;B
X I Z Q H G | G H Q Z I;X
S V W H Z M | H Z S V M;W
Q S X C Y D | S D X Y Q;C
Q H M C T X | M H Q T C;X
W F I Y P M | P I W F Y;M
T X Y M A P | P X T M A;Y
F E V Z J K | F J K V E;Z
X Y F B H N | B F N H X;Y
G Q I J K E | G K I E J;Q
G W Q K C D | K C W Q D;G
S U Y A K Q | S K Q A U;Y
H X T O B C | C X T H O;B
B F A C O K | A F K O B;C
O B P Z F D | F O P B Z;D
C U G F I V | F C V I U;G
H D G M C Y | G H C D Y;M
X V E Q F W | Q X V W F;E
F L C I B Y | B L C F Y;I
F H W C V K | C F H W V;K
H C I F Q P | F Q P I H;C
M W K E C A | M W C E A;K
X A O B D Z | X O D Z B;A
K V H U N D | V K N H U;D
B P Y A X T | T Y P X A;B
G B C Y J D | G J C D B;Y
J M N F T X | T N F J X;M
X F Y I W Z | F X I W Z;Y
U Y N Z W A | Y N U A Z;W
F M D A B C | F A B C D;M
F R E T C S | T R S F E;C
C Q P W X A | A W X P C;Q
B K S V J O | B J K V O;S
Q E L K J U | Q L E K U;J
T P I W U A | W T I A P;U
Y I R B P U | Y P U I R;B
Q G U A Z O | Z O U Q G;A
N G K V A Q | Q V A N G;K
E I W J N V | N E J V W;I
P G Q C O U | G Q C U O;P
Y E R X C W | X C Y R E;W
B C X O Y F | X O C F B;Y
Q M T F U J | J F Q T U;M
W U D B Q L | W D L U B;Q
S V P Y M H | S H Y P M;V
M J V P T R | V P T J R;M
J W P Q V B | P W V Q J;B
I V O R W J | W J I V R;O
G Q I Y J K | Y I J Q K;G
Z W V P H C | V H C W Z;P
F C K U E O | K F E O U;C
V O Z M X D | D Z X O V;M
I S D R W F | I D R S F;W
B L U A J O | U A J O B;L
D B S O N T | T B S N O;D
P W J V Y L | P L Y W V;J
X A S H M T | A X M T S;H
K A B L O E | A E O B L;K
W K U N V G | V W K N U;G
V L F D I M | L I M V D;F
P S X T Y C | C S X P T;Y
M S B G O U | U M O B S;G
B S R Y I Z | B Z Y S R;I
Q J L K X S | Q X S K J;L
B T C K U H | K H B C T;U
Z O S G B M | M O Z B S;G
H A I U B D | A D B I U;H
N I M B U Q | I B M U N;Q
S F Q H E J | E H Q S J;F
T W S L K R | S R T K L;W
E B S R C W | S W C R E;B
K Z G S P L | Z G K L P;S
R L D P N Z | P Z L N D;R
O E M P C B | C O M B P;E
H A C K F E | F C K H E;A
B F V S X R | F S V X R;B
M W X N P F | X N P W M;F
G B J T Q R | G J R Q T;B
U M R N H P | M N P U H;R
I E K Y Z R | K R I Y Z;E
L Q U O M W | O M W U L;Q
Q F L U N C | L F C N Q;U
H T O C W K | O T H C K;W
W O U B Z J | U O W Z B;J
K J Z H G M | K M H J Z;G
J W A R B I | W I J B A;R
V S F W O I | I S V W F;O
H Q I T S C | C H S I T;Q
V W L F E B | F E B L W;V
B E C M W R | W B E C M;R
J N L W S Y | Y L S W J;N
N X D M H C | C N H D X;M
Y Q S P V U | P Q V Y U;S
V J Y G L R | R G L V Y;J
G W U P F N | W P N F G;U
Z J R C L A | Z C L R A;J
O F Z A I L | F L A I O;Z
K E U N F H | E U N K F;H
B U H P A R | P A B H U;R
T H A Z J Q | A H Z Q J;T
A I X D B R | D I A B X;R
X F O C I U | O U X I F;C
S F U Y M E | F M E S U;Y
S H E N F Z | Z E H F N;S
L D J Z C I | L D Z C J;I
B R W U S J | B U W R S;J
Y D R W L I | Y D L I R;W
Z V Y C N I | I C N Z V;Y
H F C J Z E | J E F H Z;C
P C T Q S X | Q X S T C;P
U L G J Z K | L G J K U;Z
J Q W R I F | J F I R Q;W
E L W B I V | E V W L I;B
S Z B L R O | S Z R L O;B
N A U K C V | N C U K A;V
E K Z A L B | Z B L K A;E
C F L S Y B | L F C Y B;S
X V G T P E | X T G P E;V
N C A T X I | T C X A N;I
I F A H Q R | A R F Q H;I
T A L Q K C | A L C Q T;K
Y I T L N S | Y N S T I;L
K H V X L Z | L H Z X V;K
T Q E D H N | Q E H D N;T
L O V R H Z | R H L V O;Z
P D E O G J | J G D O E;P
D V Z T W Q | Z V T Q W;D
P I D S X L | L D X S P;I
Z L Y K G S | L K Z S Y;G
E H L S P Q | L H P E S;Q
L Q F P M G | L M G P Q;F
A C R S J U | S A U R J;C
A K T P H D | P H K A D;T
X P E H Y G | G X E P Y;H
Q K U W F Y | U Q K F W;Y
E D G T W K | E T D G W;K
X B D R C G | B X R G C;D
R V I S O X | V R O I X;S
H K G W L D | G D H W K;L
U W E L Q T | T Q W L E;U
H W P Q O E | E Q P W H;O
J Q N R C U | Q C N J R;U
X L M G W E | W M X L E;G
Y A D K V I | A Y V K I;D
M J V P K O | V P K M O;J
Y U A J F S | U Y S F A;J
Y R O F B L | F R B Y O;L
E Z B V U N | E N U Z V;B
Q A N Z X W | Q A N Z W;X
P D S J I B | D S B P J;I
K W F Z X V | X V F K W;Z
L N D E S Y | Y E D N S;L
Y Q L G I H | Y H L I Q;G
J K Q R D L | R Q L J D;K
J H F V Q S | J H S Q F;V
O G Q U C Y | Y Q G O U;C
F D R O N S | D O F R S;N
S V O X P C | V O S P C;X
P E Y K F M | M Y P F E;K
X G P D V F | D F X G P;V
M S F V K B | B V K S F;M
I O B A N F | I A F O B;N
J K E Z F N | F N Z K J;E
E F P D A C | D A C F P;E
M Z C Y I U | I M Z Y C;U
B T X F M W | F M W T B;X
F S A E T W | A W F E S;T
A X R I U N | N R I U A;X
T W O Z E L | W L O Z T;E
Q L M C W Y | Q L C Y M;W
Z M B C I N | N Z I C M;B
R P Z Y E F | Z R E P F;Y
Z D L A M B | A B Z D M;L
P O I C E J | O J E I P;C
C L E U W M | E M C U L;W
P N V A D H | D H A V N;P
Z H Y U Q D | D Z Q H U;Y
A D N H Y Q | Q H D N A;Y
E F X S W I | S X E F W;I
S I O X D Z | X Z S I O;D
K E J S D M | D E K J S;M
A Y D R J H | J H Y R A;D
D G B V S O | S O D B G;V
R M B J A G | R A B M J;G
B V M H X L | V M L X H;B
J H F C I V | I H F C J;V
D K R W T P | T D R W P;K
S J L Y O H | H L O S J;Y
I R C E F O | E I C O R;F
K Y V I M G | M I K Y V;G
S F J E H U | H J E F S;U
U D I F T C | D T F U I;C
Z C E I O T | E C O I Z;T
R G T P S E | S R T P G;E
Z S G K E L | L S G K E;Z
Q S T V F Y | S T V F Q;Y
I Y P E R Q | Q Y R E P;I
N C D W U Z | D W N C U;Z
W S R J E Z | J W R E S;Z
F J A I D Z | F I Z J A;D
U K O Y A J | J U A O Y;K
E M H Q F N | N M F H Q;E
W Y M Q U S | Q U Y W M;S
J Q W L S N | N Q L J W;S
C I J W O U | J O I W U;C
M R O F H N | M R F O H;N
X B W Y K R | W K Y R B;X
J X C P Q F | P F J C Q;X
N Z V Q I M | I N M Z V;Q
U V D C R M | M U R C D;V
M O G N I W | G I O M N;W
K Z C H M I | I Z C K H;M
X C T J Q U | X T U J Q;C
M H E Y A G | A M H Y E;G
M R L C W F | W L C F M;R
P Q H G M F | G H Q P F;M
K V Q U Z X | V K U Z X;Q
C U M B D L | D L B M U;C
C L N G U K | U C N L K;G
Z C I B U O | B O U I C;Z
T N H A V R | N T A V H;R
Q O X Z A K | A Z O K Q;X
F T B J I Z | Z J T B F;I
G S W O U P | O U G P W;S
F D Q H R V | R Q H D V;F
I X M H J K | I H M X J;K
B T N V L U | B V L T N;U
E U M A O T | E U T M A;O
V J W P S T | T W J V S;P
I L P B E R | L E P I R;B
Y D G P W M | P Y G M W;D
O G Y B H S | G Y S B O;H
V R H N P M | M P R N V;H
E V S C N H | E V C H S;N
N V X R D I | I R D V N;X
Q X S F J R | F Q J X S;R
S V K R B A | A K R V B;S
X M L P N S | N X M P S;L
X C D H V R | R H X C D;V
P Q I R A V | I A Q R P;V
Q I R U C A | Q A I C U;R
T H L F B C | F B H C L;T
A U X H I R | I X A U R;H
P B N L X U | N P U L B;X
J W N G F H | N H J W G;F
Q H T E U V | V E U H Q;T
E C K G A B | K A G B E;C
C D F V G U | C F U D G;V
T W F R N Q | N F R W T;Q
G R A Y K F | G K Y R F;A
N L J Q R P | P N Q R J;L
X N A R U Y | U A X Y N;R
E I K J U G | I J G K U;E
J I G B F K | G K B I J;F
W E Q G I L | W E L Q G;I
U C T A O Z | C Z T A U;O
F E C A K R | K C E A F;R
U C T W N D | N U D T C;W
N L S E B I | L N B I S;E
U D H W P R | D H R W P;U
R Z J F K I | J K F Z R;I
K S L F X G | G L X S F;K
W T P G B M | G P B W M;T
F W U X H P | W P F U X;H
B F H V R J | H V F J R;B
E C F B W G | E B C G F;W
G K I E A Y | K Y I A E;G
Z E V B C O | E B C O Z;V
N X O S Z R | N X Z O R;S
L U D T C J | D C U J T;L
Z O Q U T N | N U Z O Q;T
R D N C K O | N C K D O;R
N K O M Q W | N Q M W K;O
Q G T N P U | Q G N U T;P
U D S O G N | N O D U S;G
R X K L D P | L D R X K;P
V Z G L O E | V L E O Z;G
N O V Z B X | B Z N V O;X
N C E Z H M | N C E M H;Z
H G L E Z C | E L G C Z;H
C M O N Z X | M Z X C O;N
T M H V W F | V F W M H;T
Y M C S W E | C M Y S E;W
C G H B S W | G W H C S;B
X E U F B C | C U X F B;E
H L E X F A | A E F L H;X
J Y I C F A | C Y I F J;A
D F A N H G | D A G F H;N
H B Z C G A | G H C B A;Z
P K N J F B | P F B J K;N
A J W K V L | L V K A W;J
A U Y G I N | I G Y N U;A
H X O F D P | D O F H P;X
R P Z T I L | R Z P T L;I
P K C T Y Z | Z T C Y P;K
R I S V F P | P I F V S;R
B M O W D R | W R O D M;B
D M B P O J | J O M B D;P
W S R N J L | L R N W S;J
C D I W Y Q | Q C Y W I;D
V P S H E K | S H E K P;V
J R O Q W D | J R O Q D;W
I W R E D O | R D O I E;W
X Y P W R L | Y R L W P;X
K E B F T X | E K X F T;B
H D V I R M | M I V D H;R
H O V X P S | V H O P X;S
S D E N B T | S N T B D;E
L R I F C A | C F L A I;R
Q J H X S F | F S Q J X;H
W S B J V I | S J V I B;W
M I O G Q U | I O U M Q;G
X M L H O W | H X W L O;M
S L C M Z V | M C Z V S;L
J N F B Y V | N B V J Y;F
Z W X Q T V | T V W X Q;Z
B M P W I E | E M B W P;I
N C F S T E | N T C S F;E
G C K L P M | M C K P L;G
U F D M T K | D U M F T;K
E D N A X T | A X T N D;E
U A V K R D | R V K D A;U
W V S C T Y | T S W Y C;V
C N T J B W | N T J B C;W
N W V E B L | N E V W L;B
G U S X K Q | S G U K Q;X
L U M C S V | M C V L S;U
S W N F A T | A N W S F;T
M B F P S R | S B R M F;P
E W R N Q K | E W Q K N;R
W U P C L A | C W L P A;U
H J L D F O | O H L D F;J
A F U E X C | E U X A C;F
V A J U X G | A V X G J;U
S C V F G X | V C F S X;G
Q N P X F U | F P N U Q;X
J H Y W A E | W A Y J H;E
T I H V O M | O V T M I;H
W M U T F J | M W F T J;U
S K T H J Y | J S Y T H;K
L W K X I Z | W X K I Z;L
I M Y F B G | I Y F M G;B
N Q M R P V | N Q V M P;R
E C Y V D A | V A E D Y;C
Y D Q K J T | D J K T Y;Q
N X W H B F | W X B N F;H
E Q L N W H | E Q H N L;W
K D O Z Q Y | D Q K Z O;Y
U T H R Q B | R H U B Q;T
L U J H B F | U L H J F;B
E X M G N P | G X M P E;N
H S Y P F N | N P S Y F;H
N E Y G C U | E N C G U;Y
B G J C M A | B A C M G;J
I T R H U O | R H O I U;T
Q W T L N Z | N Q Z L W;T
U D T W K H | U D W H T;K
M F G P X B | G P X B F;M
Y K O V N X | V K X O N;Y
M B E U D O | U M B E D;O
P O C R L M | R C P L O;M
C R Z B F I | Z I C R F;B
I O J S H C | H S J C O;I
H W E B X N | X W N E H;B
C T J X U Z | U Z X T J;C
D U B L P G | D B P U G;L
S H J P I Y | P S Y H J;I
T I H D U O | U T D O H;I
A R E X K Z | X Z E A K;R
I K S W M G | K I M W S;G
N P L M B D | L D M B P;N
H X B F E M | X B E H F;M
G O T P S X | X G S P O;T
Z B I O Q H | H Q Z B O;I
I U O S N A | N A O I U;S
R I K Z X U | R I U X Z;K
P C W H Q X | Q C X H W;P
B Y W O R K | Y R W K B;O
B O F J X A | O X J B A;F
Z J P L I G | J I G Z L;P
R L Z J B N | R J L Z B;N
A R I F H D | F D R H A;I
S C D B K T | C T B D S;K
M Y Q U V J | Q U Y V J;M
S R I N X K | S K X R I;N
G A X K E Z | A Z G K X;E
L U Y J D M | Y D J U M;L
W R L X N Z | Z N X R W;L
L Y U J B A | U B A J L;Y
F M U L H Q | F U M L H;Q
A U S O P G | O A U P G;S
F T R Y K C | T R C Y K;F
U F R Q S D | U Q D R F;S
Y Q O V A T | V Q T A Y;O
E L M B J G | M J B G E;L
Z U B M E W | Z M W E U;B
D T J Z K C | Z J K C D;T
W H P Y A D | Y W P D A;H
Z D W P N Q | Q N D P W;Z
T X K A C J | X A J K C;T
V M T X H G | H T X M V;G
X H O L E M | M L O E X;H
I F P A L Q | Q F A L I;P
G V Q B P E | G E Q B P;V
R M W Q N Y | W M Q R N;Y
G J R E C Q | R G Q J E;C
V Q O W D H | Q W H V O;D
Z R W Q E B | R Z E B W;Q
M L D G J W | W L J G M;D
N D J M X U | N U J D M;X
C V X H P F | V H P F X;C
X S L E A J | E X L S J;A
Q I K J U F | J F Q I K;U
S Y I W P K | I P K S Y;W
O H P N C W | N O H W P;C
Z R X E B P | Z P R B X;E
T V A P D Z | V Z T P A;D
F Q H M E Z | M H E Q Z;F
R V N K Q D | R D N Q K;V
L M K A Y W | A Y L W M;K
S A P F I N | P F I A N;S
B V S D J Y | J Y B V D;S
K W C J Y U | C W U Y K;J
P Z W B G S | Z P S B G;W
T C Q R O D | O C Q T D;R
V F S D G C | F D V S C;G
O I D B K L | D L B I K;O
G H P B W V | P V H G B;W
W K L Q R H | H W R L Q;K
O I U C S R | R I S U C;O
T O Y E D V | T O E D V;Y
G T I B J C | G J T C B;I
M J K I R H | J H R M K;I
S Q P D W F | S F P D W;Q
O I X P Y U | U O X P Y;I
M J A R S X | J X A R S;M
K H U M L C | L M H U K;C
S G B F A Y | F S A G B;Y
H L M K A F | H A L F M;K
J Z Y C T L | Y T J L C;Z
R J N X S W | N R S W X;J
P R A S L D | P A D S R;L
M V L B F H | L F B V H;M
U E L R D H | E H R U D;L
Z X Y I A U | Y Z I U A;X
V K E Z D G | V G D Z E;K
I P U M S D | I S P D U;M
Y B E V Z I | B I Z E Y;V
Y Q N Z F V | Z Y Q N F;V
F H O M G Q | O M H Q F;G
U Z V G J Q | G Q U Z V;J
V M J N P A | V N J M A;P
E Z H R V Q | E V H Z R;Q
M B H Z E S | E S H B M;Z
O P I S Y F | Y I F O S;P
O U F B X A | B A O U X;F
Q R K B Y S | B Y K Q R;S
A X V U N I | N U V I A;X
V N G R D Z | D Z G R N;V
R G D K N Z | Z D R G N;K
Z N A H G R | A G R Z H;N
Y I K W L F | K L F W I;Y
Z C J P L I | J L C Z P;I
F A B P K T | K B A F T;P
J F V H Z S | H J F Z V;S
W Z T R V N | W T Z N V;R
V T N O L M | M V L N O;T
M Z F S E T | M Z S E F;T
M R Z G S W | Z M W R S;G
F U A N L X | F L N X U;A
U O K N B S | S N B K O;U
U W K F I Z | W I K F Z;U
F E A H W C | H W F A C;E
A F V T C R | T F C A R;V
H E T K C Z | Z C K T E;H
N M J V R P | R N V J M;P
N Q F U B K | B N Q U K;F
F P O X G M | M F O X G;P
G D Y E C U | Y U C G E;D
E X G C R Q | C E Q R G;X
F Q O U A N | O A Q U N;F
M G S N T B | S B M G T;N
G Z A R Q E | R E Z Q A;G
J H S N F P | F N S J P;H
W S R G I L | S L R G I;W
C L M V H J | M V L J C;H
C E J T Z M | M E T J C;Z
V T M Q N B | V N M Q T;B
P B U V G J | G V J U P;B
L J A N I P | J L I A N;P
H R Z Q L V | V H R Z L;Q
K L A I U S | S I A K L;U
T A M Z S K | S A K M T;Z
L N I X S D | D S L N X;I
C X K U Y G | C X U G K;Y
A H I L X U | L I A X H;U
C L R N D T | C L R T N;D
J O A E Q S | E Q S O J;A
V Z A N M D | Z V N M A;D
D J H Y L T | D H T Y J;L
M L A U F X | M U X F L;A
O S F J W Q | W O S J F;Q
V W Z F K G | G K F Z V;W
B L X U O Q | Q O X U B;L
Z B L V A P | L V Z B A;P
U O W F V P | W O P F U;V
N G U V X A | U X A N G;V
J O E Y D X | O X D E J;Y
C K M F J P | P C M F K;J
D E I B S O | E O I B D;S
V M B H T K | B H T V K;M
F N B Q Y M | N Q Y F M;B
H O Z S C D | S O C H Z;D
A J D E T Q | T Q A J E;D
Q Z K A M V | M A Z V K;Q
Z X N G Q O | Q Z X O G;N
K F R Z S Y | Y Z F S R;K
K L H J C T | J H K L C;T
V C R P H Z | P Z H R V;C
F N I T P E | N F E I T;P
G P C O S V | C P G V O;S
V N H W L B | W N H L B;V
S N H I T O | O H I T S;N
Q V P B Y W | V Q W B Y;P
G Z H F I M | H I G M Z;F
U P H K F I | H U K P I;F
Y S G B R H | R Y H G B;S
W J N Y S Z | S J W Y Z;N
N W A V L M | M W A L V;N
J E D T N C | N D T E J;C
P B E I Q J | Q E J I B;P
T Z O S V H | Z V S O H;T
Z G Y N U P | G N U Z P;Y
R M X U O L | U R L O X;M
O S R G E M | G R E O M;S
F W X A T B | B T W F A;X
E O N Z V Q | N V E Z O;Q
K V T L C O | V C O K T;L
Z O I L Y K | I Z K Y O;L
L S K Z A C | S K A L C;Z
V J T U R E | T U J V R;E
Z G Q P Y D | Y Q Z G D;P
I V U M Z S | I M Z V S;U
C Z M T U E | Z E M U T;C
Z B C P W J | P B J Z C;W
R B C M D L | C L D B M;R
K H S X O V | X S K H O;V
W Z Q E V J | W J Q E Z;V
O V P G C B | O P V G C;B
T Z K O U E | T K Z U O;E
C B I S K Q | I Q S C B;K
E V J K U Q | E V Q J K;U
K U I G E S | I E S K U;G
K J S V T R | J R V T S;K
Q U M S A R | A S Q U R;M
T E D R L U | T L D R E;U
Q W E M T I | T M I Q W;E
B K U G O N | B K O G U;N
H T S G K V | G H V S T;K
V J B R D P | J R P V B;D
P N T I X D | N I P T X;D
S P V W I Y | V W P I Y;S
D Q A X Y J | D X J A Q;Y
H J Q B S U | Q S U J H;B
C V K P L A | K P A C L;V
N I K J F B | N K F I B;J
F O I P X M | X M O F I;P
H X V F K P | X V H K P;F
I L T M W U | I L W U T;M
P E Z A O Y | A Z E P O;Y
R Y E B J F | Y R B E J;F
X H C W L D | H C D W L;X
Y R A H K J | J R K A H;Y
D U K I G L | I U D G K;L
C T L S N Y | Y L C N S;T
J H Q X K R | H Q J R X;K
T A Z K U Q | U A T K Q;Z
I K H P Y A | H I Y A K;P
R Z Y H O E | Z O H R Y;E
Y E B J T P | E T J Y P;B
Z B S X J L | B L Z J S;X
B I A Z K U | B U K A I;Z
P I A J X V | J V X A P;I
O Q A T J Y | O Y Q A T;J
K D M U R F | M U F K R;D
X U P G K H | P U H X K;G
H S K Z V Q | Z S H V Q;K
E J L U W X | E U J X L;W
D E P V A U | P E D A U;V
F V Z R S A | S Z F V R;A
C U W T N B | B T C W U;N
V J E L M W | M W L J V;E
H L R P Z C | L P H C R;Z
A R L P G T | G A L R P;T
L B R G C A | L B G R A;C
C M S B P T | S T B M C;P
Q X K C G Z | X C G Z Q;K
H D J C I U | I D U H J;C
N U C W K L | C W L K U;N
Z I U V W P | U W V I Z;P
W V G C P H | W H P G C;V
E V A W B R | E B V R A;W
I C W E V H | I E C W V;H
Q U I V F S | U V Q I S;F
O L X Z V T | Z L V O X;T
L Q X G V A | L A G X V;Q
Q J C H K N | C K J N Q;H
B A F Z G O | F B O A G;Z
D C X J B R | X R D J C;B
G T C H F M | G M H C T;F
D X V I M A | I X V A M;D
D X V B E R | X D E V R;B
T V Y S W N | N V T S W;Y
T N A H X Z | T A X N H;Z
T Z W Q F R | W F Z T R;Q
J K D Z S H | K H S J Z;D
S T Y B U N | S T B Y U;N
N Q A V E X | E X A Q V;N
B J H P V O | V H J O B;P
G X H T S D | D X H G T;S
Q W F J C Z | W F Z J Q;C
G W J B N S | N W S B J;G
W P X V A B | B X W P V;A
Z F I T P C | F Z T P C;I
Z D F H P N | N D P F Z;H
P C J L F M | J P F C L;M
R E C H W Y | H C R E W;Y
E J W M L P | J L W E M;P
F H W T C G | W C G F T;H
Z U R B V N | Z B N R U;V
C O E K D T | T K C D O;E
N Q S U L M | S N Q M L;U
N W X H S E | W X H S E;N
X N S C M L | N L S X C;M
F L Y Q P C | Y C F L P;Q
U X L Q Z D | D L Q Z X;U
A R V B S U | A B V U R;S
W I K O D G | G D O I K;W
Q Z H K J E | E K Q J H;Z
M U I C P E | P E I M U;C
G S P R Y T | S R G P Y;T
E V D Z I R | R V D E Z;I
S X Y R V P | P R S V Y;X
H F V T P B | F B H T V;P
Y Z X K W M | K Z W M Y;X
C O W Z T R | W C Z O T;R
M C P G Y W | M G W P C;Y
F T N S W P | S W F N P;T
Q D N R K S | R S D N K;Q
I E M C F Q | F I E Q M;C
E H O R W N | W H N O E;R
G X E D W K | W K E G X;D
L H Z G P U | P L H Z G;U
D B E M U K | M E D K B;U
R O Y E C I | Y O C I R;E
Y C I V U Z | C Y Z I V;U
R S M V U T | R M S V T;U
G V A R K Z | G K V Z R;A
O L J I Y B | O J B I Y;L
M H Z W A K | M A H Z K;W
E A C T Z W | E Z W A C;T
G V K E M Q | M E K Q G;V
L A B S J O | B O A S L;J
Y F A T J B | J F Y A T;B
E Z T K I B | B T Z I K;E
H N W C I Y | I H Y W C;N
N T B W H A | B T H A W;N
P F A W C R | R W A F P;C
V Q X I B U | B I V Q X;U
W K V S Y G | G W S Y K;V
G B H D U P | U D H P B;G
T I S M X K | M I T X S;K
C P T V Y U | C P T Y V;U
C U N J T S | C J N S U;T
B L I S G Q | B I G S Q;L
L H T O Y M | O Y H M T;L
J X U A O P | U A P J O;X
W I A M L J | I J L W M;A
Y W P X G L | P X G Y W;L
Q V J K C N | N K C J V;Q
M N W T K B | W K B N T;M
V Z T E C X | X V Z T E;C
C U J P Q M | Q U M J P;C
L S F A P Q | Q L F P S;A
Y L N J I A | L A I N Y;J
B E G M F K | F K G E B;M
F T Q P K V | P V K T Q;F
W T C E S P | S T C W P;E
W J F H O Z | F Z H W O;J
J M Q S Y L | J S Q L M;Y
S V X I F N | X V N I S;F
Z A O F R B | O Z R B A;F
R O L T I P | P T O L I;R
B Y H V T I | V H T Y I;B
T F P M B D | T D P B M;F
Z A P T J W | A W P T Z;J
Q O G U F T | T Q U F G;O
W P Y T R G | R Y P T W;G
K O Q M P N | P K M O Q;N
L I J K X U | U I K L J;X
Z Y M A Q H | M H Y Z A;Q
I X W F O H | I F H O W;X
H L V U R A | R V U A H;L
G Z X P Y K | Y P X G K;Z
U B H T K S | B H K U S;T
J N Q X P V | V P X Q N;J
H S Z E Q N | Q Z S E H;N
M Z K C J B | M K J C Z;B
U T K B X I | T K U I B;X
W E Q C X S | W C X S Q;E
N M X I Z J | N J Z M X;I
L Q E M K S | S E L Q M;K
W S I E B V | B V I S E;W
C W A N K Q | C N A W Q;K
E Z L F S M | L E M Z F;S
F K S E O Z | S F Z K E;O
H D T U J A | A U J H T;D
F Q A K N I | K N I A Q;F
E V Y Z T U | E Z Y T U;V
G X D R C B | X R B D C;G
J Z X R A E | R J E X A;Z
D I E M H T | T E H I M;D
S M H Q V L | Q M S H V;L
S D Z H R Y | Y R S D Z;H
Z V D G O Y | D Z O G V;Y
C F G N M J | J F C G M;N
M B I U C J | B C M I J;U
S Y I U Z M | Z U Y S I;M
A B D C E V | V D A B E;C
Y G O H V C | H G C O Y;V
C H G S J P | P C S G J;H
P R U B E S | E B S P R;U
O Y E D Q F | E Y Q D O;F
L W F Z R T | F R T Z L;W
T J L K F Y | L F J Y T;K
V O F X Z H | V F Z O H;X
I G U P X J | P U I X G;J
K G U H P L | G L U H K;P
I Y F V D M | F V I M D;Y
H S Q C E J | C S J H Q;E
J F C Z M R | J R C F M;Z
W C R I L Z | Z R C W I;L
J X W O T M | W M J T O;X
R J P X B D | X D R J P;B
C X Z O U Q | U O Z C Q;X
T B W P L R | T P B L R;W
A S W E B G | S E A W B;G
F I C B E K | E B C F I;K
G R J P A W | J G P W A;R
X N D G E V | G D N V X;E
R W D N S X | S R X W N;D
Q R Y Z T L | R T Y Q Z;L
W D G U O Q | Q W G U D;O
W M O U V I | M W U O I;V
K W O T M L | M T W O L;K
V H K I O E | O H E V K;I
Y Q T S J H | S J Y Q T;H
O F Z U P Q | Z U Q P F;O
E S G B L W | E S B L G;W
I J R V A B | V R I J B;A
C Q U P W N | N U Q C W;P
A S P D N Z | N P D S Z;A
W M N V Z O | O N Z M V;W
N L V O I B | I B V L N;O
H O R G L A | R L O A G;H
J H B U A Z | Z J A B H;U
L S H A P X | S A H L P;X
N G T Q S F | T N G F Q;S
Z F W P U T | Z U F P T;W
S X Y L W M | W S L X M;Y
D H Q J W T | H Q W T J;D
F E O N B I | I N E O F;B
R K E J P W | K R E W J;P
C N Y W Z T | T C Y W Z;N
X K P S J V | V J K P X;S
A R G F E O | O A F G E;R
S A B L P G | G A L B P;S
A W D T O J | W A J D O;T
K Q I F A W | W F K I A;Q
P I B S G V | V G I S B;P
M R Z L K A | A R Z M L;K
O Y N E H Z | N E Z O H;Y
Y S C U A H | H S Y U C;A
B Y V F R L | L Y V R F;B
U W K P G M | W G P K U;M
S G M P Y I | I S Y G P;M
T U B V J R | T B J R V;U
C A P J I H | J P H C A;I
V C R E H G | V R E C G;H
S F O V D Z | V Z O D S;F
Q C J E D N | Q E N D C;J
D I S F U X | S U F X I;D
I N D U F K | F N K I D;U
D A U V P H | V D U P A;H
T K E C U P | T K E C U;P
O Q D C F P | C D Q F O;P
F M T V L Q | T M F V Q;L
Y A V O N K | K O V Y N;A
X O G B D F | F X D G B;O
K B J Y E U | B K E J U;Y
Z U A F N T | F Z A U N;T
A L Y W H D | H L Y D A;W
U K D Q T E | E T K Q D;U
F I K R P C | C P R F I;K
E Q R Y W L | E Y L Q R;W
X C I V F W | V C F X I;W
V F Z Q N I | Z I V N Q;F
M X D K G E | D X M G K;E
T D V O I L | T O D I L;V
X L S M Z F | M S X L F;Z
S V F U N R | V S R U N;F
P L R A S Y | P Y L A R;S
D P V F I S | D F P I S;V
M O C Y A X | A X C O Y;M
K C A E L S | S E A K C;L
R I C D N Q | D Q R I C;N
Z J A M E I | I J M E A;Z
E P J A S L | P L E J S;A
D G N Q B O | N O D G B;Q
R O X K P M | P O M K R;X
A T B P N C | C B A N T;P
I U W F C G | F I G C U;W
L I W D M T | L D M I W;T
A F S I X U | U F X I S;A
Z N S R Y C | C Z N Y S;R
T S A L Q E | S L A E Q;T
S H T L M A | M H T L S;A
U M A Q E D | Q E U A M;D
Z R G C H N | G R H Z C;N
D Q V I H A | I V A H D;Q
G F N T J Y | T N G J Y;F
I W E S C F | C I S E W;F
K G O P E R | G E P R O;K
I E Y L F J | F I E L J;Y
D L O W T H | H D W O L;T
L Q B C T U | U T L Q B;C
P R Y O E M | M P Y E R;O
N T A Z Y S | N A T Z S;Y
S X T Z V L | L X S V Z;T
Y Q X O H P | P X Q O Y;H
Y K I V B N | Y I K B N;V
K C M O S G | C S O K M;G
M L E Y R W | R Y M L W;E
Q S H B T F | T Q H F S;B
A J Y Z Q P | Y Z J P Q;A
P N H A B U | A H U N P;B
D B Q K L G | Q D G K L;B
U S V E H Y | Y U S H E;V
Q A I D F C | I A Q D C;F
U F R K P M | P K U F R;M
N Q M L Y Z | Q M Y L N;Z
R Y P C Z L | Z C P Y R;L
U H B V D G | B U V G H;D
T U X F P L | F P U L X;T
R V C W Z J | V R J W C;Z
H B V U F S | V B H F S;U
E M X V L F | F M L E V;X
N G X A O B | B O G A N;X
V G T U B J | B J T U G;V
C J D I X L | I C L D X;J
G X M Q W U | G Q X M W;U
K H Y X D P | Y K P X D;H
D P W A N O | O D W N A;P
W Y M T F A | A T W F M;Y
R I O U Q N | Q I N O U;R
V N Q F T R | V R N F Q;T
X D R K T W | D R W T X;K
I Z A T S E | T I A S Z;E
X P O B F Y | X F B O Y;P
G U S N J L | N U J L S;G
L B W U M J | W B M J U;L
A U M D S Q | U A S D Q;M
M U R J E W | J E U R W;M
Z J H W U M | U M W H Z;J
Q K H S A T | A H K T Q;S
H W G E M T | H M T E G;W
B H T N D V | N B T D V;H
A Y D G S R | G R A D Y;S
U Y F Q A I | Q A F U Y;I
B C T I E H | I B H E T;C
Z W H K F L | F K L Z H;W
B Z G U T X | X G B U Z;T
V R O W Y N | V N W Y O;R
A M Z F J K | A M J Z F;K
Q C G A U E | C A E U G;Q
A U Y R P N | A R Y U N;P
N A J C E T | N C E A J;T
L D W R J O | O R J D W;L
E Q D Y W P | W Q Y D P;E
C R Y Z V G | Z G V C Y;R
Y V K Q L C | V Y C Q L;K
T Q Y M L F | F Q T M L;Y
T I N H S L | I T H N L;S
I B V R X N | I N R B V;X
P G V B A R | R G P A B;V
A M L P Q E | M L A E P;Q
Y V Z M U O | O M Y U V;Z
I J K Z N G | N K J Z I;G
N E G A U Z | E A Z G U;N
A M H P B E | H B M A P;E
O J X Y B Z | Z Y X J O;B
H E X M L U | M X E H L;U
U H Y R G M | M H Y G R;U
W M T Z J L | L J W M Z;T
Y C E W J R | C W R E Y;J
N X A M F Q | M X N Q F;A
H Z I L Q K | K L Z Q H;I
S Q G O Y V | Q V G Y O;S
R X V O M F | R V O X M;F
D N V Z A B | Z V N D B;A
Q M O D Y L | O M D Q L;Y
L Y Q Z S I | Y L S Z Q;I
T K B J Q C | C K J Q T;B
L T U Z N A | L U Z A T;N
S P A K G J | P S G A K;J
J E Y W B C | Y B W J C;E
K A F Z E U | E F Z A U;K
M I U V T O | U M T O V;I
K H E N Z X | X E H N Z;K
G E S T C U | E S T U C;G
S M F Y C E | C M Y F S;E
M P F W C U | C P U F M;W
P Z R W G C | G P C W Z;R
R O L I T K | T R I L K;O
L E C F G Y | L E F Y G;C
I O Y P U H | I U H P O;Y
S F Y Z Q X | F X Y S Z;Q
X F Q Y G J | Q Y G J F;X
V E L J K A | L J K A E;V
R L O I S Q | S L R Q O;I
C U B W F D | B D U F W;C
E G A D K W | K G D A E;W
D M Z P C T | Z T C P M;D
H C B O S R | H O R C S;B
Y C N M T A | Y T A M N;C
A F Q B V T | B A T F Q;V
T E D K Y W | K D E W T;Y
Q B I C U D | I B D Q U;C
U Q T E F A | T E U Q F;A
U W F O E P | O W U P F;E
F I P D M E | E I M D P;F
O L S N C D | O L S C N;D
P L Q T K Y | L Q P Y T;K
P C G S U B | P U G C B;S
D X A C Z Q | A C D Q X;Z
L B Y M F O | B Y M L O;F
A T L S H C | L T A C H;S
V Z G L T M | L G T V M;Z
X G O D A R | R G A D X;O
U X A H K T | T H K A U;X
C Q P D N W | D C N Q P;W
M A P I D H | A D P H M;I
E V F K X J | E X K V J;F
A B I G Y L | I A Y B G;L
Y E C V S O | C Y O V S;E
B A G Z P T | G P T B Z;A
W Q X E O I | I X Q E W;O
C Q O K R V | Q R O C K;V
Z D F G X L | F L D G Z;X
E Y V G K U | Y E V U G;K
I R E X P T | R E I X P;T
B J Z Y K T | K Y Z B J;T
J R H X S N | N X R H J;S
R W S V O P | P S O V W;R
X F L Z V E | Z X V E F;L
Q C S W F Y | S W Q F Y;C
R H Y F E C | R Y C F E;H
X C Y S R Z | X R Y C S;Z
V L G A T R | L A R G T;V
J K I L H R | I K J H L;R
G C H B R S | C G B S H;R
D R W T A F | F R A D W;T
K D C M G B | D G C M K;B
V R E K U O | V R K E O;U
L F R I Z U | R Z F L U;I
Z T J P H N | H P Z N T;J
I H F X J V | X I H V F;J
O A W T G K | W G A T O;K
V D H Q A C | D H Q C V;A
A O M D S G | S D M O G;A
Y H R D S I | R H I D Y;S
V L X A O F | V L O X F;A
Q A L X E B | L X B A E;Q
N G E C J K | C K J N E;G
M E S B C H | M H C S E;B
Z Q E F X K | Z K X F Q;E
U S W V H Y | H V S Y W;U
J Y M I S K | J S K M I;Y
O M I C B Y | I B M O C;Y
C N F Z T W | Z N T F C;W
C G L N V B | C L B V G;N
A S X K W G | X G A S K;W
G W Q A T K | Q W K G A;T
X F K B R C | F X R C K;B
N W G S X V | N X S G W;V
V L X J H Y | V Y L X J;H
V H B N W X | H X N V B;W
F U V N R X | U R N F V;X
A F D E O Q | E D F O A;Q
U W E L Y I | U L Y W E;I
G C V P J B | G C V B J;P
B P C S W Q | C P B Q W;S
H A G S U V | G H V A U;S
H L T J Z U | Z U J L T;H
D C O U K V | K D U C O;V
D V H K T U | D K H V T;U
A Z D Y M E | E Y Z D A;M
P K R B J W | R P W B K;J
K L G U Z Q | G K U L Q;Z
L O Y N X A | Y N L O X;A
Z W D Y I F | W D Z F I;Y
U L W J X O | O X U J L;W
A X W R B J | R A X J B;W
S Y R V B X | R S Y B V;X
K U W S Z D | S D Z U K;W
H S V Q T Z | Z V H T S;Q
R H L C U J | L U H C J;R
N Q P F Z M | Q F M Z N;P
H N A S F I | I A F N H;S
U C V G I W | I W C U V;G
L M T U O Y | M T O U L;Y
E F A B Z O | F O A B Z;E
Y U K R C V | V Y C U R;K
L O P D W K | L O W P D;K
U N S C R K | K N U R S;C
T V C Z I K | C T V Z K;I
P G W I N T | N P I T W;G
D I T L V Q | T Q L V I;D
P N B G Q Y | Y B P Q N;G
I Q K N S G | G I S K Q;N
O K X J G Y | J K X G Y;O
H I U V P T | H T I V U;P
X F O V Y U | V F O Y X;U
J F L R S G | J S R L G;F
O X Z P H V | X Z P V H;O
S I V G K M | I G M V S;K
Q G V U T N | T G N Q V;U
S V P L U I | U V I L P;S
X C P D V M | D X P V M;C
R D N X S G | D S R G X;N
X S V A J U | V A X U J;S
N E K P Z H | H N P Z K;E
N H W R S A | H S A R N;W
R V H G I J | R V H I G;J
U S K Q E D | K S Q E D;U
O J C Y F I | Y I O C F;J
X T L I Z K | X L I T K;Z
P F D G U K | P D F K G;U
W M E Y H C | W H M C E;Y
J G I Y K P | P Y J I K;G
R M U I F V | V U R F I;M
X M C V S B | V S M B X;C
V O S E Q U | V U S Q O;E
G P E L C D | G C P D E;L
N V K Y E W | Y W E V N;K
P J O U Q L | U Q P J O;L
Z T M B I Y | M B Z T I;Y
U R V T W K | V K W R U;T
A Y S Z G K | Y K Z G S;A
B J W O U S | J S W O B;U
I V E S X Q | E I Q X S;V
H Z A Q J D | Z D H Q A;J
T G C Y L R | L G T C R;Y
C A Q P N W | W A N P Q;C
C W F E N K | N E W K C;F
U C K Q G Y | K U Y G C;Q
B H L I D K | K H L B D;I
C S N U T Z | C Z T N U;S
R O Z M H T | H R Z O T;M
H G F C T A | C A G F T;H
N M V C F B | M N B F C;V
D V W U Q B | U B W V Q;D
T H I A Y Q | T Q A H I;Y
I V Z D Y S | Y Z I D S;V
K W J O E V | J V E K O;W
B R U N L O | N L R B O;U
Z R B P Q G | G P R Z B;Q
M Q T W A Z | T M Z A Q;W
F P K N V R | V P N K R;F
B A I Z D P | D A P I B;Z
K X S W V H | X W V H S;K
O M H X S J | J S H O M;X
U X B Z P G | G B Z P X;U
D H Z F S Q | Z F Q S H;D
Q A F N B I | B Q F N I;A
V I C X K T | X K C T I;V
W U L A S N | L A U N W;S
G C L M Z T | C M G L Z;T
F B Q P N L | L P N F Q;B
Q P O E X I | I P X E O;Q
M R D T P F | D R M F T;P
D O M U L C | U C M L O;D
W V O E N T | N W O E V;T
S K J T B I | K J B S T;I
R E J F Y M | M F Y J E;R
C X T U B O | X B O U T;C
S J Z Y E F | E J S Z F;Y
Z W L H K O | O W K H L;Z
N X Z U K B | Z X U N K;B
L G N O X K | N O X L G;K
U R Q D V Z | R Z V D U;Q
I G R N Z S | Z I R S G;N
S Q T L G J | G S L T J;Q
P T E L C Y | P T Y C L;E
F V N M A H | H A N F V;M
Q P O M X N | Q N O P X;M
J I A T W Z | W A Z J T;I
V U L T P O | U L O V T;P
T U S O N H | H U S T N;O
B F A X I P | B P X A I;F
Y T V K D Q | T V K Y D;Q
D X J E Q S | Q X D E J;S
N A Q C Y L | A C L Y N;Q
C L W K R Z | K C W L Z;R
P A Q W M L | W P Q L M;A
D M J H W C | D M W H J;C
O G M Y C T | Y M C T O;G
P H L K A T | K T L A P;H
Y Q M O X Z | Q M X O Y;Z
R N Y T C G | N Y C T R;G
W V Q N C H | W V N Q C;H
M B A P F O | B P M A O;F
E C U P I X | I P C U E;X
R J B P Q V | Q V B R P;J
H E W C B A | A C W H E;B
H U W X S P | P H U X W;S
H M F I Z Q | I M F H Q;Z
X F Z V S K | F X K V Z;S
I M L X W U | U L W X I;M
B S C T O R | S B C O R;T
U R A W G Q | W G R A U;Q
I E K U Y C | I E Y C U;K
L S J B E X | X B J L E;S
V F H A I K | I A V K F;H
U O S T Q Z | U S O Z Q;T
D Y P L S H | D H S L P;Y
V L N F S T | L T V N F;S
B F T Y W C | Y T C F W;B
S Y E B M I | E I M B S;Y
A D R N O I | O D A N R;I
R P M J X W | R J X W P;M
D F B G R P | B G D P R;F
Y L Q O G X | G O Y X Q;L
W R J H E A | E W R J H;A
I B L H E K | H I B L K;E
I R Y Z V H | V Z H I Y;R
K W S B D P | B S K D W;P
M D O J V L | O L D M J;V
R V S K N C | C R V S K;N
H D X P A F | F D H A X;P
T I H Y R O | T O Y H R;I
J N Q V W B | Q B W N V;J
T K E O D Z | O K E Z T;D
W D G X F V | F D G X V;W
B D V C E Q | B E D V Q;C
G C N Y L E | L C N Y G;E
P B H F E D | F D E P B;H
R I D W A C | D R I W A;C
X Z M K C O | Z O K C X;M
J W Y G P I | I Y P W J;G
R X G L M V | R G X V L;M
B L P Y G E | B E Y L P;G
Z L W O T I | I Z L T O;W
B G W H L K | G W B L K;H
G V S K O D | V O G K D;S
Q F J T C G | C F Q T G;J
W L Q M K I | W M K Q L;I
E R S A M I | I R M A E;S
U K Y F Z P | K Y U Z F;P
Z L D F P K | F P Z D K;L
H L K Y B M | M H K B L;Y
F O I Y V X | F X Y I V;O
P X Y J N G | G Y X J P;N
F G S W X T | F T X S W;G
G M I X P B | P G I B X;M
O V T Y A U | U O A T Y;V
M X P Z T O | Z M O X P;T
J A H M R E | M R A J H;E
N O E Q B S | S O E N Q;B
T R P H J A | J T A R P;H
C J P D R H | D J P H R;C
S W N A L I | L S A W N;I
P F O T B Y | F T Y B O;P
S D N X A P | X S P A N;D
I W B Z D S | B W I Z D;S
S L G O X Y | L G Y X S;O
A J Y C G I | G Y A C I;J
Y D E H P W | P D E Y W;H
O B S T K N | S N O B T;K
O D J L Y F | D J F Y O;L
O V J T S Z | V T S J O;Z
N W A D Y V | A Y N V D;W
I L Q C A B | B L C Q A;I
B G T O Z Q | B Q O Z T;G
R W U O E B | B U W R O;E
U N K W L F | W F K L N;U
P Z E H G X | H X G P E;Z
A W O F L J | W O F J L;A
D U F S K Y | F K S Y U;D
O R K W P A | O W P K R;A
K O B D Z Q | K Z B O Q;D
Z N M P X S | P Z N S X;M
A W E B X L | L E B A W;X
O H V G E Z | V G O E Z;H
J M P S C F | J M P S F;C
O D C G Q A | D O C A Q;G
D O W M L Z | M O Z W D;L
E M G C N I | M N G I E;C
A F P I L J | A L I F J;P
I H O M W S | O M S H W;I
L J P F U H | P U L J H;F
C H R Y J U | R C J U Y;H
Q R V J T N | N V T Q J;R
I Q C Z W R | R C I Z Q;W
X G C R I K | R K I X C;G
N C T D Y G | T C D N Y;G
T V D J A K | K A D T J;V
P W T B Y L | Y L W B P;T
T G R B H P | G H B R T;P
W N O E Z B | E O Z N B;W
O X U E Q M | E M Q O X;U
C F K R O W | C R F K W;O
J M I L F Z | F L M Z J;I
S H O M Y L | M O Y S H;L
J Z V T M N | N V T M J;Z
V D M C Z G | C G Z M V;D
L G S W N I | I N W S L;G
Z K I N W L | W K L I Z;N
P E D Y T J | T Y P J E;D
B Z N F O R | B Z N O R;F
D H Z V B Q | H D B Q Z;V
M U S X I Q | U S M I Q;X
X O T J W M | X T M O J;W
U D P K R T | P T U K R;D
A T I U Z E | T A E U Z;I
H N T L W E | N W E L T;H
Z U G X F M | X Z G M U;F
R J C I Y E | J R I Y C;E
H X C N R Q | N R X Q C;H
Q C N B F E | E F B Q C;N
O Q C S U H | C O S U H;Q
Z A O L S U | U L O Z A;S
F G E H P L | H F L G E;P
X V I H S Y | I V X S H;Y
A I G D Z M | Z M A D G;I
M W B I K L | W M L K B;I
J N I E D V | J I N D E;V
I F X H M B | H B M I F;X
U O R B K J | O K U R B;J
I J X V D O | V D J I O;X
V B N R M L | B N M L V;R
C I N V L G | N V I L C;G
W Q R F K D | F R K W D;Q
M D H P E S | D H S M P;E
C D Z L O H | C D L O H;Z
W X L O G K | W L K O X;G
U D H C S V | C H S V U;D
D L F Y X Q | Q X Y L D;F
P U D G O E | U P O D G;E
T L Y X Z I | Y X L I T;Z
B M W S U I | I W U M S;B
M I F N P X | F X N M P;I
G S C Z E V | V G S Z C;E
C R D U J X | D C J X U;R
D Z A M I U | A M I Z U;D
K U S T R W | T K S W U;R
X Z C Y Q H | Q Z X H Y;C
R P N X G B | N P R G X;B
Q S A H O C | Q S A C O;H
E H G O N S | G S O E H;N
T J W V A P | P W V J T;A
D L G N X R | D N R L G;X
V O S R L N | V O N S L;R
P A O V E Q | O V P A Q;E
P Q W B R Z | W Z B Q R;P
F H U X C V | H U F X C;V
B F D H S V | V D H B S;F
N J S Q L W | N J W S Q;L
P H Q N S U | H P N S Q;U
O A U C B H | U C O A H;B
Q I F Y U Z | Y F Z U I;Q
U M T V K F | T U K V F;M
W Q S V C K | Q S K V C;W
A J M D L X | J M D X L;A
G E B Z I L | Z B I L G;E
E L M V S Z | Z M V L E;S
V H J U Q M | J V M Q H;U
O I N P M U | P N M U I;O
I R P H U J | J U R P I;H
C R G E H J | J E R C G;H
M F K W L I | L M F W I;K
F W D L M R | F D M R L;W
N B F S A Z | B A F N Z;S
F N P J M T | P N F M T;J
Z Q B U R E | Q E Z U B;R
O S T W A Y | W T O S A;Y
Z F O A R T | T R A O Z;F
H E B M C U | B H M U E;C
A C L P O Q | C O L A P;Q
Z A R W B E | W Z B E R;A
B I H S D M | D B H S M;I
F T E H N J | J F H N T;E
I H B P E K | I E B P K;H
D R L H C J | L R C D H;J
Y E M G C F | E M G C Y;F
P I T K N C | T C P N K;I
T U A R E X | T R A X E;U
U G P T V D | G V D T P;U
L Y V G R T | R L Y G V;T
X R V W I P | X R W V P;I
T Y B U N V | V Y T U B;N
X U W T D A | X W U T D;A
K G S X Y A | X S K A Y;G
D N V K R Y | N D R K Y;V
J V I Z B E | B J E Z I;V
C U B H Q X | H B C X U;Q
T D V L M C | V T L C M;D
Y B S D R W | Y B W S R;D
X Z F R T D | D R F T Z;X
M V B I D X | M D B X I;V
B P U W V Q | Q U V P B;W
S Z A K G P | S K Z A P;G
F G K P T I | P G T F I;K
S I C L X M | I X C L S;M
C K S P H Q | K S P C H;Q
A D O U Z T | D U A T Z;O
M N E Z Q F | F Z N E Q;M
Q N A F B D | N A Q F D;B
B U Y E O D | O B E U D;Y
W V K L U J | K W U L J;V
E P M O T N | M O P T N;E
O U E H F W | H O U F W;E
L D C N V J | D V N J L;C
X Z L J O A | Z A J X O;L
R P A Y H U | R Y U P A;H
C E K L M Z | L E Z C K;M
E N J U M V | N E J V U;M
L I G Y U V | V G U Y L;I
D L A F O G | D G A O L;F
O K J R T Y | T J R Y O;K
I R U F A O | O I A U R;F
E A I X Y O | X O Y I E;A
P Z B E R N | Z B R P N;E
V T D O A Q | T Q V O A;D
W Z G Y H K | K Y Z G H;W
T A Q F Y R | Q A Y T F;R
F J Z O C X | J C X F Z;O
I M B U N P | P B I M N;U
Y O G F Q U | Y G F Q U;O
S P G I B R | I R S P G;B
D K F Z Y W | D Z K F Y;W
S Z N T R H | Z N H T R;S
E Y B Q G U | G Q U Y E;B
S Z H C N U | C Z H U S;N
O W B X J K | B W O X K;J
G L X W H T | T G L H W;X
E F U O V D | D E F U O;V
E X G S T W | S W G T E;X
A M T J N Q | Q M J N A;T
Y Q E N A B | Y Q E N A;B
J I F G P S | J G I P S;F
R M X K J E | X J E M R;K
N I K P O E | E O I N P;K
L N F H U Z | H N F L Z;U
B O J S T N | N S O J T;B
I Q E Y M H | E Y M Q I;H
O D E Y G Z | Y Z O G E;D
L B R M D P | P D L R B;M
M C Q B O H | O M B Q H;C
M H I V E F | H M E I V;F
C D K J Y M | Y J C K D;M
O S V L C K | O C V K L;S
X S Q F K O | Q S X O F;K
B C H D R Z | R B D H C;Z
W M P N E I | N E M W I;P
R H S A Z I | A R S Z I;H
N J V Y L P | J N P L Y;V
P X J R B M | M P R B X;J
U D E W Z L | Z D W U E;L
N D C P Q M | Q D N C P;M
E X T L Z K | Z T X L E;K
O Y X G M P | O P Y M X;G
T E A R H C | H T C A E;R
N J E Z C K | J C K N Z;E
L I Y S H N | L S N H I;Y
I B L T Z E | L Z B T I;E
L D B M R T | D M R T L;B
J S U D E L | L J U E S;D
B G L R D X | X R G B D;L
P D C S Y U | U C P Y D;S
R W N B O A | O N B A W;R
J Y S P R O | P S J Y R;O
W G J B K Z | J K B Z G;W
S V G U I Q | G I S Q V;U
X B W G Q R | R X B Q W;G
M C Q N J T | T N J C Q;M
T O N H G S | T O H N G;S
B V K L A F | K B A V F;L
X M V B R T | M V R B X;T
Y P Q A J N | Y J Q A P;N
F A J S X U | F J U X S;A
D M T H J E | M T E H D;J
K P R E Q M | K M P Q R;E
I C K O W Z | C K Z I W;O
I W Z P O Q | Q W Z O P;I
N M Y O S T | Y S O N T;M
R M T Y S G | Y G S R M;T
L B D O N M | L D M B N;O
Z S K C F B | F K Z B S;C
S X Z L P Y | S X P L Y;Z
J C S R K P | C K S R J;P
O I A W L V | A L O W V;I
I S M H W X | H I X M W;S
J H K B S C | K H J B S;C
V T K Q O F | F O V Q K;T
Y L X D G E | G E L X Y;D
L D W Y Q J | Q D Y W J;L
O Z L F R X | R O Z F X;L
S Z D K O P | P S K Z D;O
S X B M F T | X M B T S;F
G M S X D H | S D G M H;X
A P B X L Z | A L B X P;Z
D S Y X I C | D S C Y X;I
H Q T F P L | L T H F Q;P
V L U O D W | U D V O L;W
X J P D U Z | U Z X J D;P
S Z J X Q B | Z J S B Q;X
O U B A E P | O A B U P;E
I F O N Y H | O Y N H I;F
T K E D S J | S D K T E;J
D H A S Q M | M A D Q S;H
Q W U E O Z | Z Q U E O;W
Q I W G X F | I F Q G W;X
C U K E F B | F C K U B;E
J X D I E T | I T E X D;J
L M Q K E C | Q E M C L;K
V U L T N M | N V U M L;T
U W M H N Y | W H N U Y;M
F U H A S C | A S C F H;U
R V U I Y H | Y I U V R;H
O P C F G Q | O C Q P F;G
I W C Y J F | J W C F I;Y
Y A N F P X | A P N F X;Y
N I O K Z B | N O B K I;Z
Y J F Q T O | F Y J Q T;O
A K M I D R | I R K M D;A
N G O A X Z | Z X A O N;G
P J Y V H L | Y V L H P;J
Y A W O P F | O A F Y P;W
B J C S D H | H B D J C;S
N Z X D Q P | N Q P D X;Z
K O Z H Y R | Y R K H O;Z
X W B L E V | X V W B E;L
O K C S M W | K W C S O;M
K C O N M B | O N K C M;B
Y Q D U Z J | J Y Q U Z;D
F S B I T J | J I T S F;B
I F H X T V | V X F T I;H
D O G H J I | G D O J I;H
V G R S X E | R E G S V;X
U Z M S B N | M S Z N U;B
L A R I V C | A L R V I;C
Q E X S O T | Q S X O E;T
G T W H J P | G J T P H;W
H F G B L Q | H B G L Q;F
V G R U K N | K V U G R;N
Q D X R L V | D Q V R L;X
M T D Q P J | P Q D M T;J
O S Q T Y V | T Y S V Q;O
D Y Z L C O | D C L Z Y;O
X C P I N U | X C P N I;U
B H M E K V | V M B K H;E
C R W Y G B | C R B W G;Y
V T Q P S U | V S T P U;Q
L H X Q Y N | L Q H X N;Y
C I S O J Y | J Y S I O;C
K D Q N E T | N T D K Q;E
C E D K Z J | D E J Z K;C
Y Q R K I M | I Y R K M;Q
C S D A X V | S C A D V;X
S H K V E C | S E C K H;V
T D S U M P | D T S P U;M
X A I V P G | G I P A V;X
K Z B I R V | V B I K Z;R
A W N Y I Z | A W N Z Y;I
F O U H A I | F A I O U;H
U A C V E F | U E A F C;V
B P E U H L | E P B H U;L
V M D E P I | M D I E P;V
H X A E B V | V H E B X;A
M D Z N F S | S F Z M D;N
L E H Y V F | Y L V E H;F
B Y R D H X | R H Y X D;B
O I Y G E B | I Y E G B;O
D Q B F O R | Q O R F B;D
L B V P S H | S B L H V;P
W N M I E B | I M W B N;E
X K Z Q Y R | X Q R K Z;Y
G D J F R A | A J G R F;D
L J P T X S | J S P X L;T
X A C O W K | C W A X K;O
G I T Q F Y | G Q Y F I;T
S B R Y V X | R V Y X S;B
M A H Y O W | Y O H W M;A
V L R U M T | L T U M V;R
N F U J O B | J O N U F;B
Y N V Q E K | Y V K Q N;E
E V Q H C W | W V E H Q;C
J W Z Q E D | W J Q Z E;D
V S H P W C | W H C S P;V
V G U F P R | R G F P V;U
P U Q C H F | C U P H Q;F
H N O X S Q | O Q S N H;X
G W M Z H J | G J H Z M;W
D O Z M K I | D I O M Z;K
P Y C S M F | M Y F S P;C
E J Y Q G L | G E Q L J;Y
U N C K Y D | U N Y D C;K
E C T K F P | E F K P C;T
B S T L V E | S V T B E;L
S K J Y F G | G Y F S J;K
T K G S H Y | G S K Y T;H
T Y M J R P | Y R J P T;M
M H X P F W | P H W F M;X
H J D T Y E | H D Y T J;E
L Z J B T R | J B Z T L;R
Q R U X N Y | U N Y Q X;R
Z K L O H D | L O K D Z;H
K J X Z U Q | J Q K X U;Z
K F Z L H B | Z B K F H;L
E R W D M X | W R D M X;E
K S C Y X U | K C X Y U;S
V L O D P E | D L P O V;E
W O A T J Q | Q A J W T;O
N Z D O G J | O J N Z G;D
G D F Y M I | M G I D F;Y
S P D N H G | G N D H S;P
D H A P E L | E A D L H;P
L U Q N B R | N U B Q L;R
N X Q Y E B | Y X E N B;Q
B S F G D Q | D Q S G B;F
I F B R T P | B T R I P;F
B J D Z L U | B D L Z J;U
I X M C D T | T M D C X;I
O A T E L P | P O E A L;T
R O X U S D | O R U X S;D
F C T D L Y | T D L Y F;C
P A X H B S | B H X A P;S
F X M R G I | F X G I R;M
U T H E L V | H V U T E;L
E N J F Z M | J F M Z N;E
I D L R O X | D X I R L;O
G V L W J I | V I J W L;G
A Z M Y R I | R A I M Z;Y
T U B D V Y | B V U T D;Y
W C Q X H B | B H Q C W;X
E O S M D F | D S M E F;O
P H T Q I G | T I Q H P;G
D F V Y N K | V F D K Y;N
B O U I Y Z | Z I U B O;Y
C K V L X H | L X H K V;C
T V J P S D | J S P V D;T
B U T H Z C | C Z B H T;U
C N V T I Y | C V T I Y;N
Y E B W Z Q | W Y Q B Z;E
Z L K N O X | N L X Z O;K
Q T J P X M | P T X M Q;J
J W S Z O I | W J O S I;Z
N H V G X U | U H N G V;X
P S L D I W | S L P D W;I
M V A C E B | E C V M B;A
T C J K A H | J T K H A;C
O Y K V B E | Y K B E O;V
U Y D S E T | D Y T E U;S
M F G X U H | G X M H F;U
N Y R V O Q | Q R N V O;Y
J A Z X V B | J B V X A;Z
M D R O J A | D A O M J;R
S O R A F U | U S R A F;O
N M F R T J | F N T M J;R
Y C B E G D | D G B Y E;C
Y W C S R N | W S N Y R;C
B Q X J U P | B Q P U X;J
P K Z I M O | I K M O Z;P
U G D W Z M | D U M W Z;G
A N V P K I | V A K P I;N
H Z P E L O | H P Z L E;O
W L H J Z Y | W L Y H J;Z
K D P V Y N | Y D V K P;N
L H G T Z F | Z G H L T;F
I K F A Z T | A K I T Z;F
T Q U J R P | T P J R U;Q
X V J N K C | J N C V X;K
E T U A Q V | A T E V Q;U
U B A M O V | O V U A M;B
T Y Q M B G | T Y Q G M;B
Q N S X Y K | S N K Y X;Q
S T C M E I | I C M T E;S
A U S X W M | U A M S X;W
Y B T P X V | Y B V T X;P
Q F O C B U | F B U Q C;O
M L U K D G | G U K D M;L
C V B K L J | B V L C J;K
Z T P C B W | T Z P B W;C
U M H P L Y | L Y M U P;H
R Z J L D I | I R J D Z;L
P V M U F R | M V P F R;U
G N O W L S | O S W N G;L
Z L A I C J | I L C Z A;J
W K L U J E | J L U K W;E
Q W R I A L | A W Q R I;L
K B W Q R X | Q X B K W;R
R H L S N I | S L N I R;H
M C X S P Q | C P Q M X;S
Z F O M B Y | Z M O B Y;F
T H A U P W | T W H U A;P
Z G K U B I | B Z I K U;G
G Z Y H B A | Y G Z A H;B
S Q B C F M | B C M S F;Q
A Z Q C L J | A L C Q J;Z
J O C S V G | C G S O J;V
S T R X D P | R X S T D;P
O J L T M U | O J M L T;U
I A G Z Y V | Z I G A V;Y
K L D V U W | U V D L K;W
B L G N O D | N G B L O;D
U I N B O S | I N S O U;B
S G I Q K Y | K Q G S Y;I
E S M O H N | E M N S O;H
O E M V B H | V B M E O;H
T U L Q N Z | Q N Z T U;L
K F G O Q X | X G O F K;Q
P E G F L Y | L Y P F E;G
H B O F X M | B H F X M;O
U P T D E R | U T E D R;P
Q M J X A B | X J B Q M;A
E M S Y I O | S E O M I;Y
M K O G V W | M K V G O;W
D Q M K S W | Q K M S W;D
M B D G C I | M C I G D;B
V K P M L Z | M P V Z L;K
I V R H Q Y | V Y R I Q;H
Q W B J L A | W J B L Q;A
R O P J K E | J K R E P;O
T O Z B H C | B O C Z H;T
Z J X R S B | R J X Z S;B
O R A D H P | H A P R O;D
H U S B I T | U B T I S;H
J Y W R P X | J W R Y P;X
B V Q I R U | R V I B Q;U
V U F N M Q | V U N F M;Q
K G F T L Z | L F G K Z;T
D J G X M R | X G D R M;J
R B I A F Q | Q F R A B;I
A J U Z C V | J Z U C V;A
L Z D U W I | W D L Z U;I
T M A R H Q | Q M A T H;R
D L P E A Q | A P L E D;Q
Z U O G X W | Z X U W O;G
N Z C J V X | J C V X N;Z
T G N Q S L | L Q N T G;S
B Y C W U I | C Y W B U;I
P V J U N E | J N E U P;V
Y Q H S E X | H E X S Y;Q
C X S B P M | C X P S B;M
Z L Q O F C | Q L O C Z;F
K N X Y T S | N T X Y K;S
X W N Q J Y | Q Y W J X;N
A O Z Q J F | O J A Z Q;F
A I B P G L | A I G P L;B
J M X W T Y | T M W J Y;X
J H X F Y L | J L Y F H;X
C I M L Q A | Q A I L C;M
F M I P Q Y | F Y P Q I;M
N M H C R L | L N H R M;C
J Z V L C X | V L J Z C;X
S D I B H M | H B I M D;S
H R D Y W L | D H W Y R;L
T E K R G Z | R E G T K;Z
R Q Y I D J | R J Y I D;Q
G U F S P V | S P U V G;F
N L K W Q R | K W R L N;Q
P F E L R K | R E F P L;K
A I U H W N | H A N W U;I
L J W H A N | A L W N H;J
A D O U S M | S M D O U;A
N I U Z E H | E N U H I;Z
I X R S T P | S X R T P;I
V R X P F U | X V U F P;R
D S F Z P J | S J Z D P;F
R E C S V X | X S V R E;C
O S H B V W | S O H B V;W
P C S W F Q | F W P Q S;C
A F L M S J | M A S L F;J
G A S Y C I | I A G C S;Y
N U S A Q G | Q S N G U;A
K S F Y V C | C S V Y K;F
I Y M P L W | W P I L M;Y
H D V S K N | V D H S K;N
Q R G C L F | C F R L G;Q
D F M Q G A | G D Q A M;F
S R Q W D H | R D S H W;Q
G V S B D A | S B D A G;V
G T R L U F | L U G T F;R
V G W T C Z | T Z W V G;C
Q I Z A S N | N I S A Q;Z
L E D Y Z V | E D Y Z V;L
W K T D Y B | Y D B K T;W
H O V D G C | D H O G C;V
U X J D C P | J P C U X;D
O D W F P M | F O W M P;D
O R D S M G | R G O M S;D
L I G M V T | L M T G I;V
F Z E M L B | Z F M B L;E
B T U L G D | G D L U T;B
B I R M P F | F R M I P;B
Q L P C I Z | Q L P Z I;C
T W I U B R | R T I W U;B
T D E L O N | D E T N L;O
C T J Z B K | C K Z T B;J
G H R K N M | H G M N R;K
V P H W K A | K H W A V;P
Y Q F J K W | Q K Y J F;W
T A L D M F | A D T F L;M
W Q S A C O | C Q W S A;O
X V O N J F | V X J O F;N
M Z Q W H D | Z Q W H D;M
D N C M L R | N R L C M;D
Z L S P R G | R G S P L;Z
I G T A Z W | W Z G T I;A
H K V R T S | R H V S T;K
R S P O H B | B P S O R;H
S C E N J R | N E R S J;C
E V D H I R | R H I D E;V
B K W G C Y | B W Y G C;K
D Q P N W E | Q P N W D;E
X B I D Q R | R D Q X B;I
D P B U H Q | B H D P Q;U
J D O S M F | S O J D M;F
F Q R D C V | C R V D F;Q
E I Y P C K | C I K P E;Y
N P G H F Z | H Z F P G;N
A B H T P D | A D T P B;H
W P A H L M | A W P M H;L
Z V X C F L | L Z X V C;F
R K W C Y I | W I C R Y;K
G O M V I T | O M T G I;V
X R Q N Y J | R J N Y X;Q
C Z D B M E | E D Z C B;M
U T A R I Z | U T I A R;Z
U Q I W A G | W G Q U I;A
A F I V J P | P I V A F;J
O D U H B N | D U O N B;H
C U Y B O H | U B Y C H;O
V O P W I S | S O P V I;W
W A O J L E | A O J L E;W
N W I R J S | S W R N I;J
W D M A B R | R M B A W;D
X Q C B S K | B C K Q X;S
M P R G H X | G X P M H;R
A H M V W Q | A H V W M;Q
R Y D P W M | W P Y D R;M
T M O X V S | O S V M X;T
C L H Z U T | H L Z T U;C
W B F G M I | F W G I B;M
J F S H B G | H S B G F;J
H P G D R L | G L D P H;R
W E D F L H | L H F W D;E
M C U E Q J | Q J U E M;C
H P S O Y N | S N O Y P;H
Q Z Y D H T | H Z T Y D;Q
B N E I O A | B O E N I;A
M T C L H E | E H M C L;T
U F H Q K B | H U Q B K;F
K V N F S W | V S F K N;W
Z Q Y X B T | Q B Z T X;Y
K S E R J N | R N K J E;S
O S P G X Z | X G Z O S;P
M A Q T S L | S A Q M L;T
B A Z U S F | B S A F Z;U
B Y J Z G A | A Z G B Y;J
N Z X O S F | X Z S F O;N
Y R C G H W | W C R H G;Y
G L A W S P | L W P G A;S
T J M P O K | T O M P K;J
I G Z Q A W | Z I G A Q;W
B E H T U W | B U H T E;W
C R W J D S | R C J S D;W
A G U J S P | G U A S J;P
T U I J Q M | I T Q U M;J
N H A Y G V | A V Y G H;N
B U W G K A | U B A W K;G
C R F K Y M | F R Y M K;C
K P D S V Z | D K P Z S;V
R A H Q V M | H M Q V R;A
C O S X I Z | C Z S O X;I
Y T F V P R | P R Y F T;V
Y R G I X W | Y I G X R;W
S A Q G C W | A G S W Q;C
V B M J W R | R J M W V;B
A M G D U S | G U S D A;M
G V L T B Q | G Q B T V;L
S U Y J O B | J O Y U B;S
E K T Z A D | Z A K T E;D
V P W Q Z T | V Z Q P W;T
S H L C Q E | Q S C H E;L
Y N K T G U | G Y K T U;N
N M L T J O | T L J M N;O
E L J V U C | L E J U C;V
O T F C X N | N O C T X;F
O A E Q I M | O A M E I;Q
H E Z W J M | Z M W E J;H
V X M L J D | X M V L D;J
S G C B K T | T S K G C;B
W X Y K H R | W R H X Y;K
S O N E H Y | S E H Y O;N
W G A I N K | I W K G A;N
W J I Y E F | J Y W E I;F
G Z I U S R | G Z R S U;I
P D Z I O T | T Z D O P;I
B H A V Y M | B M V H Y;A
C J M H Z P | H M J C Z;P
Z R T Q I D | Q R Z D T;I
T S W O Q K | S T O W Q;K
R P Z F D K | R F D P K;Z
B T H M O U | U H O M T;B
D H X Z Q O | Q H X O Z;D
D X U H Q L | X H L D U;Q
W L O D B S | B L S W D;O
O X T Y I K | T K X I Y;O
G M I L W K | M W I L G;K
R V H S P L | V R L S P;H
Q M A V O I | I M Q A O;V
Q G C I Y A | A C I G Y;Q
H T K U B W | U T B W H;K
P Y V I L Q | Y I V Q L;P
B Z Q M P O | P Z O Q M;B
S U T Y E H | T E H S Y;U
T L C D G P | P G L T C;D
H G I M D C | H D C M I;G
Q F T M J X | J Q F X M;T
V L A K Q O | V Q O K L;A
X S W A U K | A S U X K;W
L N Q R P J | Q N J P L;R
I S K E O M | S I O E M;K
O V K X S I | I K O S X;V
Q F J X E K | E K F Q J;X
R D Q F J K | D F R Q K;J
K I O B X Q | K B X I Q;O
R X Y L C O | O Y L C R;X
T I X B J Z | X T B Z J;I
M L C B K Y | K B Y L M;C
V N Q X H I | H V N X Q;I
R Z E C F A | C Z A F E;R
S O X Z F Q | Z X F S Q;O
S Y B C A Q | S A B Q C;Y
K D C M F B | K M D B F;C
I Y K X E S | K S I Y X;E
Q K C H V M | Q V K H C;M
Z A Y D V T | V T Y D A;Z
D K I L B C | I C K D L;B
L Z G T V U | V T G Z U;L
R D S C N E | C S N D R;E
M I C E R X | R E I M X;C
H Z J B G X | X G H J Z;B
S V N T D F | V N T S F;D
L S I K A V | S I A L V;K
Q J W L F K | Q J W K F;L
W O C H Y S | O C H S Y;W
W Y O J A U | A U O W J;Y
C Z I A R U | R A U I C;Z
V E Q C O T | Q O E V C;T
S B I C L O | I C O S L;B
I Q O P B D | Q I D P O;B
J Q C E G Y | Y G C J E;Q
I Z P U Q D | P Q I D Z;U
D N K P C O | P D K N C;O
E W K B U O | B K W U O;E
S Y F G R C | G C R S Y;F
G R A B W U | B A R U G;W
I W E K P M | P M K I E;W
D C O W F A | O F W A C;D
F P M O S Y | M Y S P O;F
T A U N M I | M I A N U;T
C K V S Z E | E K C S Z;V
S I R E M P | M R S I P;E
R Y G B W D | R D B W G;Y
J P U N T F | P N J U T;F
A R F U B M | F U M B A;R
S P B G T H | S G H T P;B
U C M L D H | D M H L C;U
S P C N M X | M N X C P;S
O I F V M N | O V M N F;I
W Y G L H P | H G Y W P;L
U J O I F H | I H F O U;J
T S A N E C | S C A T N;E
I T X O Y G | Y O T I G;X
R Q B P O T | T O R B Q;P
L T I G P X | I T X L G;P
O K T H Y R | O K T R Y;H
H F L C P I | I C H L P;F
J K C L W X | K L X C W;J
O M G N S F | G S F M N;O
I U N V F T | V U F N T;I
V T U L W D | D U W L T;V
E Q Y J N U | N J U E Y;Q
M K T Y U W | T Y W K M;U
C F J L Q I | J F Q L C;I
T H G X C O | T C H X O;G
H V D O M W | W O V D M;H
X D L R E J | X R D J E;L
D Y J W A M | Y M D W A;J
Z F R M E P | Z R P F E;M
S J N Z E Y | S Y J N Z;E
V G O L Z J | L J V Z G;O
X D B F P T | F P B T D;X
R G Q J T S | G S R T J;Q
R O K G X W | W K G X O;R
M O I F G R | G F R I M;O
B Z X A H N | Z H N B X;A
E H V I B R | H I B R V;E
Y T O S Z G | T Y S O G;Z
V X C D S O | D V C O X;S
C G O H T N | O T H N C;G
H F D A L V | V L F D H;A
F I K T J O | I K J T O;F
I Z K Q C T | Z K T Q C;I
B I N X D L | I N L B X;D
J Q G C Y E | Q E G J C;Y
J S Z X E Q | E Q J Z S;X
Y J Z W T E | W T E J Y;Z
J K R Z O M | K O R J Z;M
Q Y U L X V | V L Y U X;Q
Z X K N J P | Z P K N X;J
Y V R A N M | Y A V R N;M
X Y U H Q R | R X Y H U;Q
F C P Y N G | C F N P G;Y
A Y W N X L | X L W A Y;N
A U N Q L X | A Q N X L;U
R P Q T N X | N R Q X T;P
J H G Z B Y | G B Y Z H;J
U F C V W M | M F U W V;C
P B F D Y H | Y P D B H;F
U J O D B X | O X B J U;D
D V E F Z X | Z D F V X;E
X O A G F R | O G X A R;F
C Y D A W B | B Y W D A;C
G F P B K R | P B G K F;R
S H R K U W | U S K R W;H
O Z I B L D | O D Z L B;I
V N Q Y K W | V W Y N Q;K
Z N A S H D | H A Z N S;D
S X D O T A | D A O T S;X
D Y A J K E | K Y A E J;D
I K W V P E | W V E P K;I
G S Y I W C | W Y S C I;G
P S X F E T | F P X S T;E
F N J G L O | F L J O G;N
I A P X L O | X L I O A;P
L B I C K X | I L B C K;X
V F T R U N | F U R N T;V
P Q Z O T E | E T Z Q P;O
M Z B Q V E | V M E B Q;Z
V A Z S L R | R V L Z S;A
U N P H F S | P U N H F;S
L I Y P M Q | M I Y L Q;P
V S Z A O G | S A Z V G;O
T Q J V U O | J T Q U O;V
O Z T W J M | O W T M Z;J
Q I J C G N | G I C Q N;J
H W F J V L | J V F W H;L
K N Z X G L | N G X Z K;L
P S A N F T | P N F T A;S
F C H N B S | B S C H F;N
O K N H F P | O H P K N;F
M H S E G Q | G H S Q E;M
W T J N C Y | W N C Y J;T
C E R X W U | R X E C U;W
D I S X H V | X D I S V;H
A Q Y H D C | Y H D A C;Q
R J T W A Y | A R T Y W;J
D T S N W C | W D C S T;N
V H Y O G X | X G V O H;Y
W B O F T C | B C O W F;T
U D V P F O | O F D P U;V
M T H B Q U | M Q B U T;H
S Q W A T L | A S L T Q;W
T F H U N A | F A U N H;T
K L U I C X | U C X I K;L
R I Z W A X | X I W A R;Z
I B R A Y X | R B I A X;Y
G C R Y U K | C K Y R G;U
N H E U J L | J U N L E;H
R V P J B T | J V T R P;B
Z D J H O K | O K Z H J;D
Z F W K B S | Z W S F K;B
Z A E X I F | I A F X Z;E
N A M L I T | T L A I M;N
X P R V E Z | Z X E R P;V
U M Q D S I | S U D M Q;I
Y A U E N G | Y G A U N;E
Q R D L Z V | R V D L Z;Q
E R M X T D | D M R X E;T
H C U P S F | P F U C H;S
R A D Z B W | W R A B D;Z
Z M S Y E O | Y S Z O M;E
G L N M V U | N V M G L;U
B R W S A H | W R B S A;H
O S Y J X U | X O S U Y;J
M G E L O F | M F E G L;O
V M H G O Z | M H O G Z;V
T W E C X P | W C X T E;P
P F J E H N | H E F P J;N
M Z I G W X | W M Z X I;G
L S I R H U | U H S L I;R
X R A Q Z T | X A T R Z;Q
P L S F I W | I F S W L;P
C K F J O X | K F J C O;X
G M S V L O | G V L M S;O
Y N W K P D | K Y P D N;W
E S Q J I M | M S I J Q;E
H C P D X L | L P X H C;D
B D N T G W | W G D T B;N
L Y N M V P | L M P N Y;V
Y V B J Q D | B Y D V J;Q
T K C H R U | H U T K C;R
F M D E A X | D M A X E;F
D E C X H Y | E D H Y C;X
H W U I T O | W O H T I;U
M G I J D C | M D I G C;J
Y K O P A Q | Q O K Y A;P
L N X W S D | X L N S D;W
N Y H F W C | N F H C Y;W
C L B U N I | C U N I B;L
H F C S Z P | C P F Z H;S
Q K H T G B | G B Q K H;T
P G B N K T | K P G T N;B
B C Y I S V | Y B V S C;I
J P U L G I | G I L U J;P
Q R D J V S | V Q J R D;S
V X O G A H | G V O A X;H
Z S Q T R J | Q T S J R;Z
Y U F A I Z | F I A Y Z;U
V E D O J I | I O J E V;D
W P K Q G Z | W K Z G P;Q
A M O S F Q | M S F A O;Q
Y X U N B O | Y O U B N;X
K J X G Z R | Z R X G J;K
S I H V B Y | Y H I S B;V
H Z V I X U | Z H X V I;U
F H B M V A | M F B V H;A
H D B G Q S | H Q D G S;B
V Z C K O P | O P Z V K;C
K J D U L N | U J K L N;D
Q T S I C F | T S Q C I;F
Z Q V R T K | T R Z K V;Q
J R I W K S | I W R K S;J
F T C I M W | C M I F T;W
F V X B O Y | Y B X F O;V
B K J U R I | J K I R B;U
D J M S X P | D X P S M;J
U H K D C I | D K I C U;H
Y A B U O X | U X A Y O;B
S U W L Y D | W U Y L S;D
H R K Q E O | R K O E Q;H
J Z Q B C D | D Q J C B;Z
B U O Y N Q | Y B N Q O;U
C X D F R Y | F Y C D X;R
C L T H R Y | L C H R T;Y
A D V P U F | P D V A U;F
L R B D P F | P F R B D;L
G U J M C B | G U J B M;C
M I E H F J | E I F J M;H
T I E X P A | X E A P I;T
A D M X C B | X M C B D;A
V Q P Y M I | M Q Y P I;V
G H Y U P I | Y I G U P;H
N R B Y U C | Y B U C N;R
F C R Z T N | R Z N T F;C
Q T U C I W | I C U Q T;W
F J A C M Y | M J C A Y;F
M V I W T K | T V I K M;W
O T J D A G | T J A G D;O
Y W L A C R | L W C R A;Y
Y S F K H M | F K H S Y;M
M O I D E U | I D O E U;M
S M R N J V | J S N V M;R
Y U W H Z A | U Y H Z A;W
C W F G D R | F R C D G;W
U W O G J L | G U W L J;O
H C F O X Q | C O X H Q;F
M G K J P L | M K J G P;L
S N I X Q E | N S Q E I;X
F B Z X C N | Z B X C N;F
N D E M S U | S E D M N;U
W E J G Y D | D G J E W;Y
E A R D Z W | A R W Z D;E
L K Q D N S | S D K Q N;L
D P M S J G | M D P J G;S
C O V M D X | X D C O M;V
R W Y E D X | W R E X D;Y
Q V G X C A | Q G A C X;V
Q T O S F W | S W T O Q;F
W X N Y C L | X N W Y C;L
O V L S D R | V O R L D;S
Q M I R G X | X G I R Q;M
U M I S Z O | S Z I U M;O
S Y V M X H | Y X S V M;H
U J P Q G S | U S J G Q;P
L A Z V M I | M Z V A L;I
Y M V L B N | V M N Y B;L
H F O R V P | V H F O R;P
Z A K F B U | A F Z B K;U
B W R L K X | X B K R L;W
P K C B T U | C K P T B;U
M G H S Z O | S O Z H G;M
S D K J I Q | D I J Q S;K
P N F M C T | N M F C T;P
N U R A F J | F A N R U;J
J D T F E S | S D T F J;E
I P Z K L H | I H P Z L;K
U D K M X C | C K M D U;X
G B Q V N A | B G V A N;Q
V J H Y G T | G Y V J H;T
C S B G H E | H C S E B;G
M F V S O K | K M F O V;S
K J S V F Z | F K S J V;Z
M Y E Z L X | E M Z X Y;L
T B K F O R | R F O B K;T
S F E B P J | F B P J S;E
Y M W J I H | M Y J W H;I
M N U P L Z | U Z M N P;L
M K N V R L | L R K N M;V
G Q W M I Z | I W G M Z;Q
X H J Z N A | J X N H Z;A
A W Q K Z N | W K A Z N;Q
C W T H S X | S T W X C;H
U E R Y V T | R E V Y U;T
T D B A P U | P T U A B;D
V A R B T C | T R A B C;V
U T D L W B | T B L U W;D
V X T U Y F | Y U F X V;T
P F O N E A | O N F A E;P
U M Z P W E | U Z E W P;M
I A P B V W | V I W P A;B
C U F G N Q | F Q N G U;C
J G Z T P D | D Z J T P;G
U E Q X G R | G X R U Q;E
C I V Q G D | Q D I V G;C
Y E O R I V | Y E O I R;V
M H F V G Y | V Y H G F;M
K B V I G Q | I V Q K G;B
L Q Z P R T | R Q Z P L;T
E I D G T Z | D Z G T E;I
C K I R E X | I R X K E;C
I Z E V D O | O V E Z D;I
I L R O Z V | R L I O Z;V
M A Y F D K | M F Y A K;D
H R A C Q E | A E R H C;Q
X W M J Y G | Y J X M W;G
X W Q L O H | Q O L W X;H
U Q K O L Y | Q L O U Y;K
V W Q B G U | Q V B G U;W
O J Y I U C | U O C J I;Y
B N F J Z U | F J Z B U;N
V C G T F N | T V F C N;G
V Z P B F Q | Q Z V P B;F
Y L G J V W | G Y W V J;L
P Q C I M L | Q P C M L;I
X Z P Y E D | P Z Y D X;E
W Z N E S L | S Z E N L;W
E X T P V K | P T V E X;K
U L F H S M | U F L S H;M
O P Z H B E | H O B Z E;P
X Y N O G D | Y O G D X;N
Q E B H L V | V L Q E H;B
T W Q X K J | W J X Q K;T
F B Q M O R | R M O Q F;B
T Z P X E A | P Z T E A;X
D S K A Z W | K Z S W A;D
Z J Q V U G | Z J V Q U;G
S T D G P U | P D S G T;U
D Y Q R A Z | Z R Y A Q;D
E N C P S Z | E C Z N S;P
N G I J E P | G I P E J;N
J D P A N G | G N P D J;A
T H J F E C | J T E F C;H
G C U F M X | X M C G U;F
S W J O F E | J W E F O;S
H F M E B K | B E M F H;K
V Z Q N S D | N V Q S Z;D
P C L Q E O | L C E P O;Q
N O H D Y Z | N Z D Y O;H
Z L A Q M P | P M Q Z L;A
H K W U F I | W H F K I;U
F V S I Z L | Z L F V I;S
U V J O M F | O U M V F;J
L X D M Y H | Y M H L D;X
S Z K C Y P | K C Y S P;Z
F C Y M R A | Y M C A R;F
H J R E F N | H E F R N;J
I H Y V B Q | Y V H I Q;B
J S M C F E | S C M F E;J
Z B N L C G | Z C L G B;N
W P J D M V | V D W M J;P
S N E V B K | E V K N S;B
I O J D E T | T D I E O;J
Q V W D N K | D W K Q V;N
V B C E Q L | V B Q C L;E
S R E N M L | E N R S L;M
L T H W Z D | T L D Z H;W
S T L U C Q | S L Q U T;C
K M D X Q J | K J M X Q;D
R Z T G Y V | T V G R Z;Y
V B I T S J | I J S V B;T
D K R I S N | N R I S D;K
Q H I E F Z | E H Q Z I;F
H B P F Z N | F P H Z N;B
Y C J N P K | Y P N C J;K
Q Z R D S P | Q D P S Z;R
A Z Y X H N | X H Y N Z;A
W G C T X A | T C G X W;A
X Z L K S H | X H S K Z;L
Q D S P B F | P Q F S B;D
A T F U I N | U I N F T;A
F Y U R D M | Y D R F M;U
Y U L M B A | M B Y A U;L
T O F P Z W | O T F W Z;P
T W H V Q O | W T Q H O;V
V O N P U H | P H U O N;V
P R D F A Q | Q D R F P;A
J T R Y P S | P J Y R T;S
Z Q C T E U | E T Q Z C;U
S W O Q I B | O S Q W B;I
I Z M K E O | M K E I O;Z
L O V Q R G | R Q V L G;O
Q L T V G H | V T Q L H;G
M D C U G W | C W U M G;D
C G X F H E | G E X F H;C
Z R W T I E | E I T W R;Z
Q C S H D K | K D Q H S;C
T R C Y F K | F C K R Y;T
M Z C P T K | M K T C Z;P
P R Q Y F M | P F M Y Q;R
Y F D L N C | D Y L F C;N
S O R U A L | S R A O U;L
H Y C T K D | T K C H D;Y
N V X O C L | V N O C L;X
C U P Y X B | U X P B C;Y
E R Y J U K | Y K E R J;U
C A P X V D | X P V A C;D
X O N P Q U | P N Q X U;O
P Z S Q W V | W V Z S P;Q
G N I Y C H | H Y N G I;C
D E V K O Z | O Z V E D;K
E C Z J Y H | Z C H E J;Y
N A S K Q E | S N E K A;Q
Z Y K S X O | O X S K Y;Z
L H C F N D | C N D H F;L
K M Q P T H | M T P K Q;H
W X R O J A | J R X W A;O
R B M J L K | J L M R B;K
B Z T E N J | T J Z N B;E
Z H A E F M | M Z F E A;H
K V H Y X S | K S H V X;Y
Q D L X K I | I L Q D K;X
B X W L P D | X W D P B;L
O L E A X R | R L X A O;E
G F Z A Y O | Z O Y F A;G
B E V J M W | W E M J B;V
I J C B T P | J I T P B;C
S O M R T A | T A O M S;R
V W F Y P O | F O Y W V;P
W D H T E X | T D E W X;H
A J M D N X | X N J D M;A
D W K U T G | T D G U K;W
R B E C X G | X B E R G;C
K S C Q E N | C N E Q S;K
H S W Y J G | G J W Y S;H
Y C J X V P | V Y X C P;J
Q V L D T W | Q V L W D;T
Q V J T Y W | Q T W Y J;V
R X K V Q P | Q V K P R;X
Q O B V I S | V B O S I;Q
I S T G W H | I W S T G;H
V X U Z E J | U X V E J;Z
M N L S R Z | N M Z R L;S
Y Q X B M E | X M Q E B;Y
K Z B L N M | Z L N B M;K
I W N H G F | W F H G N;I
T N G F H E | G F E H N;T
I W O J U T | T J U I W;O
A Q X R P E | Q R E A X;P
J U F L W S | L S J F U;W
N E S L M K | E M L K S;N
E U Z F W O | W U Z O F;E
U V F J T R | V F J T U;R
J S T I X R | R X I J S;T
P S G B C Y | G C Y S P;B
V G S X W O | V G S X W;O
X J N Z H K | J H X K N;Z
V K G P C U | K V G C P;U
H S Z R O L | H L O R Z;S
V A W S I K | S W I V K;A
K X O W V U | V K X O U;W
N V A B P L | L V P A N;B
O L B H U Q | U H O B Q;L
A M W P F C | F P M A W;C
X C U B I M | U M X I C;B
M B C V P A | V A P B C;M
C Q Z D U T | C D T Q Z;U
L N M H K B | N H L M K;B
C S N Y J X | N C Y S J;X
J Y V T K F | J T K F Y;V
Y K U P H W | K U Y P H;W
P D O U H W | O U D P H;W
N A L M S W | M A L N W;S
B L V I P A | P A V B L;I
Z K U P O Y | U K O Y Z;P
X Z R G I U | R X Z I G;U
O V Y L D C | L O Y C D;V
E H I G B T | T B E H I;G
H B C S J N | N J B S C;H
W H Q I M X | M W I X H;Q
I C Z D M P | C D Z I P;M
D M W H B K | W M H D B;K
W O Z B J N | B J N Z O;W
F T Q O E X | Q X E O T;F
Z J Q M Y K | K M J Y Q;Z
G V O A L U | L V O U G;A
D W H L O Z | W H L O Z;D
F O W Q U H | U W H Q F;O
H F Y B U K | B K U Y F;H
P T G S Y U | Y U S T P;G
M Y X L I O | M L X I O;Y
K N X A I D | D K X N A;I
W P Y L D J | D P W J Y;L
K A Z T D Y | D Y K T Z;A
X N V R U E | U X N E V;R
S I Y M B P | I P S M B;Y
S X P U N D | X S U N D;P
T I Q F S Z | Z F I Q T;S
T J O I U G | I O T G U;J
H D C W E N | N H E W D;C
V P T Z K Q | V Q T K Z;P
L Y F K M H | K L M Y F;H
D V R H G W | R V G H W;D
T S E P K Y | Y P E T K;S
M W X U A K | W U M X K;A
O A W T E X | A T W O X;E
X V C P K S | S P C K V;X
K I O G Y U | Y G U K I;O
L A I P Z K | Z K A I P;L
D E N L R K | D K L N R;E
Y W C T R H | W T H Y C;R
S W X N D Z | D X S N Z;W
R B Q J I C | I R B Q J;C
K B A C E G | G E K A B;C
T N D V Z B | N Z B T V;D
R C N B I U | N R C B I;U
F I T R P K | R K T P F;I
N Y X A V O | Y A X N V;O
H B T J E K | E B T K H;J
K O Q U F T | U K F Q O;T
M E Y U D G | G D U M Y;E
A Z T Q F Y | Z A T Y Q;F
H G Z P K R | K Z G H P;R
Q C T N R P | C P R T N;Q
H S C Z I P | P Z C S H;I
S V W J N A | A V S W N;J
N C I X S J | J I X N S;C
T I Q S K M | I Q M T K;S
T B H Z U R | H B Z R T;U
W H V B K X | X B V H K;W
N Z V D M U | N U V Z M;D
S R V T B X | S R B T X;V
X F T W Q Z | T Z Q W F;X
B Y J K U T | U B T K Y;J
J K S N W X | W J S K N;X
X R Z I C B | X B R I C;Z
H V A M N B | A H M N B;V
B Z P X M G | B P G M Z;X
C S N F E Z | E Z C S F;N
R Z N Q I C | C N I Z Q;R
S A R F I Y | F A I R S;Y
S P Z A C W | P Z C A W;S
J L P K R F | L J R F P;K
B N C F Y H | C F N B Y;H
H L F Q R D | Q L F D R;H
Y U E Q M V | Q E U Y V;M
N H O J G F | N J F O H;G
I P V T H N | T V H N I;P
R M U Z X J | U J X Z R;M
K V W H N I | W V N H K;I
Y I N L O V | V L Y I N;O
C D K Q M T | D K C M Q;T
C A V I G L | V L A C I;G
Q Z M H L Y | L H M Q Z;Y
C H X K B U | C K U H B;X
I Q K Y H E | Q E H Y I;K
P E Z Y V C | C V Y E Z;P
U P R L Z T | R T U Z P;L
P S L E O A | P A L O S;E
M J Q W O P | Q M P O W;J
V O Q L F C | V O Q C F;L
G U Y T K H | U G K T Y;H
W D T X V U | D V W U X;T
J I G S Q V | J G I V S;Q
B V I J N T | B V N T I;J
S F V L G B | G V F B L;S
K M J A E X | A J K E M;X
X E B O L V | O X L E B;V
O Y C X H B | O B C X H;Y
A Y V F H B | B A V F H;Y
I X Q L E J | E X Q L J;I
L V B K X E | K L V X B;E
P M D U S O | U M O S P;D
D A J N L K | L N D J K;A
F X L B R Z | B X F L Z;R
E U J K S A | J S K A U;E
M S C G T K | C T M K S;G
K B A M Q T | Q T A M K;B
S W J Q Z E | W Z J Q S;E
G S K U H X | K U H G S;X
K I L Y X R | R I Y L K;X
W N Z I D K | N D K I Z;W
F V Y L A G | F G A Y V;L
Z E G Q A B | G Q B A Z;E
T H B I V Z | I H B V Z;T
A N V O B J | J O N B V;A
H Y N F O P | H Y O F N;P
G L R A M H | M L H R G;A
Q F M A Z S | F Z Q A S;M
M F K C G I | C G M F K;I
C N B V A K | C K N B V;A
Z S G F Q J | G Q S J Z;F
N M E Y Z Q | Z E Y N M;Q
J Y V B O X | J B V Y O;X
U I H D M O | H M I D U;O
P E Z O Y H | Z H E P Y;O
X R H I N O | I N O H X;R
S V R K W C | S K C V R;W
Q G X F O V | O X Q G F;V
D Z K Y R M | K R D Z M;Y
L G O K J H | K G J L H;O
Y R H Z E S | E H Y Z R;S
V B T J P A | B J P A T;V
H Y F C R T | F C T H R;Y
T E H N X F | X E H F N;T
C N X Y F E | E Y C F N;X
L O T P V I | V O P T I;L
G F V J H K | F K V J H;G
D C B K T P | B T D C K;P
G D N J K Z | N G J K Z;D
V G L Y A J | V J L Y A;G
H X G E W Y | Y X W E H;G
S P O R W X | X P W O S;R
B U C N P S | P B N U C;S
T U X R F J | X T U R J;F
Y U E R D F | R Y E F D;U
N D K G H R | G R N H D;K
V Z L S B C | V B C Z L;S
O I V A Y N | Y A O I V;N
H S A N M P | M A N S H;P
Y B E I H M | H B I E M;Y
Y F S D W L | S Y D L W;F
A R Y V J Z | V Y R A Z;J
U P D B R J | U B P D J;R
O U Y A H I | Y A U O I;H
P T U E L X | E X L U P;T
D J S A L M | D J L S M;A
A W H K C S | S C K H A;W
X V W O F Z | F V Z W X;O
L V P C F S | C S V L P;F
K I X G C M | K X M C G;I
N Y M E X C | Y X E N M;C
I R K J L C | J K I L C;R
T R O S P G | G O S R P;T
O Z T W X D | D W T Z X;O
Z F E R T Y | F Z R E Y;T
X S T F V R | R V X F T;S
O Z I N R H | O Z R I N;H
B J W L P U | W P B J U;L
G P E V W Q | P E G W Q;V
D G A F Q C | A Q F D G;C
J K R D S C | J S K C R;D
X D U I J Y | I J D U Y;X
M Z W R D Q | Q R D M W;Z
S D N Y F B | N F B D Y;S
A V I W T J | I W A T V;J
F I O J Y V | F V Y J O;I
L M A S R C | S R L A C;M
S G M O B Q | M O G B Q;S
S C K H Q T | S Q K C H;T
I A W E D V | E D A V W;I
L Y Q H X U | Q L Y H X;U
R B K V G I | K I R B V;G
U Z C O I D | U C O I Z;D
V N I U C R | C I U V N;R
H F R E M Z | F R Z H M;E
T Y D Z H V | Z D T H Y;V
X J N H Z W | X W J Z H;N
L K Q D O Y | D Q K O L;Y
K L I V D Q | I L Q K D;V
L H P G M U | H G M P L;U
H R O I L M | M H I O L;R
H P Z Y W U | H Z U P Y;W
O E M U A Y | U A E M Y;O
P R A N S H | S H A R P;N
A C S J O M | J O C S A;M
N P A Y L C | A C Y L N;P
G Q O T X W | X Q G W O;T
C G O W Q U | Q C O W G;U
W G J A F Z | W F A G Z;J
G C I R P N | R I C N G;P
X B Z K E V | V K Z X B;E
F M W R K A | R K A M F;W
O T U Y C H | C U T H Y;O
Y W U X A D | W A U D X;Y
I S N J Z W | Z I J W N;S
Q B Z J X N | N X J B Z;Q
I C S L N B | B S I C L;N
F U T Y C J | F U C Y T;J
B F K H Q J | F H B K Q;J
M K F T A H | H K M T A;F
E X F N O R | E N R F X;O
V N I C T J | I T C N J;V
Y O F Z A J | J O F Y A;Z
L W F N V S | V W L N F;S
R B X P O G | P X G O R;B
S G U O T N | U T N S G;O
S E I N K P | K N S I P;E
D I X Q E C | Q C D E I;X
X N I L O K | N K O I X;L
J L H I E T | J L E H I;T
L G R D K V | R D K G V;L
I L N O Z B | O B N I Z;L
Q H Z U C X | Q U X H Z;C
E S P V D J | J P S E D;V
J N E M V K | J K N E V;M
B T P Y F M | M Y B P F;T
J T M Q K X | Q K M X T;J
C P S X O F | X S P O F;C
Z R U C N H | U R Z C N;H
C N P F U L | L P C N F;U
A I V L Q M | L M A V Q;I
L O I G C U | L G C U O;I
L U C R M G | L R U C G;M
H U V Z E N | V U H E N;Z
Z R I V E A | R A E I Z;V
U K A M P G | G P A K U;M
T X I F B M | I B X M T;F
A X V U M W | W M X A U;V
U H G J Y A | G U J H Y;A
W U S K L D | U L K S W;D
H B D U X W | D B W X U;H
F A P V K R | R P A F K;V
X S U B K M | X B U M K;S
X C L Y F V | Y F L X V;C
E P Q V O I | O V I Q E;P
T S N V F E | V T N F E;S
S Z K P O Y | K Z Y O S;P
U D L C K G | L D K C U;G
U R F D B K | R K D B U;F
E J L W B T | W T E B J;L
M O H X I S | S I X O H;M
C X Y D I O | O X D C Y;I
R A L E I V | A E R I V;L
U P D G R Z | R D Z P U;G
O G R Z J L | J O L Z R;G
E X D P O Y | Y O E P X;D
W R S K M J | K M W J R;S
T Y I U H E | E H Y I T;U
N R W T U L | T W L N U;R
T B F Y O X | Y O B X T;F
G Q X B S U | U Q X G S;B
I W D L S P | P I W D S;L
Z A C H D P | Z H A P D;C
Y N A K C H | C N A K H;Y
M G H B E I | G E I B H;M
X G B T Q N | N Q T G X;B
V I J B Q D | J V I D Q;B
U N O B Y S | N B U Y S;O
P S J B V H | V S J P H;B
T B S Y X P | B T Y X S;P
H U L S M V | H V U M L;S
A L I O Y J | Y A J L O;I
S Z N B U K | B K Z S N;U
M Y T Q W D | W M Y T D;Q
X T A R P H | T R P H X;A
U S G A T L | G A T L S;U
I S Q Z F O | Q S F Z I;O
K B S G U N | S U K B G;N
U Z I W Y N | U N Y W Z;I
J Z T W I X | Z X W I J;T
K S V C A X | X K V S A;C
M T F C V E | F M V T E;C
I L K W Y Q | I K Y Q W;L
G K V S W F | S V K G W;F
S Q A P L K | S Q L A P;K
F U A N J Z | F J N U A;Z
E L T C G Y | T C G L E;Y
U I D N O X | N D I X U;O
N Z C O K Q | Q Z K N C;O
B V X P C W | B P W V X;C
J Y A E O M | Y J M A E;O
E B G W F N | B N W E G;F
Y O P A V B | O P B V Y;A
U C F T H A | F C T A U;H
U R A W Z J | R U Z A J;W
H P X U L F | U X H P L;F
Y F K S R T | R S Y T K;F
S Z F Q B O | Z B S F Q;O
O W L J G Z | W G J Z O;L
P M F H A R | H R A P F;M
I L H D E K | I K H D E;L
O C Y E G P | E C Y O P;G
L V Z E N U | N V U L Z;E
A H M C V I | A V M C I;H
X Z J M G D | X Z J D M;G
H R N C P Q | C N H Q P;R
L M Q X N D | M X N Q D;L
D N K G U P | K U G P N;D
N W C K D G | D C W K N;G
N B H F R U | R H N B U;F
E J N L K U | K N J E U;L
I U X R A H | H X A I U;R
W S R E T O | R W T S E;O
E Y I V Q J | Q I V Y E;J
D I Z J C N | D C I J N;Z
U C I W P Z | I U C W Z;P
R D A N F W | F D R W A;N
K U T D Z P | T K D U Z;P
Y U P B E M | E B M P Y;U
M P U O N S | U M S N O;P
O K L F M U | U F K O L;M
M K C Q V G | V M G C Q;K
U Q V N I M | N M I V Q;U
G J M A F C | M F C G J;A
B O T X I Y | B X I Y T;O
C O D M R V | O R M D C;V
Z W C Y B P | Y C B P Z;W
M E O J B A | E J A B M;O
U M T F C H | U T M C H;F
F G A H W E | F G E H W;A
S R J W E N | E J S W R;N
P F B H D Z | Z H P B F;D
N M G K P T | K T M P N;G
J G V P U N | P N J V G;U
U Y X L I K | U I X K Y;L
N I E O W U | W O I E U;N
L E S P Q V | V L Q P S;E
B I T U R Q | T I Q R B;U
D Y Q G N Z | D Q N G Z;Y
T L D B I V | T D B L I;V
N C V B R O | C R N V B;O
C B Z F D Y | Y B D Z C;F
T G Y O S P | O T Y G P;S
U E D Y N V | N V U D E;Y
V K Y A I O | Y V K A I;O
I E B S R U | B R U I S;E
I K D M F P | M I F D P;K
V R O W H S | H O R W V;S
Y E T M H B | B E H Y T;M
Q G Y A P H | Y Q P G A;H
E F G S Q O | Q G F E S;O
P H E B F A | B E A H P;F
E V I P Z L | I Z E L P;V
T D W C R O | O T D R W;C
S A C P R Y | A R S C Y;P
P X K M U Z | X U P M Z;K
S V Z F C D | Z S D C F;V
C F K W U R | F K R W U;C
B F G L N Q | F L Q B N;G
V Y P F S T | T Y V S F;P
H W G M B X | H M X G B;W
W I J T Y N | Y N J T W;I
D Z E J T K | D T Z E K;J
H U R B K E | R E U K H;B
E F U X O T | O X U E T;F
R X Z H O E | H Z E X O;R
I O Y C U T | T I Y U C;O
T N K E J A | T A K E J;N
S U C G R F | U C F G S;R
P U W Z L E | Z L P U W;E
R X E J W K | W J R X K;E
F G P T C B | P B G F T;C
W H F I X E | H W X I F;E
T D Y B Z M | Y D T B Z;M
D F G B C M | F B D M G;C
M N D Q O Z | Q N D M Z;O
H G I D M U | I G D U M;H
D O V R N A | R D V N A;O
Q V B U H L | H Q B V L;U
Y K I P F E | E K P F Y;I
W D L I K P | W K I D L;P
E D L T O G | L E O G T;D
Z G U P K W | Z W K U G;P
B F G W O Z | Z O W F G;B
V O I R D Y | O Y D I V;R
N J Q I M Y | N M Y J Q;I
H P Z G O E | G Z P H E;O
O W I G E R | O G I W R;E
N T R A C G | T A G N R;C
Q K Y N E H | Q H Y N E;K
L X J F S H | X S H F J;L
H C K I F Q | K H I C Q;F
Y U M N X J | Y X M N J;U
W H K E T V | H W V T K;E
Y O U J C V | U C Y V O;J
K S M N X F | X S N F K;M
B S Q M I E | E S B Q I;M
V A T P L F | L F T P V;A
V L Z E N B | B Z N L E;V
Q M A F G L | A L F G Q;M
L C G O S X | O L S G C;X
G H P S R I | P I S G H;R
N S E T D L | S E T D L;N
R N E I P K | R N I E P;K
Y J X R O K | X R J O Y;K
M A S I U E | S M A I E;U
Q I T R O G | O T R Q I;G
B G I W C N | I G B C N;W
J W E N O I | E W I N J;O
U Z T E J B | T J Z E B;U
M H Z O T L | H L O Z T;M
I A G H W C | C W I H G;A
G T B W F E | B W T E F;G
J L F I G Q | Q F J L I;G
F V B W G S | F S W V G;B
W N L F D H | W N D F L;H
E J G D M W | D M W G E;J
B P Q D F I | B I P Q D;F
N X H C U B | C X H U N;B
A F P I N Q | F P A I Q;N
T O V I M A | O A M T V;I
H Z J M P A | A M P H J;Z
J M H G Z F | F M H G Z;J
B X U K I C | X C I B K;U
Z V W Q K T | Q V T W K;Z
C E F O Y J | O F E Y J;C
C E S N X I | E I X C N;S
N M H J P R | M J P R H;N
D R E J F G | G F J E D;R
A R X M V O | R A O X V;M
U I Q M P B | M B Q P I;U
X Q R T O N | N T Q O R;X
G N B Q K U | B G Q K N;U
W F X M N B | F N M X W;B
V Q G P K E | E G V K P;Q
A S P O Y T | O Y P S A;T
I R Y Z O V | O R Y V I;Z
Q H W K R L | Q W K R H;L
B O N D S P | P B S D O;N
B H Z M S Y | S B Y Z H;M
U L X G H F | L U G F X;H
C Z G V Y E | Y C V Z G;E
L A Q U O N | U A Q L O;N
L P Y V R K | R Y V L K;P
Z K Y L R U | K Z Y R U;L
L S X Q U O | O L S U X;Q
K C B O G H | G C B H O;K
Z E H T G D | G E H D T;Z
A S P B W Y | B P Y A S;W
X W V K D E | K V X D E;W
K U Y A O J | Y U J A O;K
W I J U T F | I J T W F;U
W F D Z L V | W L D Z V;F
I D Q W J M | Q M W I J;D
T Z L P Q O | Z T O Q L;P
F H N R A D | R N D A H;F
B P I F E O | E P B I F;O
H R F J Z T | R F J H Z;T
O K A R Z S | K A S Z O;R
C S I N T H | I H N S T;C
D N V J T W | J W D N T;V
H B X V K L | K H V X B;L
P U W B X V | W V B P U;X
T J U Q D A | U A J Q D;T
U A C O Q S | U C Q S A;O
M X Z E J A | X Z J E M;A
U R X O E Q | E R X U Q;O
S D R M V I | M D I V R;S
D F X E C U | E X D F C;U
U W Q L Z N | W L U Z Q;N
O F P A S J | F O P J A;S
V M G I R X | R I G X V;M
H N C J I F | I F J N C;H
M K F H C Y | M C Y F H;K
Y P K M V A | A V K Y M;P
P S B W C H | P S W B H;C
K I E P O D | O D K P E;I
E V C A R T | A C V E R;T
I Z C P U D | C P Z I U;D
I N M X U G | M I U N G;X
M B X P D K | X D M P B;K
P N D I O X | I N O X D;P
Z W L Q B U | Q B W U L;Z
O S M I P K | O I K M S;P
E C A U T N | T U A C N;E
B I C P M O | C O B M P;I
C V O W I L | C W V I O;L
N S L U Q F | U N L Q F;S
E Z C W G M | W G E C Z;M
W C H U N F | C W U H N;F
Q B O J U W | W B J Q O;U
D O Q B G R | G O Q R B;D
A Q B M E U | A Q U B E;M
K Y V X U E | Y U V E X;K
V B J Z K G | V J Z G B;K
H V P E M K | E P K M V;H
Y K S V U B | Y S B V K;U
N E K P I U | U N K E P;I
Q T P L H E | E T H P Q;L
N C R E O P | E P N R C;O
S J T F K H | H T S K J;F
S M X K R P | R P K X S;M
I T Y O F B | T B O I Y;F
U Y C D S P | U C P D Y;S
P I E O K D | O P I K D;E
J H T N E M | E H N T J;M
A T K F Q R | R A T K Q;F
K Q V H F N | V Q N F K;H
G V F Z X E | F E Z V G;X
I L V O W M | I L O W V;M
W D I C R U | C U W I R;D
L E Y X W F | W Y E L X;F
A Y Q I W D | W A Q I Y;D
H Q K X T C | T H Q C K;X
R C F B Q S | C S R B Q;F
M W G N U C | G W C N U;M
M L O R C E | R E M O L;C
Q Z H M T W | H Q W Z M;T
Y B C V N F | C B V Y N;F
P R F I D H | D F H I P;R
N Z T C H W | H N W C T;Z
Z L U M I H | L U M I Z;H
M E N U D F | E N F U M;D
P N S R I M | M I P S R;N
H Q Z M B P | Q M P Z H;B
N Y X W A I | N W Y I X;A
C H J P Y T | C J T Y P;H
R A B O I Q | O A I B Q;R
S M P G B N | S M P N G;B
W T Q M Y B | Q B W T M;Y
G A X N D P | D X N A G;P
H G I X K B | B K X G I;H
V G Z Y P I | G I Y V Z;P
Y U H A B J | Y A U H J;B
D L S K W N | W S D L N;K
T G K N R V | T V N R G;K
I Y L Q N M | N I Y Q L;M
I J Z X A T | T I J Z X;A
Y A U R J E | R Y E U A;J
M W V Y T I | T I V M Y;W
A T X K L J | X T J A K;L
Y S P G E I | S I G P E;Y
P J O I K Y | O J I K Y;P
F D K W I Z | Z I F W K;D
I S B K T Z | K I B Z T;S
T O H Y K W | K O H T W;Y
J E K H L N | L E H J K;N
D K P J T X | P J K D T;X
M E Y R D W | Y E W D R;M
E J R B I G | E J B G R;I
R Z P I W X | R Z W X I;P
E D O S R Q | R E S Q O;D
M L H S A D | M S D L A;H
T G A F B Q | B A F Q G;T
X J S G R K | K J X G R;S
F A I G Z O | G A Z I O;F
A Y T L C E | A T C L E;Y
L W X P Z D | L Z X W P;D
E I F P Z S | Z E P I F;S
V I C W M L | C M W L V;I
Y F D I X V | Y F D I X;V
M Y O A F P | O P F A Y;M
A T D Y Q H | T Q Y H A;D
I E M N T Q | I E Q T N;M
Q I O F N E | O F I N Q;E
F E R I L O | F I L O R;E
A W Z V I Y | Y V A Z W;I
E K S F Z N | K F S Z E;N
K I N F G T | T I K F G;N
R O V P W X | O P R X V;W
Y T G Q I D | G Y D I Q;T
J K Z Q L H | H Q Z L J;K
E Z W P G L | E W P L G;Z
Y K A S X D | D Y X K S;A
Q K B A H D | D H B A K;Q
Q N V G X H | V G X Q H;N
J R Y O X B | Y J B R X;O
F L X I P V | V F L P I;X
P X I O Y W | Y P O X I;W
T A Q S U F | F Q S A U;T
E W R J Y V | E W V R Y;J
O W R J G N | O G J W R;N
M A K T H W | K H A M W;T
X S I N V U | S X N U V;I
L F D C Q Z | F D Q Z C;L
U Q N W M K | N W Q M K;U
D U E A H X | H U D X A;E
D X Q K E F | X E Q D F;K
A O L Z N E | O E N L A;Z
J M W X B E | W B M E X;J
Q K L E D O | E D Q L K;O
W J L G A S | L G S A J;W
O X W F C J | O C W X F;J
E C T P J L | C J T L P;E
Q U Z L H V | L Q V H U;Z
U N K O W T | K W T O U;N
Q D E K Y R | E R Q Y D;K
H N E Z L R | Z R L N H;E
K D A G V E | E A V K D;G
Y F W D P S | F W S D Y;P
Z V N E F J | V E Z F J;N
R A Z N E D | N Z R D A;E
V Y R D F O | V O R F D;Y
E T Z N C A | C N A T E;Z
L Q J Z H E | Q J E H L;Z
P G N J I S | N P J G S;I
D E L W P Y | D W Y E P;L
D M W Y Z I | Z I Y W M;D
N A O G M S | A S G O M;N
U I J X H F | I J H U F;X
G T Q V D F | G T F V Q;D
C N M Y F E | E M Y N F;C
K Z C Q W B | Q B C K W;Z
S D U W P V | S P W D U;V
A N W V Q F | V F Q W N;A
U C I Q L J | I U Q J C;L
K U A V M O | U K A O M;V
D M G F W J | J D F G M;W
M S F L W D | L W D F M;S
S E V G D X | D X S E G;V
F M Z G A X | A X F G M;Z
Z F E Y D W | F Z Y W D;E
K E A B Q U | K A Q E B;U
H U R K Q V | V H Q R K;U
M J T V Z H | V H M Z J;T
J W H N X I | N I X W J;H
U J B K Z I | J K I B U;Z
A R S I F N | S N I R A;F
M I C P W K | M C I P K;W
H E U P D V | H D V U P;E
A U H L Q X | Q U H A L;X
L N W D P O | L D N W O;P
X K W L E U | L E U W K;X
Q U S Z H F | S H F Z U;Q
T Q F N K L | K N Q L T;F
U V K I G A | G V K I U;A
T Q O E R J | O E Q T J;R
K Z T I C N | Z I K N T;C
K M R P J O | P O M R J;K
J B V U L X | L V X U J;B
B Y M G X N | Y G X B M;N
V J E O W U | U J W E O;V
J I D Y H R | I H Y J D;R
P C M D L A | C A M D P;L
J C H Q N O | C J N H Q;O
N C G V S M | N G C V M;S
F D I V Z E | D E F I V;Z
Q P J C B U | B U C J P;Q
F E H V A Q | H E V A F;Q
U P E T O A | T U O A E;P
V X Y M D S | M S D Y X;V
L J Y Q E U | U J E L Y;Q
U F Z D H I | H I F U Z;D
Y L U H Z G | Y L H U Z;G
S W H U Q F | W S F H Q;U
I W Y U E D | W I Y E D;U
M U J N P W | U M J P W;N
B U V N F J | N U B J F;V
H O R C U I | I C O U R;H
T C H Y O A | A C T Y H;O
P J Q S L I | S I P J Q;L
A G Q W O B | W A G B Q;O
Z C B P G N | B N G Z P;C
G N Z V C P | N V C G P;Z
V Y N S T U | N U Y T V;S
U D S B V W | V S U D B;W
B G C Z T E | G B C Z T;E
R H X P G W | X W P G R;H
T S N Q G Z | S G Z N Q;T
M X Z K F V | V Z X M K;F
Q U J K N L | J Q U N K;L
H O S Z R I | O I H S R;Z
C X S O A P | O C P S X;A
H D W N C G | H C D W N;G
O D Q I C S | S Q C D I;O
G B F I L A | F I B L G;A
Q A J V P D | J A D Q V;P
L O P H F V | H O P F V;L
A S V C H F | C S A H F;V
R U F O G C | C G F R O;U
J S A D V U | J A V S D;U
D J C Q A X | A Q C X J;D
B Z I Y X T | I B Z X T;Y
E I M Y O A | M Y A O E;I
D F Y M T X | Y M T D X;F
Z O L G H R | O G Z R H;L
J G E V Q X | J V Q G X;E
X Q A S F H | X Q S A H;F
A V Q P Y G | A V P Q G;Y
B P Q R X W | W R X P Q;B
L C A M S Y | A Y S C M;L
C Z R N A J | A C Z R N;J
B E I X Z R | Z X B I E;R
T K F Z V X | T V F K X;Z
N O G Z W T | Z T G O W;N
O P L U V D | L U O P D;V
W M K T B O | T B O M K;W
R G F X N C | C G F R N;X
I D G H W F | G F W D I;H
P I N C W A | W A P C I;N
J E X F Q S | S J X F E;Q
D L B S K Z | K S B L Z;D
M J B S Q G | B J G S M;Q
H K N B Y L | N L B Y H;K
M C A I R H | R M H A C;I
P S U M I Z | U M P S Z;I
M X Y T E O | X M E O T;Y
P A X Z R M | P R A X Z;M
V J Z H N G | Z G N V H;J
I F U J M X | J M I U F;X
P I V L M R | P M I R L;V
E Y Q F D L | L E F Q Y;D
F U V Z T Q | F U T Z Q;V
F I Y Q E A | Q E I A Y;F
F E C R Z Y | R Z C E F;Y
V Q U O D F | O F V U D;Q
D H S J T Q | D Q H T J;S
V G J M K Z | M G Z K J;V
W F U A D Q | W D A U Q;F
A N J P C F | J C P A F;N
S K F J Z I | Z I F J S;K
N A M B X T | B T A X N;M
Z N F C X T | C F X Z T;N
H J D T Y F | D Y T F J;H
H M R Y J W | M Y W J R;H
W P E J L N | E L P N J;W
A T L I S E | I S E T L;A
J P N K I C | N P K I J;C
R Z M U I F | M R I U F;Z
C X L N P Q | P N L X C;Q
R P H K S T | P K H S R;T
G W E L Y N | L G E Y W;N
I T H Y O N | H I N T O;Y
D A O G V L | G V D A O;L
X V U J R Y | J U Y X V;R
O I J A U N | A J U I O;N
V G X D N M | X V G N M;D
N P A L H F | N P A F H;L
J B V A P W | B A J P V;W
I K X O F B | K O I F X;B
U F T D H Z | T U H Z D;F
B I Z D S J | I Z J B S;D
N R E U Y L | R L Y U E;N
Y B V N U C | Y B C U N;V
X Y Z A C H | A H C X Z;Y
U L N T K Z | N K L T Z;U
T J F P A M | T F A J M;P
K B P T N F | N B T K F;P
M B D V C L | V M C L D;B
B M O W I J | B W I M J;O
S E M T B Z | B M S T Z;E
W F I Y J R | Y W F I J;R
X P H W M G | X M H W P;G
Z E I L Q C | L I E Q Z;C
L A J Q W U | L Q W U J;A
X O H G E R | G H R E X;O
E T D B P H | B D T P H;E
N H X W E P | W X E P N;H
N K J C Y O | Y K O C J;N
L X N G Z C | X N G C Z;L
K P W Q N M | P N K W M;Q
J L M T F K | F K J M L;T
H D K V X L | K D V X H;L
L U W G T Q | Q U W T G;L
Q P A O T C | C Q P O T;A
S Q W E J U | E Q U W J;S
R X S F K N | N F R K S;X
Q S A F V J | Q S A J F;V
L U O D G M | G D M O U;L
K W M C B I | I C M B K;W
P Z I R N A | P I A R Z;N
V A J S T K | J A V T S;K
L X Q G K P | Q G X L P;K
F D A Z Y V | V A D F Z;Y
Q E C N Y J | Y C E N Q;J
B L J V G F | V J L G F;B
T F Y J Z K | T Y J Z K;F
U X H V E L | H E X V U;L
U J N P H S | U N J S H;P
A B O P J I | P A J I B;O
I K C N J E | N K C I J;E
C J N X Y Q | Q J C N X;Y
M R S L I A | R S L I A;M
E H S N D L | N D E H L;S
B G I N J A | J B N G I;A
S Q N U R D | U Q S R D;N
W D E S I R | E R W I D;S
M H Q E K Z | Z Q M E K;H
S W N K J H | K S W N H;J
F H T W E U | U F T W E;H
D L H P Y S | S P L Y D;H
C K Z F Y P | P F Y C K;Z
C Y I H K J | K I C J Y;H
B L S G V U | G V B L U;S
J P R Z V Q | V Q Z R J;P
U E V Z L J | V U L Z E;J
G M W A C L | C A M L W;G
Z R J E H D | H D Z J E;R
O P K Y I Q | I Q P Y O;K
S V R G Q D | V G Q R S;D
A N G W T C | A T N C G;W
I T Q K S C | K C I Q T;S
C I J V O T | C I V J O;T
H J L S Z C | S C L J H;Z
J Z I B O U | J B I U Z;O
S P J O T K | O T P J K;S
W V U Y L O | Y O U L V;W
D B Y O M J | J M Y D B;O
W L Q Y K T | L T Q Y W;K
H R W I N X | W N R H X;I
T O H R C J | J R H C T;O
L R Q S Y P | R Q Y P S;L
Z X M J R W | X M Z W J;R
R M B N P J | N J M R B;P
J R C Y A M | R M Y A J;C
Z U F P D J | U Z J F D;P
D G Q W C V | W V G C D;Q
A T Y M H C | T C Y M H;A
S B Y C F L | Y S C F L;B
F Q Z V G L | Z L F Q V;G
A R C W K G | R C G W K;A
V L N Z F Q | F L V Z Q;N
I F N Z U K | F U N I K;Z
C S D G N T | G N S D T;C
G S X A V E | S E V A X;G
D A K I G X | K G X A I;D
S Z G T R O | O T R Z G;S
Q Y F D P G | D F G Q P;Y
Y K X B C E | E X B C Y;K
R S H U N P | R U S N H;P
V W Y K R I | W V I R K;Y
Z M O C G L | G Z M L C;O
V O U S C Y | S O Y C V;U
X W V C G N | X W V C N;G
X Q O S H C | O X C Q S;H
Y T L O M K | K L M T Y;O
P M G V B S | G M P S B;V
R V Q C U I | Q U V R C;I
X G V M Z H | H Z V M G;X
F E M J K U | F U J E K;M
G F S B Y C | S C Y B G;F
T C D V H A | T V A H C;D
B H W L F X | L X F B W;H
K R O I E W | W O K I R;E
C W A E L O | O C W A E;L
P H T I O M | H T M P O;I
Y U X G K E | U K G E X;Y
E G X P N H | G N H X E;P
U Z R V T H | Z R V T U;H
Y W X R N Z | R X Y W N;Z
Z Y X B A E | B Y X A Z;E
E S T A D W | T S W D E;A
K N P G M O | O G K M N;P
O T V S J X | T S J O V;X
O W P N E G | O N W P G;E
Z L S J Q F | Q F L J S;Z
O G V H C S | O G H V S;C
Y T A G O W | O G A T Y;W
R S I J X B | B J X I S;R
K S G I R V | S V R K G;I
R U X D M Q | U D M X Q;R
K I M B C O | K I C B M;O
E U Q Z J M | Q M U J Z;E
L J R A W G | J R W G A;L
K Q B M F S | Q S M B K;F
J G Y E W H | J E G W Y;H
V R L Q M E | R L V M Q;E
Z W R H S D | H Z S R W;D
Q Z W S T N | S T Z Q W;N
J Z X F V T | T V Z F J;X
M Y O B D A | B M Y O A;D
C A V P H L | A P C V L;H
S I O V L B | O I V S B;L
P K Q A W B | K Q W A B;P
Q U N W M I | M Q U I W;N
G O M U V D | D V M O U;G
Y A Q Z O M | Q O Z M Y;A
P Q I D T L | I L Q T D;P
G U Z N E D | U N D E Z;G
E B R U V L | B R L E V;U
P Y U Z R F | R Y F P U;Z
N D S O I X | I D S N O;X
M X K G F O | M X K G O;F
Q O B J E N | B E J O Q;N
H G J S D B | B G D S H;J
E F Y U D O | O Y U D F;E
F W N H M J | N F J H M;W
P K T G O J | K G O T P;J
S H Y E L Q | S Y L H E;Q
R V W U H N | N H U R V;W
U I V K W O | V U O I K;W
J U O G Z F | J G Z U O;F
L W C Q G I | L G Q W C;I
C B G P S J | G P J S B;C
R N S X W D | R S N W X;D
L W H C N V | C N L W H;V
C I S W R U | I C U W S;R
U C E T S A | T E U S A;C
C M N K A R | N M K C R;A
X L Z B G W | Z B G L X;W
F X N V Z D | Z F X D V;N
Z O E Q F C | O F Z E Q;C
H L T D V B | B T H D V;L
Z E V M I R | M R V Z E;I
Q O C N V Y | V O Y C N;Q
D H L U S K | U D K S L;H
O M U A B C | A C B U O;M
E Q K A J X | X K E J Q;A
H P C E G L | E P L H G;C
D L M G K Q | L Q M K D;G
V X Z M W L | W V M X L;Z
E U W I C M | W I M E U;C
Y P N X A O | O P Y A X;N
N U E R B T | N T B R U;E
Z Q V R H Y | R Z Y H V;Q
V W U S P X | X U W S V;P
I E S F A N | E I N A S;F
E Q Y N D H | D Q E N Y;H
V W B L G O | O B L W V;G
E O F V Y Q | F O Y V E;Q
U G L F S W | U S W F G;L
Y H L V N M | Y N M V L;H
Z X E O L N | O X N L E;Z
M S F G Z K | F M Z S K;G
Y H N X D R | Y H X D N;R
R S H X F W | F X R S W;H
K F Y L M C | L Y M F C;K
R D G E N X | E G X N R;D
U R Z C B Y | B U R C Y;Z
V X W N L U | L X W V U;N
M L V S Y U | V M S U L;Y
B L T F X H | B F H L X;T
D I P Q G R | R D Q I P;G
Y M K I R Z | Z Y M I K;R
V P W I U B | W V B P I;U
K R W G V M | G V M K W;R
X L Y Z P N | N X P Y L;Z
T F P E H O | E T O H F;P
R Y Z H I L | L Y R Z I;H
H L Y W V Z | H V Y L Z;W
V F N M Z R | M Z F V R;N
