T S Z H G U P O | T P U O Z S G;H
K A X V W L S N | S L K A X V N;W
C S H G P A M E | E S A P M G C;H
I N O W T B G F | G N B I T W F;O
X J A H K O P U | J P K U O X A;H
O A H X Y L B G | G O H Y A X B;L
C P V L T D S R | R T S P C D L;V
S J G N X Z E A | A S E N G Z J;X
Q P I F X S W E | W F Q I P X E;S
Z O F R B X H V | X V B O Z R F;H
I A C P U W Q X | Q X U I W P C;A
Q E O D M B W Y | E D Q W B Y M;O
P F Y V A N E K | Y V N K F A P;E
B Y G X I W D R | D R G Y B W I;X
N R J A E M I K | I J N K A M R;E
D Q O A N K W I | K I Q A D N O;W
M D H I W F L Z | H D F M I L Z;W
Y W J H G L E C | E J H L C W G;Y
C Z E J H W M P | P W J E Z C M;H
A L O J X I Z V | L X A I J O V;Z
A L R Q F S X E | R S A X E Q F;L
L T Z B P I N K | T N L P B I K;Z
Z H Q Y F C U X | Y F Q H C Z X;U
J C D R M G F K | D J R K G M C;F
V Z U I T J X S | X I T S Z V J;U
H E L C B K M I | B M L K C I E;H
M J Y P N F L T | F L N M T J P;Y
Z V H A J N E Q | N Q H V A Z E;J
H J U Z W P D Y | J Z U W H P Y;D
B V Z G W I R N | I Z B W G V N;R
F P M R Q K Y A | Y P A F R M K;Q
D E S R Q P Z N | R P Q Z D S N;E
T D Z W V B G O | Z B V T D G W;O
N G H X Y C A K | X G Y N C H K;A
J N L D G O K W | G L J N K W O;D
R G C K P F J V | V G R K C F J;P
S P I G U X L R | R I U P L G X;S
M H X N G T A Y | H N T A Y X G;M
E K R L C X U H | E C X H U R K;L
U D B W E R J A | B J D A U E W;R
S P D W K C M Q | P D Q K M W C;S
F V I R B Q N G | I B V N Q G R;F
A W X H Y O T P | W A O H P X T;Y
T Q L H O U I W | H O W Q I L T;U
Y U P Z G E K V | G Y K P E V U;Z
R U D I Y J O A | U Y R O A I D;J
I R X V B Y T N | T R I B Y X N;V
H O S K J E L V | S K E J O L V;H
H U X L Q O A P | H P U O X L A;Q
V C R A Z P S F | R F V P C A Z;S
M Q A V P S J F | M Q F J V S A;P
M N Y S V G T L | V S M L G T Y;N
C X K G Y H S P | C G X P K S Y;H
V K W R I L A E | V W A R L K E;I
M L P T Z V G S | M T P V S L G;Z
D Z I K H L O C | D H C Z L K I;O
A Y L E H Q R J | Q E Y L R A J;H
L Q B Z O S H D | O Q H S L Z D;B
D R A T G Q Z S | G R Z D A S T;Q
F D S Y M C O L | M O F Y L S D;C
Q K A F D U E R | R D U Q F E K;A
S T P Y F W B R | W R P S B T F;Y
O Q B I P U M S | M S O B P Q I;U
N R O H J B F W | R W H N F J B;O
S V I Z G O X K | G S Z K X O I;V
L N I Q S Y B H | N L B I S H Q;Y
K C R J U H N Q | C J Q U K H N;R
H Z R A C G K I | Z R C I K A H;G
K L M O T E R U | L U T R M O K;E
R Z J H B V N C | N V J B Z R C;H
E L Y F S K H W | K L F Y E S W;H
R V T Z B O J D | V B T O J R D;Z
U G E N B P K H | H K E U B P G;N
E N V W Z P T S | S T N V W Z P;E
J B G O A N I P | A N O B G I J;P
G K R X B P H D | K D G B P R H;X
X G U M V L B N | M G N L B V X;U
Y H C G X Z U K | Y X K G U H Z;C
Y P Q U J B X H | X B Y J H Q U;P
T D I O W X M V | T I D O X W V;M
O A H K Y W P F | Y A H F P W O;K
P Y O T H V C R | O Y P H C R V;T
I A L C Z M E Q | L E I M Z Q C;A
A D H W Y G I Q | Y D I H Q G A;W
W O M A F V C B | O A M C F W B;V
R A T Y L Z B O | O B T R Y Z L;A
Y A X Z R H U N | R U Z H A X Y;N
C G U E B H L P | C U H G B P E;L
T Z L A H J F U | F J H Z U L A;T
F S L C D M W A | W L A M C S D;F
L U D T B X C E | X B T U E L C;D
J T H S Q C Y O | H J S T Q C Y;O
S F V B M G H L | F G S B H L V;M
X R J Y C D A U | A U J Y C X R;D
Z Q M J H R K X | X Z K M J H Q;R
R E V I W O J Y | I W R V J O Y;E
H G E J A Z W F | W E Z H A G F;J
X Q R H V N E Z | E H N Z R Q V;X
N D L G Q C X M | L D Q X M N C;G
O F U H T L G A | F O L H G T U;A
L Q G C F K B U | B F U G L C K;Q
B P I E X F V U | E F I U B V X;P
Z W O J Y A N X | N A Y Z J X O;W
E T B S I C V X | I T B V C X S;E
D Z Y A H E Q M | Y E D A Z M Q;H
W Z C A P G U Q | Z Q A G P U C;W
B D F A R C T K | R B C T F D A;K
T O I U K Z A Q | Z I A O U T Q;K
Z L J K R V Q U | Z J R U Q K V;L
N M H G S U I Z | G Z U N M S I;H
E W N B J I C M | I J C N W M E;B
K Z M H U T C Q | H Q C U K M T;Z
F Q M A L H G Z | H G Q M L Z A;F
B E U W Z K G C | W U K G B E C;Z
D H V R E N W L | R D N H L E W;V
F G C W Y O I U | F U W G C Y I;O
C R G Z Y A L X | Y A L X G C Z;R
L U M D R G P Z | Z U D P M L R;G
K R T Q Z U W J | U T Z Q J W K;R
R W S H C D N J | S H R C J D W;N
D V A S I G L Y | G D A S L Y V;I
Z X A B U Q J O | B O J U X A Z;Q
X I P R E G W K | I E K X P G R;W
K D C N Y R J U | R D U K J Y C;N
D W S Z K N B Q | S K B N W Q D;Z
Z P Q O N G K B | G O Q Z B P K;N
T I K H N Q V G | G K Q V N I H;T
G Y N B S L I H | S I N Y G L H;B
Z P N Y R A K O | Y O Z R P K N;A
M R O Q W A I S | R I M Q W A O;S
F W K A B T V N | W F T V N B A;K
Y G U I P C B V | G C I B U P V;Y
J O P X Z L U Y | U P Y L J O X;Z
X S U N L M Q T | X L T Q S N M;U
U R Y M C Q N E | Q U C Y E N M;R
Y S Q M V O J N | V M J Q N Y S;O
J K I V O W N U | U W J N K I V;O
P Z O U K E J I | U O I K E J P;Z
P V J T X Z A K | P Z V A X K J;T
J G I O Z C W S | J G Z C W I O;S
S T V O D K A F | S D T K V O F;A
J S U V M N H I | J U V M I N H;S
S A F V W M L N | M N L S V F A;W
M F W I T G O N | F W I N M T O;G
D M T I H Q L B | B H Q D L M T;I
F I E A D H R U | A H E F U D I;R
K E V R X Z U P | P E U R Z V X;K
J G C P Y Z R O | P C O Y G R Z;J
H R Q Y N J O F | H Y J N F R O;Q
K E Q T G B L N | E N G T B K L;Q
N E B L S J G I | N L G J B S E;I
R A V S Q L T P | P S Q L R T A;V
J N X U Z Q O P | O Z J N U P X;Q
Q N F P W I Y B | I Y P W Q F B;N
M O E B X C I W | B I W O E C M;X
V G L I W X F A | F X A G L I V;W
Q S O N E M C Z | M S Z Q O N C;E
E G J K M U A P | G K P M U E J;A
O W V T P B F G | W T F O V B P;G
T W H J A I S D | H T J I A D S;W
A N B V Y P J T | T A J Y V P B;N
O L U K W P A B | O L K W U B A;P
P S O Y A N D L | P S Y A O N D;L
U I A K W P J N | K P I J U W N;A
V T M P K D G L | D V L G P M K;T
T E U B X V C I | B E C X T V I;U
F B L I G N A V | G B I L A F N;V
H I B S F Z V T | V Z H B F T I;S
L V Q X Y F M A | L A X V F Y Q;M
E R G F L Z X T | X T L G R E F;Z
I W X L F Q U M | Q X U I W L F;M
O L D V Z F B A | A L O B V F Z;D
S E Z R G D Y I | I E G S D Z R;Y
L M P B E R F W | M R W E L F B;P
H G N L J R O U | U L O N J H G;R
A I V L P R F B | B R L I V F A;P
M D O Y A T J S | Y O S D A T J;M
S R G C X I Z O | R S G O C X Z;I
Q X N Y B O U F | B F Y X O N Q;U
L M S F I Q U W | Q L W U M S I;F
C S A O B K U X | A B S X C U K;O
E M O Z V W C R | W E R M V C O;Z
E X O F H L K U | O E F H K L X;U
L Y P X Q N R U | Y P U R X L N;Q
B Q I S J T D A | Q B I T A J D;S
G M J V X L B W | B J W L X V M;G
X E I R Q S Y M | E S R M Y Q X;I
C T N B S E Q Z | E B Q N Z T S;C
U Z J S Q N W Y | U W Q Y N Z J;S
Y I N C X S R L | L C Y N X I R;S
Q G B M E X Y C | B X M Q G E C;Y
N R Q T C G B H | Q B R G N H C;T
X M O E Q W T S | X O M S W Q T;E
B Q E X O F W P | O Q B P E X W;F
G N C J W F M L | W N L J F C M;G
E J G B R N X M | N J M R B E G;X
W M N H A J L R | H L M W J N R;A
Z E Y R B D P X | R P E D Y X B;Z
M O V Y G A N H | H G O A Y V N;M
F V L W I S B K | V B W I F L S;K
V B R A Y G H C | R A B H G V C;Y
C R S T O J B K | K C J T B R O;S
C D N R T U G X | D X T N U G R;C
I S D P T R B A | P I A D R B S;T
I A J L U X V P | U V P J L A I;X
K D M R Q C X T | K D C X Q R T;M
B T O F N R K W | K F N T B R O;W
Q T O G Y N I X | I Y O G T X N;Q
I U L A J B F S | J B A F L S U;I
M T G X C Q W D | T G X W Q M C;D
C N J O U Q Y L | Q L O U Y N C;J
M X A J F Y I N | J Y F I M A X;N
J V Q P H D Z R | R V P Z Q H D;J
T S Z N X M U D | M T N U D X S;Z
H Q G U T L D Z | U Q D L H Z T;G
L R V A T G S C | L V A G R C T;S
H O J F D R I X | F H X R J O D;I
W R S B A H J Z | B J Z R A S W;H
V T E J I P K M | V T I K J E M;P
K M U S J X N I | K M X J S N U;I
H X I C G F J N | G C J F I H X;N
W Z O D Y X M R | W M R Y X Z O;D
J U C E B P G L | J G E B C P L;U
O G X C Z U J P | X C G Z O U J;P
V U F A O D B C | D O A U V B C;F
M Q C D P F Z U | D M U Z F P Q;C
W H A Q Z D O F | O W Q D H A Z;F
F I G X L W T Y | W L T X G I F;Y
O B S R C N M U | M U B C R S N;O
W K E B Z G I C | G I B C Z E W;K
Q P B K A F D O | O P K A D F B;Q
S T O G N Z W V | G O W S V Z N;T
Q S H J X U P A | J A H Q U P S;X
Z I R G D C T U | U I T Z D R C;G
F L B Y A T R V | T B V R Y A L;F
D T L O K I G X | T D I L G O K;X
M F V J A W S I | F I V J W S A;M
L U X G K Y T Q | T K L Q Y X G;U
D V W I B R O S | R D O W S V B;I
P C E X H V N A | N P A V X E C;H
A I Z N Q W M P | M P W I Q N Z;A
D F M E T H K P | F T K D E P H;M
N U Y Z X I B C | B X Y U I N C;Z
O W M F S C R A | A O R S C M F;W
T R F L G J Y I | Y L I J T R F;G
Z J S M E V D C | D C M S J Z V;E
F Y C B A Z V H | H C F V Z B A;Y
M N I K G L W S | N G I M S L W;K
T F I G M B Z R | B M Z G T R I;F
D I A V F X O Y | I V X F A D O;Y
N C S V D Z E J | V N Z E S C D;J
S N T V Q U L C | L Q V C U N S;T
X S G N K I J Q | J N Q K I G S;X
P E F W I K T N | N K T F I P W;E
W P E D N F L X | N X D P E F L;W
W U J L S O E N | J W S L O E U;N
E A L F X J T K | K T J F L A X;E
I A C L B T U Y | C B T L U I A;Y
L M E K U Z B I | M I K L Z E U;B
P G C M S Z I J | G I C Z S J M;P
N Y H P A I R S | A S H Y P I N;R
H C Z S K N W F | H S W N K F Z;C
C K N H A W E S | W A N E C K S;H
X U V Z M C J H | J M C Z X U H;V
P F C B A T E O | P T B O E F C;A
L A S T H D R O | A T L H R S D;O
M O R F N J B G | N G R F O J M;B
Y I P A N J E F | J Y P A N E I;F
X H K O G T C Y | T C X H Y G K;O
B F C K R O Z V | K F Z O C R B;V
N K U P M H Y B | H N U Y M K B;P
T J B D U L M Q | D Q L J U T B;M
N Y U J M Q B H | U N B H Y M J;Q
I R G X D N E M | M G X R I E D;N
H W U N I T Q D | D I N H T Q U;W
Y B D R N O E I | R B O N D I Y;E
F Z R L H N D V | F V L Z N R D;H
M N H Y F C J U | J N U Y M C F;H
S F T Z P J N Q | P F N T Q Z S;J
N W B F H Y E G | Y W E G F N B;H
Y K D B T F P I | Y B D T F I K;P
U W H N S P B M | H B M S W U N;P
P L H A K R C Q | C R H A Q L K;P
O S M X K W R H | W R S M K O H;X
T Y P A W R Q L | P R Y L A W Q;T
K N G P E M T W | G T W M P N E;K
X E J O K R Y Q | J K E O R Q Y;X
X Y O Q F U M V | X Y Q U F M O;V
P Z U O W V B M | Z V O P B W U;M
B W I U H A K R | U H R B I K A;W
Z L X K C U S H | Z S U L H K X;C
C A Z S Y O N B | C S A B O Z Y;N
F M R O Z W X U | Z O M F W U R;X
V Y B Q G S L C | B V Q Y G S C;L
H E O A K X J T | O J H A E K T;X
F P X W U G E J | J X P F U E G;W
H D Y C Z M R S | H Y M C R D Z;S
Z R H G D Q L E | G D E Z Q H L;R
U I Y X B P N Q | B Q X Y P I U;N
C P M R Q V Z K | M K C Z V R Q;P
V I W R Z N M J | V W N R I Z M;J
Y M U S B F Z X | Y X M F U S B;Z
B Z C U P L S A | P B A U S Z L;C
W J U M O Y P V | M V Y P O U W;J
K L D H F Q U I | U H I Q F L K;D
L O M V Y I A S | A M S Y O I V;L
X Y J U B E S D | S X E U Y B D;J
Y W V G L I F X | Y G X L V F I;W
A H N J I R B E | N B H E J A I;R
Q Z I H Y V M E | Q V Z Y E M I;H
V M U H W T S Y | S W M U T H V;Y
D Q Y B U C S G | Y U S C G D Q;B
O Z K Y W M N L | K O Y Z M L N;W
E B T N W P O I | W O P B N T I;E
Y D K C A B H N | A N K D Y H B;C
K U L M J F S Z | L K U J M F Z;S
C H K D W U Z P | U W D Z C P H;K
M X H D U V L K | H X V M L U K;D
J P B A I G K O | B A I J O P G;K
B Y N H O P S T | B H T O N S Y;P
H W F Q R T O G | O W H T R G F;Q
A E N K L P G J | N P E J L A G;K
P Q E U X K Z V | X U Z V E P K;Q
S Z K C D Q R E | Q S D K C R E;Z
W N L I X Y F J | X N Y J F I L;W
A K Y V Z T X C | C X K Z T A Y;V
E T G Q Z U J O | G O Q J U T Z;E
L T O Q X M C W | L O T Q C X W;M
Q T S K B Y V D | D K B V Y Q T;S
T H B R C D P Z | Z B P H T D C;R
T H J O P S R K | R T J O K S P;H
H F R I Q C G T | H R C G Q F I;T
C T S E Q V U X | S T X Q C V E;U
C B O K P R U V | V K C P R O U;B
W B H P I S Y K | I W P K B H S;Y
C Y N D B S Q T | D T B S Q C Y;N
Y N W P M S E L | P Y W N M L S;E
N C Q Y P A M G | G N A M P Q C;Y
N H Z S L T W Y | H N Y W T L S;Z
V H E Q Z X C T | V X H Z E C T;Q
G N K C B Y A S | K G Y C S A N;B
K F H Y L V E R | E F H L R Y V;K
L H A F N C V Y | L N F H V Y A;C
U O T A N V B Z | A O T Z B U V;N
X C H P N T D A | N A C P T H X;D
S V G W F N T C | T G V C W N S;F
Y K P M X Q J H | K H J Y X Q M;P
A M J H R Q S E | M S E J H R Q;A
M R T U I X B K | M X U B I T R;K
G X L T I K Z Y | K L Z Y X T G;I
Y K I F U G J T | T Y I K F U J;G
N C Z F O J V H | C O Z N J V F;H
T F W O H J E A | T W O J F A H;E
B M U E G V T I | I M B E V U T;G
J I Y L D Q T U | J Y Q U T I L;D
F H Z W I E T P | H F W I Z T P;E
U B X D A Q K V | K A B Q U D X;V
B A P H E K G U | G P B A K H E;U
W C D Y F L M P | F W Y C D P L;M
Y Q D F Z L M A | Y L Q M F D A;Z
B G I A T D F Y | F G T Y D I B;A
X I R L N Z K Y | X I L K Z R Y;N
O G N Z K Y Q R | O R K Z N Q G;Y
L I B F C Q S J | Q F B L I S J;C
T F K D B G L M | L T B G F M K;D
Q O X M A Z N R | X Q M O R Z A;N
H K B S T L Y M | H K L M T Y S;B
W X H F M C T I | X I W M C T F;H
X S V D C P J Q | X S P D Q V J;C
E A D O H B Z Q | Q D Z A O H B;E
Z A G E V C F J | G Z C E F J A;V
P Q I Y G D N R | P G D Y N R Q;I
T N A X W D H K | K D T H A X N;W
U D R O L B J N | J U B O N L D;R
B M F Z J E Q V | M Z B J Q V E;F
M Y X K U F J H | U F X K H J M;Y
X M S G Y V K Z | K G Y Z V S M;X
D U L B V M R E | B L M D U V R;E
N T Q H D A I B | I A N Q B T H;D
L D O Z H G C V | D L V G O H C;Z
I Q L C N K M V | K Q M I L C V;N
D A F V U E M B | E F B A D M V;U
Q Z O M U I T C | M T C O Z U Q;I
F U T D W G H L | W F G U T H D;L
J Q H F Y E R G | E Y Q G J H F;R
I J F B H G C E | C G F I J H B;E
Y J R U L F W P | F W U Y R P J;L
N U H M P Y F X | U F Y N H M X;P
S E R A Z J N I | N J R E I A S;Z
K E J S X T B H | X S J E T B K;H
E N O U F P C A | N A C E U P O;F
K E F C Q X P U | C P K X Q F U;E
U A T X Q C W Y | U W T C A Y Q;X
I T P F W O E H | O T W F P E H;I
T H I U D L X O | I H O T X U D;L
E Z L K T G M N | M K L T Z G E;N
H E R X A G B Z | H X G E Z R A;B
Y F Z P J G S I | I P S Y J G F;Z
I G Y W R Z Q V | G Q Y V I R W;Z
T L J Y Q C I V | Q L C V I T Y;J
V H F B R A L O | B L A R V O H;F
I Q S D Y F L V | Y L F I Q V S;D
A B T W P D K O | D P W O K B A;T
C F W I L P B D | P L C D F I B;W
M Y L A H N K F | F M Y A L K N;H
F E L J Z A P W | W Z J F L P E;A
A D Z L H N J Q | A D Q J Z L N;H
W K V S R P C L | P K W L C V S;R
S G A J B Y T M | Y J M T S G A;B
Z R D S X Y I K | R K S X Y Z D;I
K U P C V O G J | J K V O G P C;U
F Q K V Z L J D | K Q Z J V F L;D
J R Y K U H B L | J K B Y U H L;R
W R T F B C K E | R F K B W E T;C
U G R W Q S C B | S B G U C W R;Q
N P D J L Z E K | D K P J Z L E;N
G T N S E L A Y | S A L T N G Y;E
N O G P R D U Y | U Y G D R P N;O
J Z B F S E V N | J E V F N B S;Z
M J U F G X R T | J M X T F G R;U
H R V S L Q C J | J C H L Q V S;R
K E H T Y B C N | H N C E K T B;Y
W R E C A Q S D | R W C E A D S;Q
E R X B F U H O | H R E X U F O;B
X F C T G K P O | O T X C F K P;G
Q M C L B Y F H | Y B Q M H C F;L
Q M U B Y S K J | J M Y U Q K B;S
S L R Q O T J D | R Q J L D S T;O
X J Y C K P L R | P J K R L C Y;X
D G F R K E O H | H K R E F G D;O
O Q T R K F D M | K M D R T Q O;F
W C Y K T N E S | C S K W N T Y;E
C Z D X M G W U | X Z W G U C M;D
W R F G C X Y I | X Y R W G I F;C
C V N D P K Y B | B C D K P V Y;N
W B I Z R K D M | D K Z B R I W;M
B D K U F W I X | I D F B W U X;K
F H O L X M C Q | X F O M H L C;Q
E K F L Y D Q A | L Y D A E F K;Q
Y A Z Q M B V E | B E Y A V M Q;Z
E N G R B L W J | J N L G B R E;W
I C V S M G H Z | Z C M H V I S;G
Z R T U K S I D | S Z R K U D T;I
Q O T V R A P I | O P I A V R Q;T
C V Q X G N K Z | N C K Q Z V G;X
T B J A Y F M N | F J M Y B N A;T
J D T C S U G B | C J U T G S B;D
U A D S C N Q L | Q D A C N U L;S
E T D V M J Z R | M V R Z J T E;D
L K X W V N Y M | W K L M V X N;Y
G V Y P Q T N W | Y N P W G Q V;T
D N X H U P T C | D T P U X N C;H
M T S C Z A G V | S G T A Z M V;C
A W U D H N T O | N U O D H A T;W
U O B F A D I M | D O M B U F A;I
K E M P S G R W | E M R P S W K;G
V Y O J E W U K | O Y K E U J W;V
X Y I G B M Z U | Z X I U M B G;Y
E D F N G M U K | D E K F M G N;U
G F Q P K B X I | K B P X G F Q;I
J X M I Q A F P | J M F X I P Q;A
X O U Q F C P I | C U I P Q F O;X
D R F I Y V S Q | R F Q Y V S D;I
L I B W N O U X | I U L N X W B;O
D C V E Z B N U | U N B Z D C V;E
J Z B Y P F Q O | B O Q J Y F Z;P
P X G I J R V K | V G P X I R J;K
K V Z T R O N P | T O Z K R V N;P
W V H D Q I X T | V I W D X Q T;H
R Q Y B E H I N | R Q E H Y I B;N
R X U E Z O D G | U E X Z D O G;R
R M J H Q X E A | Q H M J X E A;R
G J V T H A D Z | A T V G D J H;Z
Z X L K O P N B | L N P K Z X O;B
W Z H F G R T K | F R G W Z K H;T
X P U R E T Q H | P R U Q H X T;E
A U V K N S D T | A T U N V D K;S
X L O S F P K W | X W F K S L O;P
L J I S X O F P | L J O X I F P;S
T K Y N C W S P | K C Y W P S N;T
Y L U I A G D F | Y D A L G I F;U
P Q H N B U I C | I C U Q B H P;N
K E R M O G A H | O G M A K H E;R
Q Z S P D X M R | D Z M X P Q S;R
L R P B U X G N | N G B P X U R;L
N I X A Y E J U | I J U A Y N X;E
G W X Y N U P D | D W Y P G U X;N
C K A N F O W P | A F W O K N C;P
F Z S E P X W I | W F Z I X E P;S
O L U A I H X G | G H U X O I A;L
J Z C K H F Y T | T Z K J Y F H;C
A R X C H T V Y | A X Y H C T R;V
U X K F Q A N O | N K U Q F X O;A
Y A U B P K V W | A Y B V P U K;W
Q C P B N G W X | G X P W B Q C;N
R F C Y A X M U | F M R C A U Y;X
T S Z H C Y A I | Z S I Y A C H;T
E P H N B Y L T | Y T E P L B N;H
L A S D O T K Y | O T S L A Y D;K
J F D U L S M E | D M F E L U J;S
N U M A W T Z R | M W U R T N Z;A
B X H W I Z V G | B X I H V G Z;W
P G Z D O K N T | N O T D K Z P;G
V H L D E S B T | E V S T H B D;L
R A C K Q M S H | R C M S A K Q;H
L Z D V U W N R | U Z V W D N L;R
F C D O K L Q U | O F L C K D Q;U
B T F R V G P E | B F E V P G T;R
F W K J X G T C | X W J F T G C;K
A O U F V H X M | M F X O U A V;H
S Q D J I X B C | C S Q I B X J;D
E X Y R S C G Q | S X Y C Q G R;E
C W X R O E T F | W O C X E T F;R
R P B O F C N V | F N B C O P V;R
B A W S T U N J | W N B T U S J;A
M T N S F W Y Q | W F Q N S M T;Y
B R F Q E M V Y | R Q E Y M B F;V
A J X Q H P L U | A J L X P H U;Q
V Y T J N D X L | N L X Y T D J;V
F G E D R X Q L | G D Q L E F R;X
T I R E A Q J V | E J T Q V R A;I
T I F U B Y V G | G B F Y U I V;T
G K P J V N I O | J P K O I G V;N
V L S J I Y Q B | B I Y V Q S L;J
L E I W A D Y B | Y A D B E W I;L
P Z R F B S Q L | R Q F P L Z B;S
O A Z I N Y T R | A T N O Y R Z;I
H F U K W G Q M | F H Q K M U W;G
W S P Q X H M B | M B W P H S X;Q
I W U K T J X V | I X J T V W K;U
X T Y W P J B F | T J X P Y B W;F
D T L Z G A K X | A T G Z X L D;K
U K W M A E D L | M U A W K L E;D
M T V R I O W S | T W R S O V I;M
O N F W G R D Z | Z G O F D N R;W
Z G T B Y Q F W | Z G Q T Y F B;W
P D Y R G H L O | H Y G D R L O;P
A R O Y Q E B V | Y V O Q E A B;R
F T L O X Z D K | O K X Z F T D;L
O C Q G E R K S | R G Q S C E K;O
D Z B I J O W A | W B A I Z J D;O
C O Z P T Q L V | O C P V L Z T;Q
P F X O R Z G J | F G O J P R X;Z
K M B C U X F I | F M K X I U B;C
P G U C T D B W | G U C T B D W;P
Q D O N K E Y H | K Y Q H E O D;N
Y B F V Z D U W | B V F Z D U W;Y
B D Z I P T E R | R Z E B P D T;I
I L P N H Z C T | H P I T C Z N;L
U P L G Y D N Q | G P D N U L Q;Y
K Z R H F A V S | A V R K F H S;Z
D P M Z H O A K | A D Z M P K H;O
D Y C I X T W Q | D T I C W Q X;Y
B C H Y J E Z Q | Q E Y C H Z J;B
V T S W H X P D | D X W H T V S;P
S B R E M C G I | M E B G C R I;S
R I W J Z O Y M | R W Y J Z M I;O
E Z O B M J F I | I Z E J B O F;M
D C H L Y K Q J | C D J Q H Y K;L
Q R S Y A E K W | Y R S W Q A K;E
Z U K F C G W B | K B F U W Z C;G
W Y U P Z E T G | P Y Z W G E T;U
Z B X A Q T U J | X Z U T A J Q;B
B H V Q S X T Z | X T S B V Q Z;H
X H N E D M T F | E D X H T N M;F
C N S T Z W D V | Z S C D N W T;V
Q G O H E X V L | H X L V E O Q;G
G M W C D T A R | M D T A R W C;G
R E J U A Z Y L | U E J A Z R Y;L
H P Y W X C R N | H X N C R Y P;W
G M E N Z Q A I | I Z M E Q A N;G
N V L J G Y M A | A N Y L J G M;V
L H Z K O C W Y | L Z W K H Y C;O
I H P Y L D Q T | H P I T Q L Y;D
V A D B O N U I | A D U I B V O;N
W M U I K G Y L | K M G L I U W;Y
G Z S W L R J T | Z L G R T W J;S
U X K O T C M Y | M Y O C T K X;U
J L U S E R H Y | J U L Y H S R;E
Q F O P Y N U W | Y W N P F U O;Q
U W G I P Q V S | P I S U Q V G;W
F Z Q G B E C J | Q F J B Z C E;G
A C M F D X I B | D I B X F M C;A
T U Y W A I C P | W Y U C P I T;A
I P H F B V K D | K F I P V B D;H
P V W H S U G C | V U W C H S G;P
C L T B D Z W Q | Q D W T C B L;Z
A K Y I V T P N | P V T K Y A I;N
T R Q M S F I O | Q M R T O S I;F
N V W A F R Q C | N F Q W C A V;R
Y P S N H B F V | Y N S B V P F;H
B A R H X E O C | C R H A O X B;E
G F J C X Y R V | R V F X C Y G;J
A X F N R U Q H | Q N A X R H F;U
V O A I W T Z E | T W Z I E V A;O
H F Y N L A W D | D H L N A Y W;F
G T J P K O E S | O J S K T E P;G
S D U H P O M T | D O M T U P H;S
U Y G K N M P C | N C G M K U Y;P
D N Z S G M F H | H S D M F Z N;G
E U C N F Z P Y | Z F C Y U E P;N
A Y K I O D W S | W D Y K O I S;A
I Q X T F J N M | N M F X J T I;Q
G T X Z E L W I | Z E G L I T W;X
N P T Y O J D G | N G D O P T J;Y
P Q B K G I F H | F Q I B K H G;P
N P L Y X U E Q | N Y U Q X P E;L
S D R K Q J L U | D S R Q U J L;K
K A F P C V N Z | F A P K C N Z;V
N M A E Y K J Z | A Y K Z J N M;E
G C A Y O D J W | A W Y C O J G;D
E C K I L P J Q | L P I J K E C;Q
W G M S Q F Y Z | Y Q W F Z G M;S
W C D O T P Q J | Q P J C W O T;D
I N S V W M H G | H W I S M G N;V
S K C V R L N D | L C N S D R V;K
B Y L O M Q F N | Q B O L M Y N;F
X U B C F E N S | F S X C B U E;N
Z U B Y J X K V | K V U Y B X J;Z
L Z I V T Y M A | A L Y T V I Z;M
G B E X M J Q O | J X E M O B Q;G
K M F A P Q I C | F I M A C P Q;K
L E P Q C F J A | F L J C Q E A;P
J K U P G A W C | G P K W C U A;J
A Z U O F H P I | U Z F I A P O;H
F B X L U Y V Z | L Z U B F X V;Y
X Q C W N J M U | C X N J U W M;Q
O D L W Q Y X S | D Y Q L S O W;X
H K X N R U G F | K R U N H X G;F
Q G O X B W I U | W Q G O B I U;X
H D F E Z X N O | Z F E D O N X;H
W O C P Q X L I | X W C I L Q O;P
M R G W B X I J | M B W G J I R;X
E P I X Z J K M | X M E P Z I K;J
F C B U X G H L | B X F U L H G;C
X A R U M D I S | R U M D A S X;I
J N O C F Z V X | V Z O J X N F;C
V J I N P X R U | X R U J I V N;P
E X T L V P O S | T X V S L P E;O
Z Q E V N I O W | I O Q W Z E N;V
X R W K M Y F N | K M Y W N X R;F
E O P S H A T M | A T O H M S P;E
Q E D Z A J T G | A G J D E T Z;Q
H D T K L I W J | J W L K I H D;T
D M T O Y U A S | T M S O A D Y;U
U V M H L X P T | H L P U M V T;X
N Y O D U I W E | N I W O Y U D;E
S I F A Y Q H V | V H S F Q Y A;I
T N F Z J S E Q | Z T J S E N Q;F
F L G W Y H M P | Y W M P H L F;G
B Z P G R A S F | P S G A F Z B;R
V F E J Z U L Q | Z U Q V F E J;L
T N Z U Y F D S | U Z D T F S N;Y
R A T J G V M B | G R B V T M J;A
T G O J B H E N | T B G E H J N;O
J E L N D C X W | W D X L C J N;E
F R Q S I U G M | M Q U I G R F;S
W T U V M Q Y E | M Y V T U W Q;E
Y D L J A Z O H | Y H A J D L Z;O
F G W I B D E S | G E I W S D B;F
V D W T J F N C | W V J C T D N;F
S H Q L F A J O | H O A S Q J L;F
D G A B F H V W | V H B A F W G;D
S K N E V U T C | T N K U E C S;V
V E P K R M Q U | P K U Q E R M;V
Q M D L Z E X U | M E D Z X L U;Q
D U M P H L V F | U L M F D H P;V
D M Q E L K B T | Q M T B E L K;D
S O Q K W N X R | K S R X Q N W;O
L B F M Z A I O | L I A O F B M;Z
V X J U E O Z Y | J O V U Z Y E;X
Z T M D X K Q W | D W T Q X K M;Z
G K E P Y D Z J | P G Z K D Y E;J
U P K B E L Y R | B P Y E L K U;R
Q L N S E O B X | X S O E B Q L;N
C J I L W H X D | H X C I J D L;W
W L Q M O S H Y | L Y W H O Q S;M
C V B P R Z F W | P W B Z R C F;V
T I S F U M B Z | B M U Z I T S;F
J R P Q I Z V Y | Z I P Y Q R V;J
A I D B Z U W Q | W Q D Z I A U;B
M J D E B N Z L | E B L D Z J N;M
I F Z A E W K R | W E I R Z K A;F
D G H V E J B Q | V D J G Q B E;H
H R J W X N Y Q | W Q H N X R Y;J
E Y I P D Q B M | B D Q I Y M E;P
Q V F T P H U O | T P H U V Q F;O
E I K A X R F P | X K E F R P A;I
A D K M Y B V L | V A Y K M B D;L
F U K B G X Y R | X B F Y G R U;K
L J F P Y Q V R | P F L Y R Q J;V
P T X L E D Z V | Z V D T X P E;L
B Z W F J S V T | J B T F V W Z;S
L P C Q O V T W | Q P T W C V O;L
T P L R N J G W | L G W R N J T;P
P Q O R T I N A | O Q I A T P R;N
S D P Z O F X Q | S Z O D P X F;Q
V W I H B Y E F | E H B W I Y V;F
Y W I V O T N J | Y N I T W J O;V
C I G U E M Y K | U Y G K E M I;C
I B W H N X A P | A W P H X B N;I
E L C Q O X Z A | E X C O Q Z L;A
W J F M Y Q U L | Y J W Q L U M;F
Z H Y V G B C U | Y B V U H C Z;G
V N G Y J X T S | N X G Y T J S;V
X K Y M C E A D | Y A K D C E X;M
T D R P Q I E V | P I V Q R T D;E
M V Z O W L N B | L O W M Z N B;V
J O Z B D K U C | K U C O D B Z;J
H Q E J X C T D | T E C J H X Q;D
S V I K J B O D | S I D V B K O;J
P G M V Q U D J | G Q U D J P V;M
I T R G B C Q Z | R B G Q C Z I;T
A D E R Q M N B | N R E B M Q A;D
J R Q U Z W F E | W E U Q J F R;Z
E T G P A Q S Y | A E Y T P Q S;G
D H P Y I Z Q A | Y D I P Z A H;Q
F T X Q H A W R | X R W Q H A T;F
R F E W H V Q Z | F H W V Z R Q;E
P E U Q C I R S | R U C I E S Q;P
A K P F W H U R | W P R U H K A;F
N W Q B Z D I C | C I W B D N Z;Q
Y J E M U T I P | J Y T P M I E;U
Z T B I O A C P | P Z T I A C O;B
R H F M E Z K Y | F Y H M K Z R;E
Y Z H P J E O A | H P O E Z A Y;J
I F J O X P H Q | P I J X O Q F;H
B Y H A W O X I | H B A X W Y O;I
A M L X Q Y J N | L Y A X N J M;Q
E W Q C U I A M | E Q M U C I A;W
U Q I M V R N S | I Q S R M N V;U
Y J M G E U I R | E G U I Y R J;M
J Z M E A P L V | P J Z M L V E;A
W H G L C U R F | F G W C U H L;R
L Q X E M I N O | O X L N E Q I;M
Z R P O N C W V | W N R C P V O;Z
Y D S P I J X E | D I S X E J P;Y
O L Z M R J T D | T J L M R Z D;O
F V C G W R U P | R G V C W F P;U
O J F W L P R M | L M J W O F P;R
C S I L Q G V Z | Q G S L I V C;Z
Z T I J O C S G | C T J S G Z I;O
C S P G H T I X | S P X H I C G;T
N W U E V B O T | W E V N B T U;O
N T P L S A I C | I P L S T C N;A
A L B J W K G X | L W A X K J G;B
Z I W N P F A O | F Z W P N A I;O
O G X J Q U E N | G U J Q E O N;X
W L B I Y S M X | B S L Y I M W;X
M H T E Y Z U I | Y Z E M T H U;I
G S B J N K A F | F B N A G J S;K
S V Q Z C P H J | S Z Q C V H P;J
Y C X N V P A W | Y A N X C W P;V
Z W D T U I A K | U A D I W K T;Z
T G V Y S H P Z | S Y T H P G Z;V
V T K D A R Y W | K V W A R T Y;D
D R C W A N Q P | R Q P N C D A;W
J F G P X Q V A | V J F P X Q A;G
U Z W V Q I S D | V Q I Z D W S;U
K C L Y O B X I | X C B K L Y O;I
T F K C E H D V | H D V K C E F;T
W M P X O K E V | X W M K V O P;E
G N U P F X I D | N G F X U D P;I
G S E L Z K T R | S E Z R K L G;T
X N L S Y G I A | X N G I S Y L;A
A D Q Y P R E L | E A L P Q R D;Y
W H R F P U X Z | Z U F P W R X;H
R Y F K I E S N | E I R K F S Y;N
U D F O C L S B | C D L B F U S;O
Z F Y U P V I K | F U K V P Z Y;I
R Y S A K U T V | A V U S Y T R;K
K L U E J D W F | L D F E K W J;U
Y F V G H L C R | R Y V L C F G;H
E B M Y V O Z Q | Q B V Z O E M;Y
E P T Z U A I Q | Q T A Z U P I;E
Q R L F B O T X | R T L F Q B X;O
P J Q A I B D G | B Q D J P A G;I
T S H G O L A B | T H S B A L G;O
K W H Y C V Q X | Y H Q K X V W;C
Y I E K P N V X | P X N Y I E K;V
F A T N M P E G | A F T N P G E;M
U V Y I D B M G | V Y B I G M U;D
O M Q W K T N Z | W N O T Z M Q;K
Y N B R U D T V | U R D Y V B T;N
X J M L C V Q A | Q C M A X V J;L
Z O S D J V Q N | Z S D J Q O V;N
H N L A V Y I E | N E V H A I Y;L
O W F X C J A K | K C W F O J X;A
M P H Z D X F G | G H P D X M F;Z
N P T D I Z Q S | Z T P Q N I S;D
D S Q C L M Y J | C Y S M J Q D;L
L X E G C R D A | A X L C G R D;E
N A L R T S O H | S T O L N H A;R
V A O D C K X H | D K H V C A O;X
S C B P F Y N Z | C S P N Y F B;Z
J D R V W P S Q | Q S J P V R W;D
K O V F Q N M L | F Q K L V O M;N
M T R O N F U I | F O N M U I R;T
I P D T O Y C Q | Q C O Y T I D;P
D M I N B L A W | L B D A W I M;N
Z K B D L U A Q | K D L Z Q A B;U
E K J Y X F I T | X J T I F Y E;K
M P V R U C E Q | U C M R P Q V;E
X M Q O D F N B | B X F M O Q D;N
F W P D N B A M | W F A P B D M;N
X P G L Z S T U | U X T Z P G L;S
B K P J Y Z A T | Z A T B K P Y;J
O R L K P J U I | U R O K P I L;J
O E Z N T W S D | E D S N T W Z;O
Y E O P B I H Q | E Q O I P Y B;H
R U Q K G D P H | Q K D P H R G;U
L X W Y I O V U | W L X Y I O U;V
V A O G K M J F | M F A V K O G;J
A B C X N E D R | D B N C X R E;A
S F G W Z M J V | J Z M F W S V;G
A E N P R C S B | A C S R P N E;B
L M V Z A Y K X | L Z M K X Y V;A
K C R Q S M F D | R K C D S Q F;M
N L T K Y U V A | T V U L A Y N;K
O N W E T J R C | J R W C E O T;N
T B X R L E I M | I E L R M B X;T
C N G L H X Z A | X A G L H C N;Z
Y S I G X F N O | N I O F X Y S;G
U R Y K M V B C | C K Y V R U B;M
N V L A E H F U | N V L E H A F;U
L A M E I D W P | W A I E L P M;D
C S F H V R U D | F C H S V D R;U
W T X E C F B P | T W F P B C X;E
H R U A W I Y V | V R U H I W A;Y
R K Z H C S P L | C R L S P K Z;H
C P E H S J A U | C A J H P U S;E
J M Y U Z B T Q | J M Z T Y Q B;U
Y V M X J B A W | B W M X V A Y;J
X J S T L M K B | X J L K B T S;M
R F N H W Y K C | Y H W F N R K;C
N V Q X D R T C | C T Q X V D N;R
A M I V T Z P D | Z D M V A T P;I
X R T N I A K J | K N A X T J R;I
B S Z I W F M E | M W F Z S B I;E
J B V D K Q A H | J Q D K B V H;A
S W A O X Z P J | Z J O S A W X;P
X D G E S H R K | R G K S X H D;E
N M H Q C D L K | M C H K N Q L;D
N V L H D P B G | L H N B G P D;V
F Q I C S R L O | C Q S L I R F;O
T X R J G C Y Z | Z G C X T Y R;J
S Z G K A B U M | U Z B S A K M;G
V C Z F B W Y N | W B Y N Z V F;C
D Y Q G W S R O | O Y R D Q G S;W
Q L V J D R F B | L B F D V R J;Q
K Z V O A M Q P | Q P A O V M K;Z
Q G S N Z D T R | R Z S Q T G N;D
Y A G O R H W F | R G O H A F W;Y
V A K I L C N J | V J N K L A C;I
Q O T N X D Y K | O N X Q D K T;Y
E F Y W B N T D | E Y F B N T D;W
V U Q R N H T X | V X U H N T R;Q
V H W S R L E B | B W S H V L R;E
G D P Y T U K V | Y D U P T G V;K
A M K H P S L X | K H X M P L S;A
H S F L X N U G | G S X N H U F;L
K W D A H F G N | N G H A W K D;F
P M Z Q C I X L | M Q L P X I Z;C
S J X E H F Y Q | X Y E S Q F H;J
Y P D K C O G N | P Y D K O G C;N
F R L K Z B U Q | K R Z Q F U B;L
I A C V U L Y W | A Y V W L U C;I
Z L A K F X W V | X L A K F V W;Z
N X Y Z V B Q O | V O Q X Z B Y;N
D N L M I W K B | B D L I N M K;W
Y D H G C S Z E | S Y Z D G E C;H
H I U E Y W R F | H E I W U R F;Y
Z N E I H Y A U | Z I E N Y H A;U
T J G H Q I B Y | B H Q I T J G;Y
F E R I M W K L | I E K W R M F;L
K V E L I T J R | K I J E L R T;V
P E A I V T U K | E I A U T V K;P
Y S T G X M W N | S G Y T M N W;X
F E M I C R B Z | E M B F Z I R;C
R D P I B H Y U | B H U D P Y R;I
N G J Z F V O T | T F J Z O V G;N
J N U M P R F A | J M N R A F U;P
P H Z O T M G U | U M G P O T H;Z
S H D J W Q E P | Q J W E H P D;S
L P W X B Y G M | P M G Y W X B;L
N T O K C A G I | T C N A I G K;O
K E R Q D J L A | E A Q R K J L;D
R B Y M W T A P | P A M B Y T W;R
T H A Y S L W B | W Y B A T L S;H
E V N K S G H C | V S C G K N E;H
J X U I C O A B | I A U X C O B;J
O C H B X Y W Z | X Z Y H B C O;W
I T F S X G A W | I A S W F T G;X
J E Y I K B M S | Y K M J E S I;B
J A W H I L K S | J S K I H A W;L
C L B I V K A U | C V L B K U I;A
L G Z O M W C A | G Z A L C W M;O
Y W M N U H T G | G N W Y H M T;U
H P F M S R J I | S F H I P R M;J
K S G J Y L O T | O G S K Y L J;T
P U Y X L T J O | O X L U Y T J;P
G Z L N O F R Y | R O N Z G L F;Y
I T R O N U C F | O T C N R U I;F
Z I W D Y A Q S | S Z A W Y D Q;I
K V E B P Z O Q | P V Z E K Q O;B
N Y F D U G O R | R N Y D U O G;F
V M W C J L T E | V J W M T C L;E
B Z L O V C F K | K C B L O Z V;F
I Q S J T E W H | I H Q J T W E;S
D F C B W U T J | C U J F D B W;T
M W I E Y Q Z C | E Y W C Z M Q;I
K A N C M B G U | U C M A G K B;N
F L D H S E M B | B E M S F H D;L
A O C R U Y I W | W I R Y U O A;C
P T O N F U Z J | U J O N Z T P;F
M L K V P T Z J | J P V K Z L T;M
O P W I D N G B | N B I G P W D;O
W G T P E X B C | E G C T X B W;P
I G U C Z Q D J | D I J U C Z G;Q
M B H V Z I S J | V S H J B M Z;I
B A Z J R F V P | B P F Z J R A;V
M C U A O R V Q | C V A R Q O M;U
L J Z P U S V O | P S O U Z L J;V
U J N A V L S M | N J V M A S U;L
W Z S T I K N V | W I V S N Z K;T
L A Y H Z S K P | A Z S L H P K;Y
F P U G E X K B | E X K P B G F;U
A S Q J B O R K | B K J O A S Q;R
N U W M P X H O | X M N O P H U;W
E M J B G Q O P | P O E M Q G B;J
J P Q C I X O R | X I R P Q O C;J
A Z E J T U R G | T J E Z G U A;R
Y L I D J G V T | I G L J D Y V;T
M U W Z I B J L | J L I W B U M;Z
G Q L M N A J W | G L M N Q A W;J
S P Q K V M A X | M V Q A K X P;S
E X V R S N G U | X R U G V E S;N
X K V T O E Y M | O T M V K Y X;E
D L H G F U K J | F H K D U L J;G
F X S P L Z A T | Z T A S X L P;F
W E G B P F K X | E P K F B X W;G
X S H D Y P O G | O D P Y X H S;G
P F R J D V S W | R S D W J F P;V
W N V G A Z P Y | A Y W G V Z N;P
I N A C Y J M Q | C A M Y I J Q;N
M R G Q C X W B | G C M Q B X W;R
T C E W L D O M | T E C O L W D;M
H Q J Y G L N A | J N H A L G Y;Q
K F L J B D X U | D X F B J L K;U
X U E K P G N D | P N K E X G U;D
Q M K F Y G L E | E Y M K Q F L;G
H Q B C X S R U | S X R B C Q H;U
N M I Y C D T V | N V C I D T M;Y
V L Q G N F U K | U Q V K L F N;G
I A X O T J M P | A P I J T O M;X
O H N R B W D V | O N R B D W H;V
E F G B P A Q V | F A P V G E B;Q
A W I G H F K E | W G K I F A E;H
L K C Q A O H N | Q L A K N O H;C
X B V O K D P Z | B O X D P K Z;V
C J B D Z V K N | J D B C V K N;Z
W T I G N F B S | W N I G S B T;F
V Z W Q H B F D | B V F Z W D H;Q
B T N I H Y F W | Y W B H I N F;T
T E N R X I W G | W T R E I X G;N
L R V H Z W G N | V L Z W H R N;G
X F C A Q T I P | X F A C Q I P;T
O D N B H E Z J | H E B N D Z J;O
S R M D T C P Y | Y P T S D R M;C
D I X Q T G E N | Q G T N D I X;E
V B W Q T C M X | W M T V C B Q;X
M B P C K L I V | P C K V L I M;B
Q R D Z T F P B | R D T F Q B Z;P
E R Q B N X O P | X Q P R N O B;E
R I T D H A S Y | R T I Y H A S;D
I K Z M Q S T J | S I J M Z Q K;T
O K Y Q G C M U | O C Q U Y G M;K
K N Q G Y H D L | N H Y L D K Q;G
F Y H Q L K W O | W O Y Q K H F;L
L D G N Z T S W | S L G W T Z N;D
B T G D O P U V | U G P D V O B;T
T P U Q W R E L | L P T W U E R;Q
W O D L I E J N | E O I D N W L;J
B O L W M G P V | B W M V P L O;G
K L V Z U T P Y | P L Z K Y U T;V
X Z K V Y O U C | O V U Y X Z C;K
X A K O T F C V | A F O X T C V;K
Y D J B R M I G | B G D R I J Y;M
B G S P K V I N | V G S N K I B;P
I P A J E N U H | P A H E J U I;N
Z L N U R X B E | R N E B Z L U;X
L I O P W X T S | O S L P T I X;W
M P U H R E W D | P D H R E W U;M
J G V X C K Q S | K G Q C X J V;S
A D W K L T Y C | K Y D W L A C;T
S Q L K I O Y A | K O I Y S L A;Q
U L K A T S G J | S K G T J L U;A
X O N P F R H U | O P H U X F N;R
T H I Y G B E U | U T G Y B H I;E
T D E G U A Q V | T V G A U D E;Q
A F G B S N W V | F G S A W N B;V
L T W P J H I Z | P I H Z W J T;L
K Z U O A J N H | H J U Z O A K;N
H Z J A N G T V | A J V H T G N;Z
N J H Y A X E Q | Y N H A X E J;Q
Q M W D L T R J | L Q M W T J R;D
Z E X D V J G F | Z E G F J X V;D
A B P J Z G O Q | Q Z B G J O P;A
J W R E Z Q I Y | E I Y J Z Q R;W
Z V J E O R G U | O V U E R G Z;J
W S U D V L P O | W D O V L U P;S
Y R G B J C A E | E A C Y G J B;R
I M T S J E H Z | J H S T Z I M;E
R U H B W X S K | B W K U S R X;H
U R Z O L F Y G | U Z F Y R G O;L
J D G E T A P W | E T P G J W D;A
X C T N W G Y B | T Y W B G N C;X
O B Y V G J N H | V O J N Y H G;B
H S Z A D G T X | X A Z H S D T;G
A J H C Y Q E D | H C D A Q Y E;J
O J I M Y G Z N | M Z J I Y G O;N
M F X E C T W R | M F E T C X R;W
D O I P Q J U G | G I P O U D J;Q
J I C H X P V R | R P J I C X V;H
G T D K N F S O | N O D K S G F;T
Q B L V E D K M | M V K E D B L;Q
H U C Q V Z I P | P U I H V Q C;Z
G D Q L T X O I | I L D O Q G X;T
E O K A Q L R M | A R M E K L Q;O
U N G Q C E H Y | Q C H Y U E N;G
N G P T J D U K | D T J K P G U;N
G M Z P E I W L | P G I W L Z M;E
J Z H A C Q T W | J A W H T Z Q;C
X N R T I Y F E | T N X I R F E;Y
J I M G Q N Y A | N Q J G Y I A;M
X Z U J F C D P | U Z X C F P J;D
I O B R V P T H | B H P I T R O;V
P E G V I Q T C | Q V C G E P I;T
S O X G K A Y J | K J A Y G S O;X
B J Y X G R H U | J H R G U Y B;X
L C G V E A Y O | A Y E V C L G;O
S E Y U D J Q O | J O U E D Q Y;S
N E Y I Q K G P | P Y N G K E I;Q
C V S X L E W M | M V W X C S L;E
R N E D M X J F | D F M N J E R;X
W H U B A S D N | H U W B A S D;N
B Z L A M N Q O | O N B A Z L M;Q
I X J V D O P T | J X I V T P O;D
D T X Z F G W N | D Z T F G W N;X
G P K D J X L N | X K D P N J G;L
L G Q A E X R I | L E Q R A I X;G
K A J P Y H E T | T A Y E K J P;H
M F N A O U J I | A I O U N J F;M
O L E N T V D A | T A O E D N L;V
K M B P L U D W | P D M B U W K;L
G Z J R U I P F | U F J Z R P G;I
T D I X N C Z F | C Z T F D N I;X
L C K W I V F Y | F V L C I W Y;K
F J O E V Z K P | P Z K F E O V;J
L P S N J X O M | P L J X O M N;S
U K M N C J P A | K P N J C A M;U
Q I D X A S C H | H I S X Q D C;A
S P E A Y K U R | R A U E P S Y;K
H D T Z A X B J | T J B X A H Z;D
K V B G M H I R | M H G I B V R;K
Z N K C F V L I | I L Z K V C N;F
Y J N R F G Z V | N J Z G Y R F;V
T G E S I X Y J | G S I X Y J T;E
C S Z E W U P G | G Z P U E C S;W
R P C E V I U A | E C V I A U P;R
B L P W I Q U R | P I W U B Q L;R
M T W O R S Z X | O W R S T X M;Z
M I K L Q D Z U | Q I K M Z U L;D
I L X J P Y T V | V L I T X P J;Y
Q K Z L J W H N | L W J K Z Q N;H
I A W N P O Z X | N I O A P W Z;X
R E F U N P S T | N P U E F S R;T
J N E P Q X B U | N U E X J Q B;P
M Y O E P U C I | E Y I M C O P;U
B T P H M Z U F | T F Z P M H U;B
F N P W K A D Z | K N D A P Z W;F
P Z W A T U G X | T W X G U Z A;P
C E T B X Y U I | U X C B E T Y;I
X R Y E P S M N | N R X E M S P;Y
C Q T S K Z M B | B T Q C S K Z;M
F R Z L S I X B | I L R Z S B X;F
B R J W D V C I | I V C W D J R;B
A P N U K Q J D | A N P D J U K;Q
W U Y H J S V A | S W V J U A Y;H
K M N R Q J I C | N J C Q I R K;M
P G L I K T Y J | L G J Y T I P;K
F U K B H R G T | U B K T H R F;G
C D Q T G A M R | A D Q G T M R;C
R X E N C O I H | R C N I X H O;E
F Y L K I Z Q E | Q Z K I E Y L;F
N L D F S W E M | D N S L F W M;E
T A P N Y B E Q | Y N A T Q B P;E
H C M X F W K L | K M C H F L X;W
P J H T D I Z S | D Z S T J P H;I
I R F P U C X G | F P I C X R U;G
V J S D E B Q U | Q U V S J B D;E
R E H Z O L D C | R L H Z D E O;C
V K U W O N M Y | Y K U W N O M;V
E G O B W R Q A | O W R A B Q G;E
N Z I S X B D T | X I B Z S D T;N
Y Z W R O J T C | R T Y J O Z C;W
R O H K J A U P | O H K A J U R;P
O Z D N J I Y S | Z I D Y J N O;S
J N I S H W X D | D J S X N W I;H
J X M G I W U N | I M U W N J X;G
V F U O W Z N S | Z S V F O U N;W
K H B D A F Z T | T B D H A Z F;K
W P L Q J B O D | L O Q B D P J;W
L S B N R M I A | A L M I R B S;N
S V T I O D E B | E V T I B O D;S
G J D T U E O C | J E T D O G C;U
T G M L Z U P B | M L P Z U G T;B
E I Q U F H L O | O U I F Q H E;L
Z O K I P S X D | I S Z O P X D;K
P Q X D Y V S K | D Y X V P S K;Q
E S C Z U O K G | S K Z O G C U;E
M L H I X C S O | X I S C M L H;O
D X E G C B U R | E D R G C U B;X
K C Q A F Y W N | N F K C Y A Q;W
D B K R Y Q E L | K D L E B R Q;Y
K H S X W D R I | D I R W K S H;X
D G A F Z X T Q | D X A F G Q T;Z
H B E K Z Q T O | E H T Z Q O K;B
O N C Q L H P K | L P Q N K H C;O
K C B Z U R P N | U N Z C R B K;P
R Q O K H P M L | Q O K L R P M;H
K R M P Y B O S | O Y S K R M B;P
R K S I W T F Y | W I R K F T Y;S
K V E O W U Z X | K X W U E V O;Z
B R G W I X D F | B X D F G I R;W
R Z J O T D L E | D J O E Z R T;L
Q R X Z F W A T | R A W T F Z X;Q
J F A K H C S O | O A C F K S H;J
J D G F U Q B H | J F H G D U B;Q
P D S U A T M F | F M P U D A S;T
N M G U H J L B | G U N L J M B;H
S E V I N Q R H | N S R I E H V;Q
H T Z A Y O U E | Z Y E O A U H;T
F E I Y Q J B X | B J I Q X F E;Y
W Y B X G M N C | B G Y M N W X;C
U X G T L R D F | R D F L X U T;G
J X N C M V E Z | X J E Z N M C;V
D L M P N S A U | A N D L U M S;P
Q X K R E T S Y | S K Y Q R E T;X
L K C N V Y I Q | L V I C Q K Y;N
G J H D N Y W A | Y W H A N J D;G
A N Z M L Y I V | I V N Y M L A;Z
R W T Q K D V X | T K V W Q X R;D
F S N X P W E K | S P X W K E F;N
X O F D Z V Q M | M X V Q Z O D;F
E T B S H K R A | H K T B S A E;R
X C Y M E G T Z | T Y M C X E Z;G
V T O C N H L J | O J T H L C N;V
Y R Q S F U Z V | Z R U S Q F Y;V
Q Y C F A Z V R | Q R C F Y A V;Z
S X E J M W A U | U X S M A E J;W
Y N W R A E V M | Y V E R W A M;N
L X Q Y O Z N P | O X Y Z Q P L;N
Q V N A J G U K | U J A K V Q G;N
P U Z V C R K J | U C R V P Z K;J
P Z Y U J I Q M | U Y M Z I J P;Q
M O S I W U K X | M O W K S U I;X
T Y A M V D Q L | Y V M T D A Q;L
O P G N Q F L Y | N O F L G Q P;Y
H W A E Z O R F | E H A F Z R O;W
E M H A G V U Y | U A G M H Y V;E
U L R S D Q V W | S U Q V W R D;L
E D Y F Q K X B | B X E D Y Q F;K
R D G M S J O C | D J G C S R M;O
C K G Q P W U E | U W Q C E G P;K
B A U P D V W K | W A K D B P U;V
M G K L Q F J B | F B Q J K L M;G
I X V P R U J A | I R X P V A U;J
Z R M O X B A E | O M A B X R E;Z
P S N D F X A Y | A N S Y D P F;X
S D M T V K C H | V S C H T M D;K
A X M Z O N E S | M A E X Z O N;S
R O Y W T E J K | O T Y K J W R;E
K X T Y G I B A | T A I G X Y K;B
M Q Y S K B D I | S B M D Q I Y;K
L J X Q T Y M F | X Q Y J L M F;T
I R E Y N U F L | F L U Y I E N;R
U I B R L Z V G | G R L U Z B I;V
B R K Z Y H M L | K R M L Z H B;Y
I P R D C O B E | P D E O R B C;I
X G D A Y F E V | A E X Y G V D;F
B G H L D O M K | M D L G B O H;K
A V G H F P L J | F J L G V H A;P
G O M D T W F L | G M W L T O F;D
Z R F K Y C P X | P Y Z K F R X;C
H J O N S Y B U | S J N U O Y H;B
P L M W S H N T | S W T L N H P;M
B F D X G Q A L | L D A F G X B;Q
O Y E F K N J I | J O K E I N F;Y
E C H Q Y V D J | D Y V E H J Q;C
Q G X E J R B Z | B R J Q X Z E;G
G H M Z W J F U | W Z J G M U H;F
I X L E R G O N | G X L I O E R;N
M H O R V X U A | U M R V H O X;A
X G P H F U R L | X G L R P H U;F
B J K I H S T A | J A S I B H T;K
W H J Z F D P C | P H J F C D W;Z
G F C V Q R A L | L C Q G F V A;R
Q O W R C P T A | W R C P O Q A;T
W H G A J O P V | V W A H J G P;O
T N S U K G C P | T P K S C N G;U
R K Q U T B A Z | T K B A Q U Z;R
V E N G P T B S | V G S E N P B;T
C O X H J L Y F | H X F J C O L;Y
A D T K H M S E | T A M K E H S;D
C F A O V R X L | O A R V L F X;C
M I E P S A L U | L M E S U A I;P
C U O X V L A F | U X O A V F C;L
R Z L E C G J D | G D J L E R Z;C
M G Z D O R C E | Z E D M G O R;C
C W R Y P V N S | V P W C R Y N;S
A Y L E P W J D | A L E Y W P J;D
Z D S N C U J K | D N Z C U K J;S
Y Z M E R W H N | M R E Z H Y N;W
P T R L I E D Y | R I T P D E Y;L
P Q M R J V N E | P R N J M Q E;V
H E M C I G T N | H I G E C T M;N
G E D T Z F W M | Z F M T G D E;W
F C E R X L T V | E X T C V F R;L
L Y E Z F R K C | C L Z K Y F E;R
M F V B T E H D | M D E V H T B;F
Q H X T D J Z A | J X D T H Q A;Z
S N T L V E Q B | L Q S N T E B;V
V M T O Y Z X D | Y D M T O Z V;X
Z P M J H O D G | P M G O J H D;Z
D E L O S W N J | D N E W J S O;L
B M E I H N A T | E A T B N H M;I
P H Z C L R Q I | C Z Q H I R L;P
O D R J W X M G | G D R J X W M;O
J Y R G H U T P | T H P J U Y G;R
L D Q C T U V X | Q D X V C U L;T
R H X J K O W Q | O X R W K Q H;J
T C W R U O A K | W O C T K R A;U
A C Z T S V X Y | X V Y C A T S;Z
H S Y M E C R J | J E R M C H S;Y
U P K B H T R G | H B G K P R U;T
F K O N B S W R | F N S B W R K;O
Q D K L H B T P | P Q K H B T L;D
X O W H M D J B | O M B D H J X;W
G R F E H K L O | H R K L E O G;F
N R C E H S B U | E S H N U B R;C
Z J K I H B S R | R I Z S B J H;K
M X H F L K T W | K M F W T H X;L
I W D B P R V N | N R D P W B V;I
Z R F N K X B J | B J X Z F K N;R
G I Q J X B K C | Q G K J I B C;X
F R H J S B E I | H J E F B S I;R
V N L A U R D G | N A R G V U L;D
U W I O T S R M | R W S O M I U;T
O W B R P J H I | I O R J H B P;W
Q M F N R W C S | N S W C M R F;Q
M L T A Z X Q J | A J T Z X L M;Q
H E B V O Y N S | Y E B H S V N;O
S O M F Z D E Y | S D Y F O M E;Z
B T R Y G P W I | Y R P W B I G;T
H I A L Q O N V | N H Q A L I V;O
Z A W J R V Y Q | Q V A Z R W Y;J
Z R C Y S V E U | S R Y E U C V;Z
Q O A U I S J C | U I S A O Q C;J
N C F Q P Z L R | P F L Q N C R;Z
B G E O V F A K | E A V B O K G;F
U S E M W K D X | X D U M K S W;E
T Q R Y I U M W | W Y T Q U R I;M
W B H K J L I O | K L H O J B W;I
S T X U V B E Y | E T Y X V S U;B
C G Y P B X N H | H P G B N C X;Y
X R F B C V N L | N X V B L C R;F
K I J Y V U D Z | D I Z U V K Y;J
G K F Y P I Q O | Q O Y I G K F;P
L C P A X K O W | C O L X P K W;A
E M J A F L C X | E L M X A F C;J
I T X A B O Y N | O A B N X I Y;T
I J C Y G W E F | Y C W J E F G;I
J F T Z Q C L W | Z Q T F L W C;J
F W X N M L S E | M L X N W F E;S
N L F I C S X R | X F R C N I S;L
L Y Z G P C W Q | Y L Q C G W Z;P
C I V G R P W S | W V I S P R C;G
A C M W B G S F | A S C M F B G;W
P Y F X A N L C | X L F Y N A C;P
X Q I L M N O P | I M Q P L N X;O
B V D A G W O N | O G V N W D B;A
J X A Y D C T B | J X A B C D Y;T
X P U J G D Q M | D U G M J P X;Q
A K W Y P C S F | S W C A F P K;Y
T L G C D M F O | G D T C O M L;F
G B P R Q H L J | J L Q P G B R;H
M G T E O R I J | I M O T J G R;E
H O T B G Y A L | O G A T L Y B;H
R D M E V U T Q | M Q U T R E V;D
Z C M E S B G O | G Z S O C E B;M
O A M R C D L Z | M A D C L R Z;O
S R W L O U Y Z | U L R Z O W S;Y
Q J C W X Y P T | X J Q C W T P;Y
D I H A K P X R | R H X P I K D;A
R L A M B H V W | W V L B R H A;M
T Y V K I B F J | T Y B J K F V;I
G Y E W B N J I | G W E N B I Y;J
R H T Z W E M Y | Y E W T H M Z;R
F M H C L X D S | F H S L M D C;X
D K A C N B R J | A C J R N B D;K
Z O Q M L R X U | O R M Z L Q U;X
P O F R V B W Y | O Y R P W B V;F
Z S F K O J N G | N S O J K G F;Z
V H C I Z F A T | F H A C I V Z;T
T R G Y B X O I | I T G Y X R O;B
U N A Z S L F P | Z L F A P S U;N
Q G Z N I F E W | W I F N Q E Z;G
B J H T C Q K W | Q H T B C K J;W
W Z S U H A T M | M A W U Z S T;H
J A M R S B E N | M E A N R B S;J
W V N H R L Q S | W S N Q H V L;R
J O R P S L T C | R S T J C P O;L
P L O C S J A G | J O A L S P C;G
X Q K R N D L S | L D K N R X Q;S
K X G O B E V Q | E X K G Q O B;V
Y W S O M Q X F | W X O M Q S F;Y
O V J Q C G L M | M J O G L Q V;C
D Z H C A Y F B | Y F D Z C B H;A
K S B M A I Q T | M T A B I S Q;K
I T K N L Y E B | L B E Y I K T;N
K U R L H E W I | E H I K L R U;W
J H O R L S X U | S X J O H U R;L
V Y A R F O X D | X R Y V O F A;D
C U S O G K M H | C G U O K H S;M
A D U V R M N K | V R N K A U D;M
F U G V A E X L | U V A G F E X;L
P O Z S N Y D E | P N E O D Z Y;S
L M Q T R E N Y | Q N Y T L M E;R
M E J U Z A Q C | A J Q E M U Z;C
L Z W C O M V F | O L M F V C Z;W
A V N Z R P Q J | P J N Q A V Z;R
E N P J C Q L R | R N Q C L E J;P
U H B P A S F J | A P S H B J F;U
G A R L T V W X | A G L R W T X;V
E P M V L A J Y | J A V P Y E L;M
S D Q N G W M Y | N Y W Q M G S;D
V P F K Y W X O | V Y X F O P W;K
A Y M O E Q H V | M H Q Y O A E;V
F A X O N V P J | X A F P V O J;N
Y N B A E H P X | P B N Y X H E;A
R Q I Y J O N Z | R Y N Q Z O J;I
Y S O M J T Q N | Q O N M J T Y;S
B V Z L D A P T | B L T P D Z A;V
R X I Y B T L G | Y I T B G L R;X
B F A T R X O P | P F X B R A O;T
D H T W A J X L | H L D X A W T;J
P E C T Q K O A | P K T E Q A O;C
X D Z L Q Y J W | D Y L W Q X J;Z
Z V H S Q N U M | S Z N U M H Q;V
D O L B T H E G | E L B T O D G;H
P B C N H J K D | P B J N K H D;C
B P N D X A L H | B D N X A L P;H
I H E F D T O B | D H E I F O B;T
E B Q M I W J P | M W B J I E Q;P
Q W F J I Y K H | Q K W H Y J F;I
Q C Y T L K H P | C Q T H P K L;Y
X T W L Z V K O | W K Z V O X T;L
D I N Q O E C S | S I Q O C N D;E
L B P W U Q M O | Q O P U L W B;M
D V N Q O B H S | Q N D H V S O;B
P J Q T Z X S M | P T Z M J S X;Q
L P G D A B K R | A L P D R K G;B
D H G F J T M Y | F Y J H T D G;M
J X K V Q W S Z | J X Z S K W V;Q
I X Q H T B V A | I A X H Q V T;B
O I X K U R F V | K F X R O I V;U
H Y N J O R A W | Y J O A H W N;R
B X G T S H P V | T H B G V X P;S
V J E G O C L R | O L G R V J C;E
E Y N S B J P T | P T S E B Y N;J
V E Q U T N L A | N T U V A Q E;L
W Q S V I A Z T | V Z Q S W I T;A
I L V B Y S O M | S V B Y O M L;I
P J O E T M F N | O E F J N M T;P
Y U N Q X B L D | Q U L N B Y D;X
O N E S K J W T | J O T K W E S;N
I J T X C L B Q | Q C X L T I J;B
H R T G Z Y P K | K P T H Y Z G;R
A C B R U D S X | C A X U S D R;B
K U A X D F R Y | A X K Y F R D;U
W F T B S D M C | B M D T S C F;W
H X B F E M J S | H X J F E B S;M
R D M X C Q L F | C L R F Q D X;M
O A F D W I X Q | D W A Q I F X;O
J C N T Y P W H | N Y W P T J H;C
K P R W Q G D B | K R W G B Q P;D
G K I J T A W S | A J I K S T W;G
V X C D K A N I | A C K X N D V;I
W P C N E V I K | V N K W C P E;I
V O S A Q K G C | O C G Q V K A;S
K U T R X C Q E | U C Q E R X T;K
S N X Q G F R L | S L F R G X Q;N
H Q G W T I V C | T G H V I W C;Q
N C T Z M X U Q | M Z N U C Q T;X
P B T S H N M W | B H M S P T W;N
N E G W Z U P B | U N P E B Z W;G
G M O K C L N F | K C F O L G M;N
T Z G W S L O C | Z T G O S W L;C
Z N I M X O H K | X N Z I K H O;M
F O R D K H E V | H F D K R E V;O
J W O G B X S I | G W B J X I S;O
M J G V O L K Y | O L J V Y K G;M
J P E I N A B D | B E N J D I A;P
R H M D G I U X | R M G U D I X;H
K O F Z T B G H | K Z F G B O H;T
P V T L F H U I | U H P T V I L;F
L D X J M W P F | F M L W P J X;D
I Y E L B T K O | B I K Y L E T;O
Z X K M S P L F | P L X Z K M F;S
W O U Q H L J B | W L B J H O U;Q
I Y M G O N P B | G M I B P O Y;N
R Y O Z T I F N | R Y F Z T I O;N
N M F W E U C H | C M E U H W F;N
R J Z X W G H Q | J X H Q G W R;Z
U T D M J N G A | M N J T G A D;U
P O C J F I M D | O J M I C D F;P
Q S C K M E P L | K Q C S M P L;E
W X P D O H C R | O H W R C D X;P
X U R G J Z T E | G T U R E Z J;X
L K U J Y G X O | X J K U Y L O;G
Y D J I L H K T | K D H J I L T;Y
A H T W O C J Z | Z J A W O T H;C
I E Y X B Z A D | B E Y X Z I D;A
D H A Z E B V L | E A V L Z H B;D
N V E Z H U P X | U E V X N H P;Z
F R T U D P H N | F N P U R H D;T
X K O J L N C G | J L O G X N K;C
X D L Z Y M V W | X Z D M L W V;Y
B G P D V I A E | I D A P E B V;G
O A X H P S R Q | R P Q S A O H;X
J O X C F Y W L | X L W C J O Y;F
I G A X Z M Y P | Z X A G P I Y;M
H D X F G S O Q | G F O D Q S H;X
W N G A Q H S M | H A Q S G N M;W
K P L X M H I J | J L I M K H X;P
G M R P F X A K | M G R X P F A;K
K Q Z A X O V J | Z K O J Q X A;V
V T J W F X D M | F T M D J X W;V
N K L M C X Q I | I Q K C L M X;N
G O S I Q R P T | T Q S G R I P;O
B I W Y T A J V | B J T I V Y A;W
Z K B P O S U E | O B E P Z S U;K
M Y L T X K S B | X S B Y M T K;L
M T D I N L Q G | M D N Q L G T;I
S N A T Y D X F | Y F D X A T S;N
Y H P V O D Z N | O H Y N P Z V;D
L J X O P B T R | L B X O P J T;R
F S Q M O X A I | I F A S M Q X;O
B O Q X A I G J | A X G I Q O B;J
W N Q Z X M P E | N E P Q Z M X;W
R T Q W L I Y K | Q L I W R T K;Y
T F B L K V H Y | L V K Y B H T;F
N V Y F A O R B | B F R Y O N V;A
T E O Q G J M Z | J G M E T Z Q;O
P H C E Q N I Z | Z E P H C Q I;N
F N I J C L Q W | I L J W F C N;Q
B N S K I A U O | N I S A O K U;B
N A Q S U F M D | F M N Q A U D;S
B Q X A P S T Z | P S A Q X B T;Z
N K M W U P R V | U W R V N K M;P
A K Z X U Q D R | Z X K D Q U A;R
U O C Q W K J T | Q K C O T J U;W
R S D Q X N K I | D K N I Q R X;S
Z X I M C O R A | O X A M R C I;Z
J W U X L Z Y V | X Y J Z U V L;W
N W P B S K J U | J P K N B U S;W
Y X W D B N H R | W H D R B Y X;N
H N T B E I V J | N J V E T B I;H
Q B W M E T A C | W A T B M C Q;E
K X G Y J L C E | C J E X Y G K;L
V J A D Q E H G | G D Q V A E H;J
P V Z I M K G O | V Z M O I K G;P
X C M W U F I V | V X C U M W I;F
J G B S X L M F | F L J X S G M;B
E A M X K V O F | A F V O X E K;M
W A C Y Q G I N | W C Y Q N A G;I
W U I M B E L Y | L B I M U Y W;E
K N H M L X G E | K N M E L G H;X
H V F I U G N C | V N I F U G H;C
N P D Q O J C Y | C P O Y N Q J;D
L U T Z G D H Q | Q D G L Z H T;U
K E W H Z R O M | M R O W K H E;Z
T U X L N O Y G | G L U Y T O N;X
F B K U O T S M | M K B F T S O;U
L W U S I Y C F | U C F S W L Y;I
U X I Q O L W H | L I O U W Q H;X
H U J N W I V L | U W H I L N V;J
O B E L J M W Q | M O B J Q E L;W
M K H X C I O T | O C T K H X I;M
Z G X W B Y A E | W G X B E Y Z;A
U S W L T D G Q | L S Q G T W D;U
U C A S T I J V | J C A T U I S;V
H C P Z J X A Q | C A Q H Z J P;X
I L P K R A B Q | B A K R Q P L;I
X Z R V S W F L | F R S X Z W L;V
U H E D L W K T | W K L D U H T;E
F H C D X V R U | F R D U V C X;H
K Z E D U W G L | D E U K L Z W;G
N B Q R G K V X | Q R N V G K X;B
O C D W Y M S J | Y S O C J W D;M
X O V Q M C E I | V Q I M C E O;X
B H X W J A R V | W R B X V J H;A
W V E P Z I M J | V P J M I Z E;W
W F G E S I X T | X W E G F S I;T
I L G Q O N S P | P Q L G N O S;I
X B P G E O A M | A B X G M P E;O
O M N I W A L V | L A M O V I W;N
X O M S V K A G | M S V K X G O;A
I E O N M R L H | E R O L I N H;M
B V R M Q S C L | M R B Q C V L;S
I Q L K S Y D N | Q L K N I S D;Y
W M K N R I A Y | K M I N W R A;Y
F H G L P K T W | P K W F L T G;H
Q X B M A P V C | Q B V M P C A;X
E Q K H O U T C | C Q O K H U E;T
Q X K R Z D B C | Q R D B X Z K;C
Y Z T J M V F G | V J G F Z T Y;M
R L J K B W I M | W L I R B J K;M
U I F M S C K Y | M Y C U S F I;K
O Q T S M X F U | Q U F M T X S;O
A V N C Y I T L | N C A V Y L T;I
W H M E I C P O | I P M O E C H;W
M S G L P W Y C | C S Y P G M W;L
U F D W E S V B | U D B S V E W;F
C I P M K H Q Z | C M I P K Z Q;H
N D V A O C M Y | C D M A Y O V;N
J L G H C P A O | J H A G C L P;O
W P D C L H J M | J L H P W M C;D
X S J A D P W U | X S W A D J P;U
V C E F Q P U G | E U F V P C Q;G
F C K D Z M J V | C D F J Z V M;K
Q I Z A N G K L | K A N G L I Q;Z
X H U V W Y D L | W H U Y V D L;X
Z Q U T N W A L | U L Q N T Z A;W
A M Y T V G R X | Y V M T X A R;G
X N Y U K R G P | X R G K P Y U;N
F R J V G W L H | J L V R G H W;F
M S E U W A L D | L S A D U E W;M
Z L B D Q X W O | Q L D Z O W B;X
W T D Y P M F Z | F M Y T D P W;Z
Y A L R U X F C | U Y L A X C R;F
G M K B V E Z I | G B I K V E Z;M
F G C E J O A H | F J G E H O A;C
N L J T X Y C B | Y N T B J X C;L
A D P H O F K S | P A F H O D K;S
S H B L R E C D | H S B L R C E;D
C Y O U V M D B | B V O M U C Y;D
V C L Y Z D U P | U Z Y D L V C;P
P B D W G M V H | B G P W D M V;H
K U D P A T V N | U K T P N D V;A
P D G F H K E L | H K G F E D P;L
P U I Z V S X F | P X Z V I U F;S
H Z W C R K D L | H K R D W C Z;L
N O K E U A I F | U I A E K F O;N
B O P I X A L J | B I X O P J A;L
P T Z E M X L I | I Z X P T L M;E
O Z U E V Q K N | V Z Q N E K U;O
O G U F V S J H | V G F J S H O;U
S Y P W D A T E | D E A W S T P;Y
G N K T R C M P | N G P T C R K;M
A Y C N Q R L V | C N L A V R Q;Y
T H Y M V Z X W | T H Z Y M V X;W
T N I U M X F R | I R U M T X F;N
F G K R D X A J | A G X R K F D;J
U X K H L G O R | H O X L U R G;K
J E L M D Z N H | Z M D H N E L;J
W M A R O S Z H | Z A M R O H S;W
L P C I R B K Z | C L R P I Z K;B
J Z K H B S Q W | B J H Z W K S;Q
M G R T O B N A | G T N B A O R;M
S O J F Q V A N | J A N Q S O F;V
B Z K O X M E R | X M O B K R Z;E
H W Z U Y X M I | X I U W Y M Z;H
D C Y B Z A I M | M D C A Y B I;Z
H T Y Z G V B A | V T H Z B Y G;A
I L U H A T S O | O A T S L H U;I
Z F P I G B J W | I J F Z B G W;P
T U X O I M D B | U B T M I O X;D
T X P F E C Z U | E Z C F T P U;X
P Q U I D A E F | I P Q U E A F;D
Q U D Y Z A R F | A Q R Z F D U;Y
Z O S N E X L R | R L O Z X S N;E
U P V G C Y F O | C U V G Y F O;P
Q I P E J C G R | E P R J Q G C;I
Z W S N K O R T | Z K S W R N O;T
Y H V S E Q L W | L S W E H Q V;Y
Q C R W S E A X | C S Q X A R E;W
N J O D T H Y K | Y D H N K T J;O
L R X Q A U F K | Q A L F U K X;R
O J V Y X Z F A | X Y A V J O Z;F
E Q X C L D U F | D F E X C L Q;U
Y M L A U I G S | M A Y U L S G;I
G H S P K U J D | U K P S D H J;G
H Z X Y Q V E K | Q V Y E Z K X;H
W Q C N P F D E | D Q W P E N C;F
R Y S C P V J O | V O P J Y C S;R
K L W S E P I J | I W S K L E J;P
X N F P M C J H | X J P C F H N;M
S X C G N T Y J | C X G T Y N J;S
Q I B G P A T F | T I Q B A G F;P
Z P O N L M U H | U L Z H N O P;M
Q G K W T F Y J | J T W G K Y F;Q
K W Q M I U X H | W U M X H K Q;I
B N U G X Y C V | G N B X V Y U;C
Y U Q T H S G L | Q L U Y H T S;G
W P N I T B M K | W M K I N T P;B
X P T Q H G Y J | H X G T Y Q J;P
K I V J D X E S | X V E K J I D;S
L A X T H Q S G | S A G H X T Q;L
V P K X Y W E B | K V Y W B E P;X
U K F T S J Y N | T J K F N Y U;S
E A P G Q O S B | Q A B E P G S;O
P J B M G K N Z | N K J G Z P M;B
D B M Y F S T G | Y F S D B M G;T
H J Z X B E P Q | X H J Z B P E;Q
C G V A I M P Q | V Q P C M A I;G
U Y T W R H M S | M R W U S Y H;T
J X L M B R D Y | L J B R D M Y;X
J Z I R N Q M C | M C I Z Q J N;R
F L J Q O R Z C | Z F R C L O Q;J
Y V J U N S A K | A U K N S Y J;V
W V M X U B D C | X V D U B W C;M
H Q C K D T P X | Q X P T H K D;C
M H Z J N G V X | M G X J N H V;Z
R A G O C H D S | S G R C A D O;H
S Q H Y J N P I | H S N I P Q J;Y
N E R K W V S G | W E S V N G R;K
W R Z H A Y G O | O Y W Z R G A;H
K R C L D Y W Z | D R C Y W Z L;K
H W J Q Z S G A | A S W Q Z J G;H
T J D Z U E C M | D T C Z J E M;U
I A M B J U X N | I B J U A M X;N
G I V P A Y K T | A P K G I V Y;T
T B J H E G I M | H M I G T E J;B
C M N D B U R H | D U H N B R C;M
J A B E K M D Q | A B K D M J E;Q
B W K E I N M T | B E W T N K I;M
X G P Y U E M T | Y G M X U E T;P
Q B D J P I Z O | I P D Q Z J O;B
X Z M P W J L V | M J V W L Z P;X
D Z Q K E R O F | D Z K Q F O R;E
O D U N V Q B K | Q D O V U B K;N
C K P V E X O Z | O E Z C K P X;V
S R T O G P V H | H P T O S G R;V
A M Y L Z U T X | M L Z T U A Y;X
U M Q H D J A I | U H Q I D A J;M
M Q C Z T P L B | B M P T Q C Z;L
L G O E B X U R | X E G O B U R;L
D X A W C S P Z | P D C X W Z A;S
C Q Y V N W S H | H V Y S Q W C;N
B Z Q F U M P E | M F Q B Z P U;E
N S P E Z M Y V | M N V E P Z Y;S
V J X Q K L O M | O X Q V L K M;J
N D C F X G A P | X N G F P D A;C
V F Y Q Z U J L | F L Q J Y Z U;V
R J C Z A V M E | A M R V C Z E;J
F Z X U V T K Q | Z X Q F U T V;K
B C A O H S T J | T B H J C S A;O
X R Q F C O V H | V C Q O F R H;X
U A N O R X Q C | R U O C Q X A;N
P M R Y F N J A | A Y P F R J M;N
Y M V B X N D O | V B M D Y O X;N
S U X O A D T N | T D U X S N A;O
Z W I P C Y Q S | P S Z C W Q I;Y
I W A F U N Q E | W E A F N I U;Q
Z S K W E H P U | Z S H W E K P;U
Q H C M P B G R | Q G C P H R B;M
N I P Z M X O A | X O Z I P A M;N
R Z B L N W T K | L K R B W Z N;T
E H T R Q V L G | V L Q H G R E;T
V A T K J N Q E | J K E A Q T N;V
V T C Z F M U S | C S F T V M Z;U
E L U D M H F N | D N F E M H L;U
E N F K U P M Q | F P Q E M U N;K
Z X F A U D P G | G U X D F Z P;A
W P J Q T C L N | L J Q T P N W;C
G Z F K D Q C R | D R K F Z G C;Q
B E F C H Z G D | D Z E C B H F;G
S E K R G O F I | S K F R E G I;O
V E R W X L D N | E W D R X N V;L
L G X W D O F S | L S O X F W D;G
H L W D C O K M | W K L D O C M;H
V M I Q U D F A | A F U V Q I D;M
P G U F A B L J | L B P A G U F;J
T R H F Y P L G | F H P G L Y R;T
J Q K G X U W B | J W X Q G K B;U
A C S T L K Y W | L K A W C S Y;T
J B L V G Y N A | L N G B J A Y;V
L Y R K N J E S | Y J E S K R L;N
T R B K X A M P | A K X B T M P;R
S H J G V I T N | V J H I N G S;T
Q Y T H E B V F | H V B Q Y E F;T
S L H M G O A J | A J O S L M G;H
V B A H Z W Y E | B Y E Z H V A;W
S U Z E T X J R | X S T E U Z J;R
T I G F L B Y D | I L D T Y B F;G
S D Q O Y W E F | Y D E F Q W O;S
N I Q P X J U S | S N I J X P Q;U
M U Q V D E O B | V M O U E Q B;D
B I G K J L T O | O I B G K T J;L
X H Z L E D P U | U P E L Z X D;H
J Y V O B U C T | U O C T B J Y;V
Q E F W L S C V | F L V C Q E S;W
D X K H O Z T U | K U T Z H X O;D
A K G X D C V H | D C K A X V G;H
W L A Z X P S H | L A H P Z X W;S
Y R M S A K B P | S B K Y M R A;P
Y D E O A U N T | U T O E D Y N;A
V X G I K W C Q | I W G C V K X;Q
N D C Y X T H B | D B N T H C X;Y
K J P O V N Q M | Q J N M K P O;V
V X T Q F Z S M | M V T Z Q X S;F
U F P K C W H B | K C W F B P U;H
L V D C U B N I | U N C B V D L;I
P V O Y H N B R | V H B O N R P;Y
P I C Y W B M S | Y S B C M W I;P
R B W Y I A T S | S R T B W Y A;I
R M C X E N T L | C E X L T N M;R
T G R U M H X D | D H M X G U R;T
J X Z O W F H V | W V F J Z H X;O
U R J V Q K F A | J A Q V R U F;K
U A M K S V R D | D S R U K M V;A
G C P I E H A O | G O P A C I E;H
H V Q B M E G C | C E G M B V Q;H
J Z T N C Y S W | T Y J C W Z N;S
J R C S N M L Y | M R Y N S J C;L
Z I A D L F K Y | Z Y A D I F L;K
K H T X M B Y P | B M H P X T Y;K
T S C I Y D A K | K D Y C A I T;S
O J I D W T L Y | D O I Y T J W;L
X U N J M B D F | J D F X M N B;U
C X L U Y V G K | K Y U X G V L;C
R Y I U X M H P | X M H I U P Y;R
L X Q Z K E J U | L U X J Q Z E;K
O T S C Y A F X | F T S A X O C;Y
S Y T V N R F G | G V R N F S T;Y
W A S N C Q Y M | A Q Y W S M N;C
P W R E L Z C Q | Z W C Q R E L;P
R G D T Z A B K | B G R Z K T D;A
M B J G I Y V U | B Y V G I U J;M
E L Z R W F P G | Z W L R F G P;E
N F U S X Q M B | U F M B X N Q;S
A R Z F W T H O | O H Z W T F A;R
V D U L K A G T | K D A T U L G;V
W Z C X J B D I | J Z X D W I B;C
K S X H M J P Y | P X J Y K M S;H
R P U F H N M K | N F P U H K M;R
E G H B X L W M | X E H W M G B;L
A C O T D W K N | D C K N T A O;W
H T E K W N U C | N U W K C H E;T
R H O Z I P W X | W Z I H X O P;R
Q O V J R B Y T | O B V Q T R Y;J
B Z G V A X Y W | B W A G V Z Y;X
Q A T Z D B N X | Q D X T B Z N;A
W N K G A L E I | K W N G L A I;E
T L G B R P F M | B P T M G F R;L
D U L M K R Z S | L D Z R M K U;S
C O H Z Y N F P | O F P Z N Y C;H
G Q R U H F Z I | Q F G I H Z U;R
J H L P A F U O | H P O J U A L;F
P N Y Q L J O S | J Q S L Y O P;N
C B J M E K G F | C E M F K J B;G
N A I X H Z L D | D N I H A L X;Z
N V F E G T K X | G T F E X K V;N
W M Y I V R D S | V W I R S Y D;M
O H N D C T A Q | O T A N H D C;Q
L A S U Q J X W | Q S W X L A U;J
C K H N W Y V G | W C K V N H G;Y
Q M F S K G U A | F A S M G K Q;U
D J Q A W U H X | A J Q U W H X;D
R I Y W T N Q F | W F I N Q Y T;R
S J N O W X V A | O N S W A V J;X
B H P E C J F T | E J T F P C H;B
S R C B O A U J | S A J C R O B;U
Q E I P N V X D | I E V D X Q N;P
R O G T P M V S | P O S R G T V;M
H S K C Q X Y M | X Q S K C H M;Y
G F T I B X S Y | X I G B F S Y;T
N C G Z W V J S | S J V C N G Z;W
F J Y B U O K Z | F O J Y K U Z;B
N F Z K A V L R | A V L Z K N R;F
D Z H Q T B R S | T Z B Q S H R;D
Y U W Z G S B A | Z S Y U W G B;A
Z A L I T R M P | P T M L Z I R;A
Y W U E B L H A | W B U H A L Y;E
O M F N B A V Q | O B A F M Q V;N
K T J Y O R Q W | T R Y Q O W K;J
R M S Q I G B Y | B Y I R M G Q;S
D N B E K V M O | V E N B D M O;K
R L A E J U X T | T J R U X E A;L
H X S U R C W Y | W U X S R C H;Y
T X W L B J Q H | B W Q L H X T;J
N A M H R F W Y | H Y R W N M F;A
G S X B K F U T | F X U B T G K;S
X H D Y W V S E | X H W S Y E D;V
A Y V U J F X C | A U J V F C Y;X
S Y K V E T D B | B T S E V K Y;D
N L A I F D C P | A P I C D L N;F
V R W C B Y M A | A V W R M C Y;B
W H K R X P Z V | W P Z K X R H;V
S D O I C L P V | O S P L C V D;I
V L C M O J D B | V C M L O D B;J
D Q L I M B N R | D N I B R L M;Q
P H X Q N R V T | V X N H R Q P;T
S B V C Y F H J | F J C Y B V S;H
E Z M Y X C H A | A H Y M Z X E;C
Y O C N X W P T | C X T W Y O P;N
A C F L U G M E | C E G M U A L;F
O V T A M F P R | V A P F O T R;M
B O R V I U H X | X R I H B U O;V
J W Y L I M S K | S Y W I K J M;L
D V Q F J I T U | V D I J F Q T;U
H F M C W G E O | O C F M W H E;G
A G H J U T L P | U T A H J L P;G
A I D R F C H M | A M H D F C R;I
H D P L S Q B M | P D Q M L B H;S
L I M W Z Q A C | L Q W A Z I M;C
H E V I L D O N | N E O L I V H;D
F A H E J C M X | M J E X H A C;F
W K G Z N I M O | I K N O W G M;Z
T I U P V F M L | L I T U F M P;V
N Z W M L X E S | X N M W Z E S;L
G F L C J M V D | J M V C F L D;G
F L R C G S Q J | F C G J R L S;Q
D Y Z O G L J F | Y Z L F G D J;O
O X V C H T D E | D O H X C V T;E
Z U R T L O H Y | U R Y L O Z T;H
M T V A Z F C Y | T F Y M A C V;Z
H B M K X Q A T | X T M K Q H A;B
I Y M W R N C D | R W M D Y C N;I
Q E B F C W T H | F T E Q H W B;C
I N P B U R S D | S I U R B D P;N
Y H F G U K I Q | H I G K Y Q F;U
Z P X E R H D I | P E Z H R X I;D
X A R V B G L Q | L R V B G X Q;A
J X V S H W E G | V J H S E W G;X
P O R B K X Z M | Z K X R O P B;M
T Y E H G B P O | B O G T P Y H;E
Z I J O R W F V | O V Z R W J F;I
X P Y E S A K M | P X Y K M S E;A
L V N J D G U A | D L N G U A V;J
O A N P M B C D | A B C P N D M;O
C P U Q X I L R | R Q U I P C L;X
Z H T W P O G K | T W K O G Z H;P
C P B Z M R L Q | Z P Q C L B M;R
W U D L T O P C | D W O C L T P;U
E Q U N T R B J | R U T J E B Q;N
C Q U H G Y N K | G K N H Q U Y;C
M R S Q N C B O | Q B C M O R S;N
V Q O C Z X F W | Q F X C Z O W;V
E A D M Z T I H | Z E D T H M A;I
T E L S M W Y U | M W U E L Y S;T
Y M L S C J T O | O J C Y T M L;S
G A N B F Z J T | J Z A F N B T;G
E U K J X W S B | J X W S B U E;K
D V K T L A W N | A D N W V T L;K
U J M V N A E O | N J E O U M A;V
C X Z M U P A E | C M E U Z X P;A
K F M X P R E T | K M X P E F T;R
G Q N O C Z R W | C R W G Q N Z;O
L D Q T N O W M | D O M Q T N W;L
S Z Q E T I M U | Q S M Z E U T;I
D U Y C I E T Z | Y Z I U C T D;E
T C X U G K B R | K U X T R G B;C
K G R D W P A N | N P R A W G D;K
S X Z N M E V W | S Z V N W M E;X
H S A Y F X U G | S X H U G Y A;F
W Z V H C I Y O | H V W I O Y C;Z
T G W L F H A Z | G W F T Z L H;A
Y N J L K C S I | J L I Y S K N;C
E W X S P J U T | T X J E U P S;W
L Q T B S G K A | K A S B Q G L;T
A I G M Y X L E | I G L E A Y M;X
Q B Z Y W S A U | Z A Y B S Q W;U
P F S J A X I O | O J P S F A I;X
U Q P C N M G S | Q S N C M G U;P
Z V E N S I C R | V R S Z N I C;E
D Y Z U I M V C | M Z C D I V U;Y
F S I D W V K C | F W K V S I D;C
X W V T N B U Q | W N X B T V U;Q
P N J B X R H U | H B J P N X U;R
F E S L P M D H | D P L F E S M;H
W B E J D X U N | U W X N E J B;D
I S N U O B L F | L U I F S O N;B
M C S D L W F E | E F S C L W D;M
K P W V A B I S | P S B K A W V;I
U D R Y M B O G | B U G O M D R;Y
Z L H F P J T V | L F V J P H T;Z
M R V S J D O I | R M J I D V O;S
M X F H U N E D | M X F D N E H;U
I G J X U P K Y | X P Y I U G J;K
D T X M U C S O | M O X T C S U;D
Z D E R G X I S | S D X I Z R G;E
M Y H J I V F Q | J I Q H M F V;Y
U M O L G Q K J | Q L K U J G O;M
Q E M S N W G B | M S G Q E W N;B
G R C U I Z A J | I A C U J G R;Z
T J M I P G O E | M T J P E O G;I
Y X J S N I Q F | I Y X F J Q N;S
C Q L K Z A T S | Z K S T Q L C;A
N T D O G A I W | W N D G I O A;T
T A R F Y V W N | A W R N V T F;Y
Q K Y U E F A W | Q A W K E F U;Y
M Z G V N H W Y | G Y M Z H W N;V
K P A U F S Z C | C F S P U Z K;A
G C M F U T H J | F C U M J T G;H
A L D O S U M J | A M S O L U D;J
O I T A D L U W | W D T L A I U;O
U R M J E W B K | B W R M K U E;J
F W P B S H X Z | Z S X B W H P;F
C W P K F Q B H | H F P B W K Q;C
B Z M U H O X V | X M U H B V Z;O
J C U P E B K F | U K J F P B C;E
T C V S F I D A | I V A T C F D;S
F K U T S L J Y | U L J F T Y S;K
F X G O E S T D | X F O D E S G;T
G W A F J D M H | D H W G M A F;J
B F E G M Y A Q | F Y Q G E A B;M
C Y B N F G X H | Y N B G F H C;X
W X A E T V G N | N X A E V G W;T
V L H X Y W T C | C H X V L Y W;T
I O J W F V P Q | V J P F I W O;Q
X F O E V Y W C | W E X V O Y F;C
H K A O Q B I W | O B H A W Q K;I
E P S O N H J D | S D E O H P N;J
L P W J C S D V | L V P W C S J;D
R M E D K H X J | E X R D M K J;H
I A O C M N T X | C X A I O M N;T
S N U J W I L D | J W D I S L N;U
Z M S W X Q H R | X S M W H Q R;Z
J G C M S U L Y | G Y S J C M U;L
G S E B C A W Z | G A W C S Z B;E
B G C F O R A N | F G B A N R C;O
Y T F H V A S J | Y F V T S A J;H
W H Q K Y F N P | F P W H Q K N;Y
S V H Y F B U I | S Y H U I V B;F
D L M A J E Z S | D M Z S E L A;J
Z O S C E T U Q | E S U C O Q T;Z
G U E K F T O C | T G K U O E F;C
C D S P U F N E | N E S F C D U;P
X C U Y P B Q M | B M C P U Y X;Q
E Z Q J H O W Y | Z Q J E Y W O;H
N O P Q F S V K | K N V F Q P O;S
X F B A V I U Q | F Q A I U V X;B
D K A N M Y Z L | K Y L Z D M A;N
I X M J R H U D | I M H J D R U;X
N S E W L C I X | C N W E L I S;X
G Y J H R Q V D | Y D H V J Q R;G
H M A X Q U O V | U Q H M A X V;O
Z Y X N M K C S | C K X M N Z Y;S
R F O K I L W V | O R L F K W I;V
B A T U M N F O | N U M A O T B;F
P D Y Z N L E X | Z D E P X Y N;L
Z G J O D W L E | D O E G Z L J;W
O E Q H A U V B | B A V E Q O U;H
M O Z V E T U D | D T Z M O E U;V
F D E X W U H A | W H U X A D E;F
Z S I V G T B K | V I Z G K S B;T
M T Y O G B R K | B M K T R O Y;G
J U H S M O Y L | H Y L O S J M;U
H F V O Z K Y D | Y D H K V O Z;F
O H T L E V S K | E V O H T K S;L
G I Q W K O P M | Q I W K P M O;G
C J W E K G B T | B T J K W G E;C
N B I G L K M O | M L K O N I G;B
F R P Q C O Y G | R P O Q G Y C;F
E U M O P D G Q | Q P D M U O E;G
W E Y X G J O Q | G Q X E Y W O;J
O F P M W X S N | W F N M P O X;S
U Y W L J P A O | L Y A J O P W;U
L U T B A K Z V | U L Z T V K A;B
H E J F G A V M | H E G A J V M;F
U V C X E G T O | C U T X G V O;E
A K D T S L P I | K D T I A S P;L
C B A Q R I M S | R Q A C M B I;S
R K A H S P C B | P S H C B K R;A
E A V C R N I Y | E N Y R C I A;V
X N J I L Y W Z | W N Z Y J X I;L
G Q C F L M W B | G C F W B M Q;L
P K C I O G L U | I P G L K U C;O
H A D S G M U N | N U S G M D H;A
H A X J T L O S | S O L X H A J;T
T G W J X B R U | B X G T W R U;J
M P B O T D F Y | D F Y B P O T;M
D O K V Z Y B Q | V D Z B Y Q O;K
Z R M T G L S V | S G R L Z M V;T
D T F G N A W Z | N F A D Z G T;W
L D Z B F K P G | L D G Z P K F;B
O S G A X D L R | G A X L S O R;D
P Z O C J T M H | J O T Z M H P;C
P C Z Y Q I O L | Z Q Y I P O L;C
G S R X J H Q L | R Q S H G J L;X
P D F O B R S Y | S F D P Y R B;O
P V Q Z M T L J | Q J P V L Z T;M
E B F R O L Y H | Y R L F B O E;H
X Q P L Z K A H | X Z P K Q A H;L
Z M P H L T J U | L U T P J H Z;M
Z G I R V D B J | R J D Z B I V;G
N O M D U S Y X | Y D X S O U N;M
O G M E C U T W | M W O T C U G;E
I W Z J P U T K | T P I W J U K;Z
W K F J P C L M | C P J L F W M;K
R L D B V E P H | R D E V P H L;B
V J I A Y W Q Z | A W V Y Z I Q;J
W Q Y C O T P X | X Q Y P T O C;W
C S O E M A U Y | C A E S M O Y;U
P Q L C J T B G | L T Q B P G J;C
P U R T L B X Q | R U Q X B T P;L
D A G S Q O M N | S Q G O A M N;D
G S K L Z X Q F | L S K Z F Q G;X
C B T L O U P F | C F T U O P L;B
A Y W H V C I Z | Y C H V W Z A;I
A J L R Q X K B | K B A R X J Q;L
B O K H L N J U | L O N U B H J;K
B K D V T O X Q | Q K X B V D O;T
R Q C T Z L U B | R C Z Q T L B;U
V A H E T K D J | H D E K A J T;V
F W L Q R Z T C | Q W F L R C Z;T
E G M J S Y N B | G S Y E N M J;B
E C Z W I R F Y | Y Z C F W E I;R
U T E P H Z S L | E U P T S L H;Z
E B S T C Q V J | S C J E V Q B;T
H L Y W O M K B | H K W Y L B O;M
A R O F S Z E P | F S O E A P Z;R
F V L N G M D J | D F M N J G V;L
K C Z A G M U Y | M U A Z G Y K;C
Q Y V A L D X E | A Q E V Y X D;L
E B O G W Q Y I | B Y I Q E G O;W
C Y Q R J L V E | V E J R L Y Q;C
V G C J A O I Z | V Z O C A G J;I
P Y C E R M K N | N M P C R E Y;K
D S K E U J P Y | S D E K U J Y;P
Y W V B L R Z I | V I Z R L W Y;B
V C S F T A G B | T B V A C G F;S
A B L H M X J W | L B X W M H J;A
C A L U K O Y D | O C A L K D U;Y
F T W I G Y S V | S T F I G W Y;V
L C K Y A Q P M | Y Q K M P L A;C
Z T V P K N O Y | Y P O V N Z T;K
U P V X T F Y J | X J P T Y F U;V
J F N D L G S C | C L G D N J S;F
X O W I J S N E | W J O E I X S;N
B D I H M R Y A | D Y B A H I R;M
E S G O J X V U | S G J U E O X;V
O G L W R T J S | T W R S O J L;G
Y V F U J N P L | L F P J N Y V;U
M E S L U W R G | W M R G S U E;L
G C A T B E I S | T I S G B C E;A
L N M E U H B I | M I B E N H L;U
F V G E I T B H | I V H E F B G;T
M E A I N P V R | E R V N I P A;M
G F Z E B L W I | F E G L I W B;Z
M U A X Z W Y F | F Z X W M A U;Y
A D Z Y S T O P | T D Y O P Z S;A
M V I J Y W U Q | J I M Q U Y V;W
S L T H G R C K | L C H T K R S;G
H S G Y P W V T | P W H Y G V S;T
P Q V S M A H B | B M H S A P Q;V
E R C A D Q W J | Q W E A R C D;J
B F G P H K Z S | Z K S H B G F;P
E P S Z T F X C | X C P E Z F S;T
L F U M Y O A G | A L G U M Y F;O
I P W B M O G X | P W X I G B O;M
Z E J C G T X B | E G C X B T Z;J
T V X K G B N C | C N T V K X G;B
Y R V B H W G M | W Y G V H R M;B
A S J M Y G O B | B G J O Y A S;M
P Y R Q J H A C | R Y A J C H Q;P
M A Z V Y X T S | M Y Z A S T X;V
Z V R T K W N H | K N Z W H R T;V
D O B Y W K P V | B O W P K D Y;V
U Y D M X Z H P | M Z U Y P H X;D
T E B F V G C R | V B R E T F G;C
M R U E L C B W | U M E L R C W;B
M L G J Z H I B | Z J G H I L M;B
S E O M L Y A G | Y O M L S G E;A
R L V N Y M I Z | I N M V Z R L;Y
D M V J E O S Q | V Q D E O J M;S
H L S R X C M G | H L R G M C X;S
A V Q U D N J B | D Q V J N U A;B
E N K G P J M Z | P K E G Z M N;J
T P Q M S Z G K | P Z K M G S T;Q
L T C F D P G Q | P L D F C T G;Q
X K E N M J R Q | R E X K Q N J;M
N O B S E H U F | F B U O N H S;E
S T Z L N Y K Q | T Y K Q L S Z;N
E L P C O U T Q | U O C T L P Q;E
D K L J U V X T | K U L J X V T;D
T M N E X S H V | S E M T V H X;N
S T G U X B W P | B X G U S T P;W
O L I G M V A N | A M I V L N O;G
G H O Y X L A F | O G A L Y H X;F
T B F J I X S C | J F S C B T X;I
A L K I D G P Q | K Q D P G L A;I
H T F C J Z Y I | H Y J F I Z C;T
S Y E R N G X W | G X Y W E N R;S
V Y J U P X L M | L X Y U J P M;V
K B X W Y Z A U | W Y Z U A X B;K
C Z K R B W J D | K R D J W B Z;C
K V H C P W N T | T H N C W V P;K
M D X G E N C W | W D X G N M C;E
A O H V Q P K W | H A W O K V P;Q
C E D P F J R Q | R D J P Q E C;F
H X L R J Q P S | L X R Q J S P;H
Y A T L G H W I | I T H G Y A L;W
Y W N E J D P X | J E D W N X Y;P
H Z V J C Q G X | X Z Q V H C G;J
X C W Q Z K H A | X K Q A C H W;Z
V T N L I O F Z | I T N L O Z F;V
W Q I P N O Z D | O W I Z P D N;Q
J B U C Y F G V | U B V Y G C F;J
Z V E F R U C I | F C R V Z U E;I
A J U Z P K S H | U Z H P S J A;K
U H Z I B R D A | D H B A U R Z;I
D B J S W M E F | W E F S D B M;J
Q U N B J S H K | S B H N K U J;Q
B Q U Z H X I A | U H A I X Z B;Q
B D T Y N S W Q | Y D W T B S Q;N
V A W N Y S D E | D E N W Y A V;S
B P V J E W F R | E P J V R F W;B
L U A N I O P V | A L U P N O V;I
M S U O I E F J | F O S J I U M;E
E Q S P T N K G | S K P E N G Q;T
J I Q X E Z A U | E A Z U I X J;Q
E X V N T P B U | B U N T P E X;V
J Z G C H Y E W | Z W Y H G J E;C
W S O K G Q C Y | O Q Y G S K C;W
Q S I O R D L E | D O L Q I E R;S
H Y M Q L G O A | A G M L O Y H;Q
M A S O Q I C X | S Q I O X M C;A
O S R P H T C Q | T H R C Q O P;S
X B K H L D S M | X M D L H S K;B
E J A M T Y C Z | Z Y E A T J C;M
F Z O L W Y S U | Y W L O U Z S;F
W Y D M R Z N K | K Z R M D W N;Y
Q P F C X W B R | Q F R W P C B;X
Y E L I S U Q T | S E Q T I Y L;U
J S C Y A W Z R | Z Y C A W S R;J
F G X N H Z I U | N G F Z U I H;X
L J P M Y Q S F | J S P Y L Q F;M
K Q T F D Y S B | D Y Q F S K T;B
S Y T W N A U V | A T S V N Y W;U
D P H E K A B R | E D H B P A K;R
K Y J X N C W R | J R X W Y C N;K
S L J R Y X O Q | L J O Y Q X S;R
G Z I X N D A U | G I D Z A N U;X
Q Y P C H X S A | S Y H C A P Q;X
N L T H P F R G | T F G L H P N;R
Z O G D E W A J | G A E W Z D J;O
D Z T R C K M Y | D K T C Y M Z;R
H M A D W O V E | H V D O A E M;W
K U Y Z H X B E | H U K E Z X B;Y
M Z E C R D S G | Z E C G D M S;R
I K A Y P U S W | S W Y A P I K;U
V G D O U R H Z | R V U Z G H O;D
Z L E P H S K A | K E S A Z H L;P
E A V S T L P Y | Y T E S P A L;V
A D S F K B L J | L B J S D A F;K
N G I O L K W M | L O I K M G N;W
F W O T B H M K | F W T H O M K;B
U Q F K D Z C B | B U K D Z F Q;C
S L X M N A O I | S O X I A M L;N
R E I F H W G M | W I M F E H R;G
S N H A P R O D | P O S D R N A;H
X N W T A D J P | W D X A J P T;N
P I V A U F M B | U P V A F B M;I
H K B E D S T X | K B S D X H T;E
G T R H K X F O | R H F O X G T;K
I S L Q U G C Y | U L I Y S C G;Q
Z P C O R G J K | G C K Z O J R;P
D V T X U G H Y | D G U T H V X;Y
B Z U Q C D R Y | U B C D Y Q R;Z
X O R C N L A Q | L C X Q N O R;A
B W G X J A Q T | X G T W Q B A;J
X Q L C V P E Z | E L P Q Z V C;X
Y T V S D Z N J | D N S Z J V Y;T
E G C I M F Q Y | Q G Y E F M I;C
E L A J W G S F | A S W F E J G;L
X R V F A Q O U | V Q A U O F X;R
Y X I C B N H F | H I N C F X B;Y
Y N D P J F L C | D L J Y N F P;C
T X S B M G H C | B M T S G X H;C
Q D V M F Y J E | D E Q M J Y V;F
M Y T U E O F J | F T M E O J Y;U
J A P N T S E L | T A P J S E L;N
N D E R K T H F | R H E D F K N;T
X Z I P G S O Q | O P Q X G Z I;S
S D I E K B G Y | S D G K Y I E;B
Y F X A W I H O | F O X W A H Y;I
O I Q M Y A X W | X Y M Q A W I;O
C X D G S O M H | G H C X S M D;O
F C W H T Q Y S | H S W C T Q Y;F
G K W Z M N V B | B V Z K G N W;M
D F P H I Y Z O | H F O D P I Z;Y
O M I N F P B C | I C N P B O F;M
C E Z U F S K P | S F E Z K U P;C
N F Y T R V O P | V Y N T O F P;R
O U X H Q T S Y | Y X U T S Q H;O
N V S W F H M U | S N F W M V U;H
N H Z T I F X J | I J H Z T X N;F
C M N Z U J O D | N O D M Z C J;U
C H M K O N F T | N K H T C O M;F
S T B Y G P N Z | Z Y P N T B G;S
C N D Q Y G O K | N O Y D K C G;Q
A B S N V Y L J | B L N V A Y J;S
P U K C Z I R Q | C I U R Q P Z;K
E S P F J Y L H | S H J L F Y P;E
M B S K Q V J O | M S Q V J K O;B
K V B D Z C S Y | S C V Y B K D;Z
F Q O W I B N G | I G O W F B N;Q
R I T F C P O W | W R I C O T P;F
W Q A L R U O C | L R A C Q W O;U
B H C Q N J P T | Q B C N T H P;J
J B P Z D M U G | U J G P M B Z;D
X Z R W Y Q O D | Z O Q D X W Y;R
V F C P Q E J D | V C Q F D E J;P
C T B V N Z E X | C B E T Z N V;X
Z T J R K A X O | O K Z A X R J;T
M C A F B L X T | F A L T X B M;C
T U L X P A B J | U A T L P J B;X
P R H U X G E I | X G U H I E R;P
T W L S Y C Q I | Q L S C Y I T;W
P U X Q Z O D A | U Z Q A X P O;D
R Q L J E I N K | R N Q L J E I;K
Z T I Q O E D F | E T O Q Z F I;D
T F G Y V L B A | A V Y B G F L;T
T X G J P Z L W | Z J L P T X W;G
K M Q W D X O Z | W M K O Q D Z;X
K V O J D C U N | K D N J O V C;U
D T G A L I X R | I R G T A D X;L
Y A V H I B F P | Y A H V I B F;P
J O X B G L M F | M X B G J O L;F
N K A W C O Y D | C N Y K W A D;O
V T U A P J R O | J P O U R T V;A
N T Y R J H C L | R T N C J L H;Y
V I W L A U T P | L V T P I A W;U
A D R L W U I S | I R W S L U A;D
D T G L Q X B C | D C B T L X Q;G
Z S C M Q D X N | M N C D X Q S;Z
N E A J B I Y Q | J B Y I Q N E;A
U D B M W S K L | D W L U K M S;B
W P C X O H G F | X H G C W P F;O
U Z I Y T V X M | Y X U I V Z T;M
Z R J V Y H W X | V H Y Z W X J;R
S X D U K C O L | K C D O U X S;L
R B D M K U Q N | M B D K Q U R;N
Y G E V Z K F U | K E F U G Y V;Z
A M T F N S D R | N S T D F A R;M
E R U Z F N Y W | R Y U F N W Z;E
O Z C W M P F R | M F O Z C P R;W
T Y W J E H Z L | Y E L W T Z H;J
P U L Q B H N C | N H P U C L Q;B
U P K Y A W L V | K Y V W P U A;L
A G O L J M Y C | M L Y J C O G;A
Y P G M I R C A | Y R I C A P M;G
Z K E M L B A O | K Z L A E B O;M
T W O D M B J Z | D Z M J O W T;B
X Q U D V H N K | V D Q X N U K;H
W K Z A B M E L | L E A B M W Z;K
S W J Q B I C H | S W C B I Q J;H
M U V S P C W L | U P L V S C M;W
D A B Q K V T U | A K U B Q T D;V
U G R A V Z X Y | Y A U Z R G V;X
H I A C W U K D | W D A H C U I;K
O T D Z P V A J | T Z D A O V J;P
R A W B C Z V E | V Z R A C E W;B
W I B R E S T O | T S I O B E R;W
A D Z M Q S X F | Z X D Q M A F;S
Y B J S K N D U | N K S D J U B;Y
Y T J O W X K B | J Y X O T W K;B
F W N R U X H Y | X Y F U W R N;H
D K Y W O I C Q | C W D K O Y I;Q
T V A G X B Z U | U X B G V A T;Z
I B J F W S T L | S T W L F B I;J
D N P G S H U I | G I U H D N P;S
A T D X I P C O | I O A T C P D;X
F E C U Q N P S | E S N P Q F C;U
Y C J M N G W O | J C Y M G W O;N
M S O P K G Q A | G Q A K P O S;M
Z H U X O K L S | Z O S H L K U;X
J P H V R X G A | G P R X A V J;H
D U Q O T R I F | R T D U Q O F;I
U Z M O X G I V | O V I M Z X U;G
I T R E L N W S | N I R E T L W;S
E H W A L J Q T | W J E L T H Q;A
B F N Z W C D P | C D F W Z P N;B
O M N K R P D B | O M P B R N K;D
Q J B R C K L P | B Q R L J K C;P
Z Q O M G K A R | Z M R O Q K G;A
K S P D A X L Q | D S X Q P K L;A
D A F Y I J N U | N F A I D J Y;U
S I P X A L U W | W I S X U L P;A
G A I U C X W E | W C E A I X U;G
E X S L F D O C | F O D L X S C;E
D F Z P J V L R | F J V D Z P L;R
K Y P H E L Z O | E L P Z H K Y;O
O S B U V R D A | B O R U V A S;D
L E U Y I Q A T | Q T L Y U E I;A
R K O Z Q S W X | W K X S R Q Z;O
E Y G L O C W R | E L G C O R W;Y
O W D F R E C Z | W Z E C O D F;R
Z H M E L N A J | N Z H E A L M;J
F U V D I P C J | J V P U C D I;F
M W L U I V X H | H I L V M X U;W
J U V R I N S L | R U L S J V I;N
D U H R P Q K I | K I P R U Q D;H
K N V O R L Z Q | V L Z O N R Q;K
Z D M A Q B R Y | A Q Y B D M Z;R
J I C E M F H Y | E M C H F J I;Y
A V P I H J T Q | V Q P T H I A;J
D G P L W J R K | P G K L D W J;R
W P E V H G Z Y | H Z Y V G E W;P
Z H T Q B Y E F | B Q Y E F Z T;H
P V W B T I U G | T V I B G W U;P
W I D E H P K U | D P K U H I W;E
B P L Y D U C W | D L B W P U Y;C
Z T O X L E B R | X T E Z O B L;R
Y M S F A D Z U | Z S D A U Y M;F
G M S I R Y P V | I S P R G V Y;M
S J Q W R M U B | B Q R U J M W;S
O M Q J B F R S | R J M O Q B S;F
A X N G D V S E | N E D A X G V;S
S Y R P D E T U | U D P S E R T;Y
I H N F M K J D | J I F H K M N;D
S N O K H E Y W | E Y O H W N S;K
K J X B E Q L M | X K L M B E J;Q
Z B A J H E C K | Z B A E J K H;C
I Y D J N A C H | H A N Y D J I;C
Z O E H F G W Y | E Y Z W G O H;F
Y S J Z E M T G | E Y G Z S J M;T
Z V R F Y N Q M | M Y V F Z R N;Q
V H M E J X A W | A X E V H M J;W
J U A P S G H K | K H U A P G S;J
B M C T A H L U | C H U A T B L;M
R X I B E N U W | W R U X E I B;N
E U K Q J M T Z | M J K T Z U E;Q
J K X N E Q L V | Q E X J N V K;L
C I B H W F S Q | C S W H F I B;Q
M J P Z W A H L | Z M A H P W L;J
T B N M S U Z G | G M S Z N U B;T
W U M F S H T Q | S U W Q F H M;T
Z M L W N U I P | M I L W P Z N;U
N V W B Q A K T | A Q W N V B K;T
F A Z R P H G B | P R H A F Z B;G
T D R C O J N G | T G C O N J D;R
K H T P W F M V | W V H K F P M;T
S O W H G B K V | G W K B V O S;H
S B Q F G H J D | Q S B J D H G;F
D O R V Z I A Y | D I R Y Z A V;O
D U Z L O T B F | U F B T L D O;Z
W T L R I E O U | U O R W T E I;L
I S X H E N G D | H I S X E D G;N
K B P R V J H T | J B H V R T P;K
R J P A S Z U G | J R P A S U Z;G
I E S H Y J C O | J C E S O H Y;I
E D S W J M I G | M E G D I J S;W
R V M B L Q N C | B M N L V C Q;R
G T I M U E K O | O K E T U I G;M
Z O C A U N V M | U C A Z M N V;O
F J E U O D S Z | O D Z U J S F;E
R Y A E N U G H | H G E A Y U N;R
L T N F E R G K | R G F K T N L;E
Z O R B L K P M | L O R P Z K B;M
S B X D V A I Y | I B A D Y X S;V
G I R K Q J S M | J G I Q S R M;K
V W K O U L A X | X U W O A V K;L
K A B T W X Y G | A B T K G Y W;X
R K M Q H P N U | U Q N M H K R;P
J A S Q M I Y X | X A M I Y J Q;S
M H Q U C J T Y | H J Q Y M U T;C
F E D R Z L N O | L R N D E F O;Z
D S Q K Z G O L | Z L D O K Q S;G
W T Y R C M P S | S Y T W C P R;M
S G H V M D T Z | G S D M V H Z;T
E T C Q A G U B | C U T B A E G;Q
E Q A N V G B I | Q V G E I N B;A
Q K N M O S Y V | M Q Y N K S V;O
M V K Q Y F L S | Q V F M L S Y;K
U R H O D L I G | G O I H U L R;D
B K C S G M Y E | B G S C E K Y;M
H A W L C S N Y | A W Y N L H S;C
R D E X P C T V | T V R E P C D;X
H Q R J G Z U A | A U J G Q H R;Z
L K B R N O Z D | D L N R O B K;Z
Z S A L R Y K H | R S L Y H K A;Z
A V N M B G C P | N G M B P C V;A
Q K U M E A F X | A X M U F Q E;K
K W N J F R X T | R F W K N T X;J
T P I R B W U J | W P B T J R I;U
I H U T O G Z L | T G U Z L H I;O
D O K W V Z T C | V C D K O W Z;T
D N A R C M K Q | N M Q K A C R;D
N G D O M C V L | L D V G O C N;M
Y G S W T D L K | D S G L Y K T;W
I A H J S K O U | H S K J U A I;O
O V L X T P Y W | L P V Y W O X;T
X J R E M U Z D | D J U Z X M R;E
S L I J C P F R | P F I C S L J;R
N O U M Y Z B G | G O B N Z U M;Y
G M B P I F R Z | G R M P Z B I;F
Q R A C H Z P S | Q C S Z R P H;A
X G N R Z S I P | X G S N Z P I;R
F W P T U Q G J | J G W F T Q P;U
C B X D V P N K | N D P X K V C;B
S J M V Q R D L | M J Q S V L R;D
U W F G O E C D | F O U G D C W;E
Q B X Y D V E U | V D E Y X B U;Q
V O Z M G U Q W | Q Z W U G V M;O
I E L M G N R D | E I D M L R N;G
E N J D Y L Z W | J Y D E W Z N;L
Z V C T S X Y B | S B X T C Z Y;V
F M V B I Q R T | M R Q V F T B;I
K F E M T Z Y W | K T W Z Y F M;E
G K H W S R Y E | R Y H S W K G;E
T M Q I W H C N | M Q T I N H W;C
Q C V R D L H S | R S C Q D H V;L
A B D T U Q N L | T U D Q N L A;B
B H L P U Y O V | O P Y U B V L;H
R Z G X O B I P | O B X G Z P R;I
G N I Q E J D A | J G D N A Q E;I
L B K F X J C Q | B J F X Q L C;K
G F E W A Q U X | U E F X Q W A;G
D F X R Y O K Z | K O Y Z R X D;F
I Q G K R T D L | K T L Q G R I;D
P N V M F U Q O | U O Q P N F M;V
U B M W D L G Q | B G M Q W L U;D
D L Y B G E Z W | B E G Z W Y L;D
F T R V I P H S | I P V F R H S;T
M I W U P T C Y | T M I W U P C;Y
N O X G J H D S | N H S X O D G;J
I M Z Y R H Q S | Q R M Z Y S I;H
X Q E H Y J O K | O Q X J E K Y;H
D X H G F L W Y | W H F D G Y L;X
G S M Y V O J P | J Y O G P V S;M
Z U R H C I J O | I O C J Z R H;U
O I R H K N V C | H R I O V C N;K
V D G O B N J H | V G D B N O J;H
T X E P S Q F Z | X Q F S Z E T;P
U W I J V K D T | I D K T V U J;W
I J T R D M P B | B D P R T I J;M
N U B A W K L C | A B U C N W L;K
Q F J Z A I T W | A W I Z J Q T;F
L W N Y T M F V | Y T N L M V F;W
O Z A I E Y G D | D E O A Z Y I;G
X G M P Z Y V I | I P X G V Z M;Y
H Y F U D X L B | B X F D Y H L;U
C J D O T H I P | J C T P I D O;H
N T W V Z O X P | V Z X O N T P;W
X M E N I H V K | X M H V E K N;I
M P X R Y H U Z | X U H Z M Y P;R
U R M I F Q S A | F M A S I R U;Q
H N A J G S U F | G J N H U S F;A
D Q O V C Y U B | C V Q Y B O U;D
J Z Q L B X H M | M H B X J L Z;Q
K J O A F R X Q | Q J F R A K X;O
T A P U V O S I | U V T I S P A;O
G T M W P O X Y | G W P Y O T X;M
X U T V G Y Q W | W V Y X T U Q;G
D E I L R F K J | F E D L J I K;R
R P H E J N F L | H N E J R F P;L
Q O I W U S G D | W Q D I O G U;S
M X F L K T O H | M K X T F L H;O
A S Z F U R O B | A O B Z S U F;R
Q D C A R H O M | M C Q D A O R;H
Z O S E J C V I | S Z E J O C V;I
R H V E N Y Q I | H V Y R N Q I;E
B N W X Y G J V | N G Y B J X W;V
G W Z R C H D I | I Z W G H R C;D
E M F C T G D J | M F G J D T E;C
A C F Y U Z J L | L C A Y J U Z;F
D O K S W R T Z | K S W Z R D O;T
V C G I A N R L | L R I V A N G;C
A M R V P W F E | R P M F A V E;W
U D G X W L M S | D U W M L S G;X
W R U O M V G C | G R M O C V W;U
Z L D Q K S H X | H D S X K Q Z;L
Z N R M D I K P | K Z D N M P I;R
W A N B J K H F | K F J W A N H;B
W M P U N C I E | E C I W M U N;P
Q M R K S P T F | Q S K P R F M;T
G A O Z H W V N | V W G O H A Z;N
V M Y G J T H E | G V E J M H Y;T
R C V H B G L K | V G C L R K H;B
J D R P Q G U O | G J U Q P D R;O
I H A T P X K W | W A K X I H T;P
W X I E N D U S | W E D N S U X;I
N Y D P M H Z O | M P Z N Y H D;O
D L I W C H R O | I C D R H W O;L
G W J D N B R E | N G E D J W R;B
H O W M E P U F | F M O U P W H;E
M P H F N K E Y | N K Y P M H E;F
N O S L M V J H | H J M L O N V;S
T X Q P J Y V H | Q V H P T J Y;X
Z R G E H X A B | Z A G E X R B;H
M F P V C I O B | I P B C M V F;O
G K D M Z L S U | L D K M G S Z;U
W J F H N D Z U | J F Z D U W H;N
I B Y D O C H X | C I D O B H X;Y
Q J T D K N F W | D J T K F W Q;N
R L B M Z U T Q | L T M U B Q R;Z
C B X N M G L V | B X M L G V N;C
D O Z G P J L Y | J P L D O Y Z;G
X K Y G H O D A | G D A O H X K;Y
N A W K C Z Q F | N C K F A Z Q;W
K E D Y N I B Z | Y Z E D I K B;N
B Y I T E H J F | B I T H J Y F;E
R O Z T Y M Q F | Q O F M Z Y R;T
K C Q B X W D T | X D K B C T Q;W
M Y P L I B Q F | P F Y L I Q B;M
H A B E O S C U | A O S E U B C;H
J D Z S N M I L | S L I D J Z N;M
U J W R F Z G N | W U N R Z G J;F
Y S N E G M T X | S G N Y T M E;X
K E M A H W F D | K F H W M D A;E
B P A Q X W R M | Q X R B A W P;M
M Q K C B X N J | M N J X B C K;Q
S Z U Y N X V P | U V P Y N Z S;X
B Q V L S N M U | N V U S M B Q;L
O V P M Q U N S | V O U N M S Q;P
I M P O F W X S | X P W S O I M;F
Z I D L M G X B | X D I L M B Z;G
R N J E F W Y X | W X F Y J R E;N
W S X N T Z C J | T J S X N Z C;W
Q K C B S A M Y | Y C A K S Q M;B
X Z G A T H L W | W A X Z T G L;H
Y I H B P U D E | D P I Y E H B;U
B M T S D R A O | A D S O T B M;R
X O M R Q E F G | E R G M X O F;Q
A M B F K T L O | T K O A L M B;F
L Q C K R X B Z | C R L X Z Q B;K
K T H C P E U L | T C H E L P U;K
K Z H Y O W C I | I K H W O C Z;Y
W O G B H V Z S | Z B V O S G H;W
V L W I R C T Z | L I C T W Z R;V
P A Q F G B H W | F Q W P G H B;A
F N K M P A I O | N K I O P F M;A
A I T F U N J V | N I F J T A V;U
E P T U Z M K Y | M Z K U P T E;Y
K E I U L P Q C | L P E C U I Q;K
B M H S J G Y U | B Y M S U G H;J
A R X Z I C N U | U N C A R Z I;X
X I B Q C W T R | R W X Q T I B;C
X Z V G M U E O | U Z G V E M O;X
H R G I S O D E | R E S I D H O;G
H K T A E Q I P | H T P K I A Q;E
X C Y T F L J N | L N T C J F X;Y
K J N E G T C U | C N T J E U G;K
E J K I T H U L | J I U E L K H;T
M G S Q B H X T | X M T B G Q H;S
E P B Y W F N K | W N E P F K Y;B
A N V G C P J K | J N A C G V K;P
B Q P D Z T L C | L C Q Z B P T;D
C A P V B J N G | C V G P A N B;J
O G D C B P J E | B C G O P D J;E
T A Y S N P L W | N L W P T Y A;S
X B J Q I L P E | Q B P X I J L;E
M K O B V S I G | V O I B M G K;S
E G L Q K C V B | B V Q E L G C;K
U F E I D K A X | I X E A D F U;K
I L J A G E D H | J D L I E G A;H
T P X H E K Z F | X K P Z H E T;F
S Q Z R P N V X | R V N Z S P X;Q
C U O W I B A G | A B I U W C G;O
Y H L G I S J D | I D S H J Y G;L
T S E H Q C W R | W H T E S Q C;R
W P L R F Q H B | Q R P W F H L;B
I Z D W S P O A | I Z P S A O D;W
C Q O J D L W G | D C Q J L G W;O
X P M T D N H B | T H D B N M P;X
V L T Y E K Q G | T E G K V Y Q;L
U V K W C J H E | K E J C W V U;H
E I W S P A L K | I E S L A W P;K
M S J F N E K Q | F E S M J K N;Q
K M B N W R L T | W L M R T B K;N
E U D P R C V Y | P E Y V C D R;U
D X S M K E P H | K M S P E H D;X
V J Z U G M A W | J Z V A U G W;M
A B C F Z E J Y | Y Z E A F B C;J
X N V H B G K L | L N H G B X K;V
R N W A Q H X U | U N W R A X H;Q
H D I M Q V S B | H Q V S D M B;I
K O W I D N T V | D O V K N I T;W
N J D B K F M H | J F K M N B H;D
D Y B M S H P L | S B H L Y D P;M
T F Y G L K E H | K Y L G F H E;T
P B I Y J S W D | Y D J B P S W;I
I D F B T E A P | T D P E A B I;F
D C E V J O N H | J H E C D N O;V
A D V N C W H Q | N D A H Q W V;C
E H V F M K N O | M E O K F H N;V
E B N U I V G Z | G B Z E V N U;I
U P L R I O Y E | I P E U L Y R;O
Q U Y S X N Z D | Z N D U Q X S;Y
O E G R L Z Y X | L O E Y R Z X;G
J T C P E R F V | P T F V R E C;J
N A L F W Q U B | B N L F W U A;Q
S A F J K Q D B | A K S J F Q D;B
R L K Y A Q U J | A R Q U Y L K;J
G U N E J T C F | T C N E U G J;F
S R N D F W O A | R D O N S F W;A
V X U Y Q G R I | G V X R U Y Q;I
W Z P U E A F L | F P A W U Z E;L
Z X Y T V N O K | N X O K Y Z T;V
F C S J Q P E K | C P S Q E F J;K
D H O V A T W S | D W V A S O H;T
K S H R A W P D | W A P R K H S;D
E D F G N U V I | I G V F E D U;N
P D G W H I U R | P R D W U H G;I
Q U E J M G T B | M J E T B U G;Q
C Z Y K S J U O | Y K C U J O S;Z
P L X C M H S Z | P L X M H C Z;S
H R K L O P J W | R L K J W O H;P
O K Y T R I U W | T K R I W O U;Y
X I J Q Z S M D | S D I Z Q M X;J
O R D A Q Z U B | O Z R D U B A;Q
P J C G L N E I | E I P G C J N;L
K T D H M U V G | M K H G U D V;T
K O P A X Q L M | L X M K Q A O;P
H V P J I A X Z | A H P V I J X;Z
J K E Y P Q W X | E P W Y J X Q;K
Q F R O Z Y N C | Z Y F C O R N;Q
G B S T A M U J | T M G S U J B;A
Y L G F K Q M O | G L Q K O M Y;F
T P D N L M G X | P D N X G L M;T
R Q N O T J L S | T O N Q S L J;R
P S O X E D F V | F E X P D V S;O
X P Z B Q Y M K | B Q K Z P M Y;X
L R Y A Q D U V | V R Y A L Q D;U
P Q V J R E H W | E P W R V H J;Q
A H S C K W P Q | W S A K C Q H;P
A H K N F I L V | L H I N V A K;F
K Q R H T Y C X | T Q K R C X Y;H
Z N H G D T Y I | N I T Z G D Y;H
V Q M H I D G X | V X M Q H G I;D
Z Y G S Q B W N | Z W N B G S Q;Y
G W Q S U C P A | S A Q P U W G;C
F M C Z Q W D N | M W C Q N Z D;F
B Z J I Q V X C | B V I Z X C Q;J
Q X Z T K Y I C | I X Y K Q T Z;C
F R S A I Z E T | F T Z E A I R;S
B K U Z P Y I J | J B P K U Y Z;I
E A S M G N I R | A N E R M G S;I
Y T F P K C U X | U K C Y T F X;P
W H F I G Y K T | F Y G H T K W;I
T O J P B Q F C | F B O Q C P J;T
U M B H S A G V | H B A V M S G;U
U E M G N X T P | E M P X U N T;G
U Z C K O Y Q J | Y C Z Q J K O;U
L C O X R B E A | O A C R X B L;E
X C J B P E L K | L J B C K X P;E
E J V L R S M I | V R J L M E I;S
C G T F L K E Q | F C G K Q T L;E
W Q F C V T P M | P T F Q C V W;M
U G C W P I K H | K U C W I P H;G
R P L D Z W Q F | L F Q R P D Z;W
O L K D X Q I U | I Q K U X D O;L
E N J T M G R W | T N M W R G E;J
V B L S R U M Z | U R Z M S B L;V
X E F D W K N S | W S N K D X F;E
L P A W E T F S | L F E P A S T;W
V E I B U K A W | K U I E V A W;B
E B R I D Z K U | D U R E K B I;Z
T N P B I Y S U | T P I U B Y N;S
X M O J K C S I | X J M O C I S;K
Y Q C B V A P G | P A V G Q B C;Y
O E I D X K Q B | E X O Q K B D;I
S N M G H A Q E | H E A M S N Q;G
O E M X A G T R | M O R X G T A;E
D R O E N F Q G | E O N G F Q D;R
X J C R S I W G | X J I C S G W;R
C W O A I V N R | C W R V N I O;A
S M O E P R F U | R M U F E S P;O
Y U O X Z J F I | O I Y F J X Z;U
Y G J B X H U Q | J B G X U Q H;Y
H Y E A K B P U | E K H U A B Y;P
A C S F D O G L | L F C A D S G;O
F B P L I Y U X | P Y I B L X U;F
M Q O K I H E X | M Q I K E O X;H
M K H J O F A Z | A Z M H O J K;F
B G A R U Z N M | B R N M G U A;Z
E M P T V I F Y | M T F Y I V E;P
Z C H A N D B G | A C N Z B H D;G
U Q I P C J Y S | P J Y I S Q C;U
C H U I Y T K R | Y H C R K I T;U
B G P F W H A J | J B A F G P H;W
C U P N Q Y S B | Y C B N U P Q;S
O B D X E G V P | P O X V E G B;D
T P O I W B F J | J W F B T O I;P
K Q C S G L V J | K G V J S Q L;C
J O H F P T C X | H X C T J O P;F
Y Q A R F H C B | A H F R Q Y B;C
E C S Y D F I Z | C S E I F D Z;Y
J S F G W D E L | E L D J W S F;G
O U P X F M D S | F O S U P X D;M
Y S C J K L H V | H Y V S K L J;C
Y X E Q H U G F | E F Q X Y U H;G
V J K B N E S H | J E B S H K N;V
E Y K O J P T H | O P E K H Y T;J
T K I J P D W X | D J T K P I W;X
G X J M T O C H | C O X J T G H;M
W M Q H A V O R | O Q M W A V R;H
A N Q I K P U V | K U I N Q P A;V
N Z A I T D S G | S D I G T N Z;A
K D I V H T Y P | K I P T H Y D;V
Q J R I S F M X | S J X R Q M F;I
L N D O S V R M | N S M V D O L;R
W K G U P I X Y | G K Y W P I U;X
U P Z R X T Y J | T R P Z X Y J;U
H O V B S P J A | J O B H S P A;V
U J M Y O R Q P | R Y J P O M Q;U
T K C D O R Z F | O F D K C T Z;R
Z Y R D L Q A J | Z R A Y L J Q;D
L N F B A V I S | N S V F A B L;I
P H K F X L V U | K V X U L P H;F
O R H M Q P C L | O P M L Q H R;C
O R K L N P S W | L P N R W O K;S
S N P J B Q Y W | J S B Y W P Q;N
E A S Z N U X V | S A U X Z N V;E
F L T X R N M Z | L X R N M T F;Z
Z P L X D S F B | D B S L X P F;Z
H I Q X W A C V | C A W I V Q X;H
V N H U F Y E P | F N Y H E P U;V
I O E D B T F A | I D T B F A O;E
O Y B W A J K H | Y O H K A J B;W
G C T M J D A E | D C A G T M E;J
C A J N R W F I | F I C A N R J;W
W Z Q D E S B N | Q W E B D Z S;N
U S F X E K T D | S X K F T E D;U
D M T I G B L Y | B Y I M D G T;L
C J Z Y R M K A | C K Z A R M Y;J
D R Q A T O C M | R O M A C T Q;D
Z G V H A O C W | C H V O Z A G;W
C S P Q L T W I | L I W C P Q T;S
H G R J Y L O K | L O G J H K R;Y
H N X R K O I A | R K I O A H N;X
E A V J U L M G | E L J U G A M;V
A T L Z U C B J | B J T L A U Z;C
W Z V D Y X C N | X W D Z Y N C;V
G U W I L R H D | R G U I H D W;L
E V Z B Y G X A | A Y X E G Z V;B
L D A R B J F T | F T R L A D J;B
W O P I Q H S L | H P O I L S W;Q
Z Q H K R M V T | K M Q Z R H V;T
B T H S V O F L | O V L S H T B;F
H A W P U R B X | H X A B U R P;W
G I W L X S Z D | Z W S X I D L;G
T N F G W J Q K | Q J W N F G K;T
J P Y D U M H X | X M Y H U P J;D
R F M H G J K S | H S J F G M K;R
F K P Z I Y J H | I Z H P Y F K;J
U R G T V I D L | T V D L I R U;G
L Y W B V P F N | B Y F V P N W;L
E A S X J C B H | J C H E A B S;X
H S M E Z R Y N | M S E N Z H R;Y
W L F O X U M S | F M W L O U X;S
O P U H Z J V E | V J E H U O Z;P
W Z Q G U X H V | Z V X G Q U W;H
S A U Y M P R B | R B A P M U S;Y
R P Y Q F O C T | T Q C Y R O F;P
I D X S E U Y A | Y A I X D U S;E
E H B X U M W Q | W U H Q X B M;E
Q N C W J T A S | S A Q C W N J;T
P I S Y F Z Q J | S J Y I Z Q F;P
E V X F W D S I | E S F V X I W;D
P U V T I J G W | J V I W P U T;G
F M U X Q I W Z | U X W Q M F I;Z
V E F G A O Q I | G O F A I V Q;E
N F C M E J U S | U M J E N F S;C
B A Y E W F J Z | Z W A Y E F J;B
C P E F Q T V M | Q E F M C T P;V
B F C G O P X V | X B V O G P C;F
W H L N Z V Y E | H Z N Y L V E;W
I F E Q V O A J | A J V I F O E;Q
S X Z H N U D F | Z X D N F S U;H
W O G Q S R Y N | R Q O G W N S;Y
Q F Z N T X S A | F Z T A Q N X;S
B U E N Q Z I F | N Q Z F E I B;U
H T V Q A E Z J | A V H Q J Z T;E
X B K V C W J H | W V J B H K C;X
G J Y Q N R B P | B Y J P N Q G;R
F V E Q R C K I | C V F E I R K;Q
C D G Q O H X F | H O G C D X F;Q
I G T D R A M J | A M R J D I T;G
U A N D S W M X | A N X S W M D;U
I K R M P A N D | R D M P N A I;K
Q R V N L D I Y | Y D L N Q I V;R
I E N S O G B Y | B I Y S G N E;O
Q D K R W M B Y | M Y B K W R D;Q
I Z G X D F U Y | U X F I Y G D;Z
B E X V P Z C Q | E Q V C X B P;Z
Y T J N O A H X | X J A Y T H N;O
X I H D E A O Q | H X I E O A Q;D
E D Z S Y F B G | F D Y E B S Z;G
A L Y D J R W S | J Y S L W D A;R
Q D M J R K B S | S D M Q R K J;B
N H L R G Z P S | H P Z S N L G;R
E F X G B Z A K | A E Z F K X G;B
A J W E K O V U | O W A V J U E;K
M I C L E N A V | I L M C A N E;V
V G A U R I E B | G B A V I E R;U
K Z G T V X S Q | X Z K T G V Q;S
A Q U J B C H S | C B Q U H S J;A
R H L Z U C S E | L E R S Z U C;H
E G K O W Z U R | U G E R O W Z;K
U T W X E V F C | C X V T F U W;E
X Q M Y A F J C | M Q J C F X A;Y
W H N S K T P R | K P R S W H T;N
V G Q A D F U I | Q I F A V G U;D
Q Y T K J D U P | K P D Y U T Q;J
B J U V W S C M | B S U J C W M;V
A R O D B V Y W | R B Y W O D V;A
G Q R H X Y U N | G X Q H R U N;Y
Y B F I W N L A | N W F I B L A;Y
W J Z H K S E L | K H E Z J W L;S
U L M V S F N D | M F L S U N V;D
J W D Y L V Z X | X Y W L J D V;Z
D Z Q E X B K I | Q X K B E D I;Z
B L X F J Q Z I | J Q L X Z F I;B
P N O J C Z V R | Z N O C P R J;V
Y A P F L D S J | L Y J S F A D;P
L J U E Z W D O | L U D E O J W;Z
Y C L B A J X N | C X A N J Y L;B
Q D V W F G O U | W F U O D G V;Q
U H D V A J I B | A U H V B I D;J
R F L Y P K A O | K O L R Y A F;P
P D R F O Y K C | Y C R O D F K;P
C W H M J R A K | A J W C K H M;R
A K L M C U X W | L U X A W K M;C
R K T Z P I D M | K I Z D R P M;T
G J W T Q L Y M | W Y T L M Q J;G
F I D O Y E P H | D O E H I P Y;F
V A U Y B T E O | V O T B U E A;Y
P Q H F S G W A | G W P H S Q F;A
I D E V K C S U | E I V C S U D;K
M C T J Q R S W | W Q T C J R M;S
P Z C H F V I M | F P C H I Z M;V
E Y W B S Z L H | H B W Z S L E;Y
H T D E U V C N | E V U H C N T;D
F C L K W B I R | F W K L B R C;I
F G H D A T J S | T D H A J G F;S
O U R L F I J Y | U J O Y I L F;R
X E F O I Y H B | H E I X O Y F;B
R J G K A T F V | K A V R F T G;J
J Z X B D Y A P | B J P X Z A D;Y
P B H F N U Z D | D F B U H P N;Z
W Y A R S E N Z | A Z W R E Y N;S
J N A L O W Z B | N J B W A Z O;L
Z A H I F P C E | F Z H A I P C;E
Z J Q K G H N U | Z G Q K U H N;J
R V Q A X F N Y | N X F A R Q Y;V
G W Z P D E F M | G W P F E Z D;M
B I X U D F S J | X I B J D S U;F
M I Q J B H Z R | Z J M Q I R H;B
O J P Y M D R K | J D Y K O P M;R
R D O B W U T N | W D T N B O U;R
J I B G P F E C | G I B E P F J;C
V N C P W E R J | N C P E W R J;V
F U Y M H N P I | Y F M N U I P;H
N Z E Q F D R H | F Z N D E R Q;H
S Y J V N U K E | N Y U S E V K;J
L S W E J G K R | W R S G K L J;E
F N J P Y K I A | J N F I P A K;Y
U Y L C T W H A | C U H L W Y A;T
G D N K O A W H | G A N W D K H;O
J Q C Z P F G X | Z J P C F X Q;G
M I T F J B R Q | J F B M R I Q;T
N G F H E Y M K | M G Y K E H F;N
Q Y R K A N H P | R A P Y N Q K;H
S Z B D P F W C | D Z B F S W P;C
E J S C D H G B | B S E G J C D;H
R A P Q N C E L | N C P R L A Q;E
G D M W H Q A C | G M H W A C D;Q
U K Y Z F M N V | F Y M K V Z U;N
Z M E W K R I G | E M Z I G K R;W
A R G F M C P X | M X F A P C R;G
J O I M Q U H F | O H I M U Q F;J
X E K B C D T L | E B X K C D T;L
E I P V N M Y R | N V M P R E I;Y
C M Q J S V H P | P C Q V H S J;M
Y L O B K S Z D | L B Y O D S Z;K
E P B K H Z I J | Z P H B K E J;I
Z M Y A L U E K | A Z E K U M L;Y
K V T N A L I O | T V L N I O A;K
O T G F M X V A | O A F G M X T;V
B G N H Y T X L | X N L Y H B G;T
A J S Q R Z H V | V Z R S Q A J;H
Q E J R A G X L | G Q R L E J X;A
P F A O K W H U | P H O W A U F;K
U E N C K R Z G | G E K R C N Z;U
E Y I T V S W F | W Y F V E I S;T
S O W V Z E T H | W E S H Z O T;V
W Z M H V B R J | J Z B R V H W;M
A Q V I L R O Y | V L I O A R Q;Y
W A H K L G D Z | A L Z H W G D;K
Q V L N B C W S | B N V S L Q C;W
F A B O J H Y N | J Y A F H B N;O
K W Q V Y B J D | B Q Y J W K V;D
R A Y N I M C J | I J R C N Y M;A
F H C L O J A P | C H A L J P O;F
Y J Z F C H A O | Y Z A O F J C;H
N I E R C L G X | C R X L G E N;I
G R N B F A U D | G D R F N A U;B
Y J L H U B V D | D J V B U L H;Y
L J B H C O U V | U V O J B L H;C
G U I L C R M Y | M I L Y G R C;U
M Q Z K R U S D | R Z D U S K Q;M
C G L N H T E F | F L N H G C E;T
W K I B F S T H | I K T B S H W;F
N K W G A R S C | S A C K R W G;N
G W C P Y L B V | V C P W B Y L;G
M T W G A O I Z | O W T G A I M;Z
I Y H O T X R K | X T Y R K O H;I
C D B Z H F I M | C H I B F D M;Z
X D G Z A Q N W | G Q Z W N X D;A
H Z F L N A X P | L F N A Z P H;X
E R J Y T D B A | D R T B A Y J;E
X O Q K I E U R | Q E O K X I U;R
Y M R W A L B Z | A L Z R B Y W;M
P G R N V K W I | R G W V P N K;I
A G Q X C P Z D | Q Z C G A P D;X
H O Y L Z R D E | E O R L H D Z;Y
S P R E J X F L | L X S J R F P;E
V F A E P W U C | A E W F U P V;C
M Z X I Y W K J | Y M Z K X I J;W
M I U E R S H Y | H E R S Y U I;M
G I J P M K A Y | J M G Y A K P;I
B Q R N D H T V | T D N V B R H;Q
R L W P G O Z Y | R O Z G W L P;Y
S B J I H F V C | S V I B F H C;J
Z D K F P L Q N | L F N P Q Z K;D
P A Q Z F U V I | U Z V P F I A;Q
M J H Z A I U O | J A M H I U O;Z
W Q O B X K H M | B W H M K O X;Q
T E R F H P A G | F T A G P H E;R
R V B O D W J C | W J D R B C V;O
P I X E R N A M | P N I A R X M;E
U W L Q K F D X | U D K Q W F X;L
T Z S P Y J D V | J Z D V T P Y;S
I S H Q J K O A | A H S Q I O K;J
G U Q F Z M S W | W Z Q M U G S;F
T Q K S A Y E Z | Q T K A E S Y;Z
Z I R P H Q T J | I T Z Q J H R;P
B Q L C F N X G | F L N C Q G B;X
O R A W K U C L | C W L R K U A;O
G J W D Y B X I | W G X Y B I D;J
M T G F U L V K | M K T F L U V;G
X H M N W E S O | S M O H W E N;X
Y T K F Q X G D | G D T X Q K Y;F
Z F N L B A H J | J N H A F Z L;B
T I W K X P J N | K W N X T J I;P
X Q I G E K P R | R K E G X I P;Q
L M P D R B Z S | M D S R L B Z;P
T M N H Z I A L | A L T H N I M;Z
N C Q I A M D Y | M Y I N Q C D;A
T S G O Q J D L | J T Q O L G D;S
I O W P E N U C | C E P W U I N;O
B L X N H T G D | L X H B T D N;G
W Z E B Y R Q I | Q Y B R E W Z;I
Y T V O L A H P | Y L A H V P T;O
F P T D B G J Z | Z F D B P J G;T
X U G E O D S L | L X S E U O D;G
T S B P C M X I | T X C P B S I;M
P F K X H Q O V | O V H P K F X;Q
N L M Z A W C B | N M B L A W C;Z
Z J G I P Y N F | J Y I N P F G;Z
T S I G D E Q F | E Q S I D G F;T
C R Y P D M E A | C A Y P M R E;D
V P J U D X W T | J P W X V U D;T
Q A E O J C R G | C J O Q G A R;E
H F L Z U W X B | L W H F X U B;Z
W D Q H T N O Y | N O W Y Q H D;T
O N Z S C A W F | S C O F N A W;Z
I B V Z Q E O A | O E B A I Q V;Z
R V M A L T G O | L G A R V M O;T
O K E R B P S I | P O B I R S E;K
E N V O Y W T U | O V Y W N U T;E
J N Y W Q B E P | W E Y Q P J N;B
Z T O H E N F X | X H E Z O T F;N
M C T V I U Z H | H T U C M I Z;V
D K P G L I S U | S P D I G L K;U
O Q R P U M Y I | M R Y U Q P I;O
K Z V T B Q R O | K T V Z B R O;Q
Y J O G P N B R | N O Y B G R P;J
W O B E G M Q U | O G B W U E Q;M
O R Q M I Y S A | S I Q O M Y A;R
T Q M F W G B P | M G Q P T W B;F
N J B H F Y L M | L J F Y H M N;B
I B S R D Z L A | L R D Z I A B;S
G W Z M K A N C | W M A N C G K;Z
J F Z U E R B X | R Z E B X J F;U
E D B N L F G O | B L F G D E N;O
R F S Q W H K I | S K R I W H F;Q
T K Z C L I B W | W L K Z C I T;B
M J G E W T D P | M E J G W P D;T
W A D J O L N T | D L O A N T J;W
Z S A X M Y K J | A K Y J S M Z;X
R E J D B U A V | R D V B A J E;U
G S N H T W M Q | T N W Q M H G;S
L V S I N Y D A | N D S V A Y I;L
S C Y B R G J L | S L J G R Y C;B
P F V S J B H G | V J G P H S B;F
Y Q V B O X C D | D X Q Y V B O;C
A M J D U K X F | J X U M D K F;A
N U J I T Z C L | C Z N J L I U;T
D S G N E C B V | N S B D C V E;G
Z G A N H K W Q | H W A G K Q Z;N
P M I O D Q F L | O I P F Q M L;D
E B U S D F T G | E D S U G B F;T
N O V F I W U B | V U I W F B N;O
J I Q Y F T B W | W B J F Y Q I;T
P I T O C J L M | P M C T I J O;L
L R V G Z Q S Y | Q R L G Z S V;Y
E G I T H N U M | U T I H E M G;N
U E J L O I Y S | J S Y L U E O;I
Z J R D W T S L | Z T W S D R J;L
P W D A E U C Z | A P W D U Z C;E
B M N H T W O E | W H M T N O B;E
S G C E V K Z B | B S Z G C V E;K
P R T N Q J B F | T B P N Q R F;J
I L Z H N S C B | I H S Z C B N;L
Y M Q S U N P D | P N Q S D Y M;U
O T Y L E Q F N | E F O T L N Q;Y
I Z B H U X R S | R I H S Z X U;B
X S Z A L Y U F | X A Z F S Y L;U
Q H F A G D R V | F G H A Q V D;R
D C V W M O Y E | E M C D V W Y;O
F Y A N V X W T | T A Y V W X F;N
F H P N Q D W Y | N F Y H Q P D;W
H B L D A X G M | A M X L B D H;G
I P D T E G W V | D I E G T V P;W
Y Q K X W E P D | Y E K P X Q D;W
P Z L U W X T S | L T X U Z W P;S
T B L U Z S A K | A K S T L Z U;B
K L F D E S G P | S E D L P G F;K
I C T R P D V A | I P T A V R C;D
T W B D G J I H | T G B H W J I;D
F I J B M P W H | B F J M W I P;H
O U K F G S P X | K P O G S F U;X
U V F L R S A O | A V U O S L F;R
J N K X P F A I | I K P N F X J;A
T X O B L Y D F | O F Y D T X L;B
H G Z A D U O V | V D U O Z A H;G
Y A X J E Q O V | V Y E J A Q O;X
W N A I Z U G Q | A G W Q U N I;Z
E A P X J W S O | S P A W X J E;O
M J S P I Z D H | S P M Z I H J;D
R B G V W F U L | R U F G L W B;V
P N J Q D A Z R | Z A J R P Q D;N
Y L V F E Q B C | E V Y C B F Q;L
A X U L G P V T | P A T L U G X;V
R D B L N Y O P | B R O N Y P D;L
K X V Y A G J H | H V A K J X Y;G
L G S V Y P Z D | S P V L D Y Z;G
W X U M N F B L | N L X B M U F;W
G O I W J T X U | J O W I X G T;U
J B C W M P S A | W S P A C J M;B
E D V M B U H Y | U M V H Y B E;D
Y C Q Z G U O J | C U Y O J Z G;Q
O Q T E D W M B | B W T M D Q O;E
R O Q J T Y X B | O B T X Q J Y;R
C F S W O T J Y | C J W S T Y O;F
Z W K B M F L U | W L K B Z U M;F
M V X S K I G J | X M I V S K G;J
T Q A B D N W L | Q W A N T L D;B
Q A I L N B S T | Q N T B S I A;L
Q G V K U M E T | E Q M K V U G;T
M U L B Y V W D | B D U V M W L;Y
I H N M W A G P | W A H N M I P;G
B C E A T O Y H | O A C H B E T;Y
Q Y B U X F C J | U B Q F Y X C;J
J T C A I G L O | G L I O A T J;C
D N Y F S B Q J | S Y J F Q B D;N
A Y J B M S X F | M Y S J B X F;A
Y T X W D Q S G | W X Q D S T G;Y
R C P I H W J F | I J F R W P C;H
Q H K A M W P D | D K H P A M W;Q
Y V U F T G R I | I R V U G T F;Y
R W T I H J C Z | H I W T C J R;Z
E K D S R T A L | R D L T A K E;S
S N L F V R K U | U N F R S K L;V
Z G J H P I M Q | H M I G Z Q J;P
R K P V H I W J | V H K I P J W;R
Y U O G E P S B | U Y P S E O G;B
U B I E P K W O | I E B O P W U;K
X D G T L C Y O | D Y O L T G X;C
V O W H F I C D | H D C W I F V;O
O C J P S L E A | S J C E A P L;O
F W V Y J R L M | J F W L M V Y;R
L G P W Q E S A | Q P G W L E S;A
G P H O M K S D | K S O P M D G;H
M X J L Q I O T | O Q J I L M X;T
E C W Y X A N V | Y E V W A N X;C
S J Q X V U N W | J X S N Q W V;U
S U T A X R G O | U R S A T G X;O
F N T R U J V Z | N F T Z R V J;U
M T Y F U B Z L | M B U L Z T Y;F
K F Y T C Z E U | U Z K E F Y T;C
R X N I L O S B | B S O I L R X;N
H D B V J I K Y | Y V D K H J I;B
W S J R N A X E | W R E X N A J;S
W Q F V X T U B | T Q W V B F X;U
W N E O H Z R Y | R W Z Y H O E;N
K E P Q X W R C | X R K Q C E W;P
D P W L K M G H | G L W P D M K;H
Q J B K S P A M | K A B Q S P M;J
J S P W D V U Q | D W V S U Q P;J
Q F W Y M U Z T | Q Y F W Z M U;T
C U V A Y M O S | O A C Y V M S;U
Q F P D T E W A | Q D W E A T F;P
X O I M Y C P L | Y C O P L X I;M
O W J V K T X E | K J T O X V W;E
W X Z S A N U Q | Q Z S N U W A;X
I U P T Q E G A | G A Q P I U E;T
Z V N U S J X Q | X S U Z J Q V;N
H Z Q B N L O Y | Q H N L Z O B;Y
K A Q W I J F N | Q I W J K N A;F
E A H G X K M B | B A H G X K M;E
F W R B Q E M D | D B E M F R W;Q
A D J O X N T V | X T J N O V A;D
F N J S B V L U | L F N B U J S;V
U N A Y S R T M | N R S Y A T M;U
I D K Z J R L W | L J R Z K D I;W
J Q Z Y T E H L | L Y H T J Q Z;E
T N X D R K P L | D R L N P K X;T
S V U X Z P G D | S P Z U G V D;X
L B Z E W P G M | P G L B W Z M;E
B M L P H T C N | P M T C H L N;B
O P Q N F W I B | Q O B W N F P;I
P J V D L S A X | V D J P A S X;L
E U A S Z T C F | A U S F C E Z;T
C H I D K S P E | I C E K H S D;P
V O M C Q G H R | H G O V Q R C;M
V Y U A Q O N R | Y U O N V Q A;R
X Z A Q C H U D | U C D H X A Q;Z
N F Y P V K Z T | F N K T Y Z P;V
L U Q I S M E A | U E Q I A L M;S
N S M Z D A W Q | W M Q S A N Z;D
Z W R S Q Y H D | D W S H R Q Y;Z
L G F O H E X I | I L H X G F O;E
T A N J S U P Y | A J T P U S Y;N
R E Z H Q S V L | Z Q E L R S H;V
N I O G C W Q A | C W O I Q N G;A
A P N F S J I E | I J N F P E S;A
Y C M L S T G K | L C Y T M S G;K
D Q T V F C N R | Q F V R N T C;D
L V F O G A I X | F G O I A L X;V
Y R X M D V O U | U R Y O M X D;V
B O W Q H E Y V | W H O B Y Q V;E
T Q I S K A Y H | H S A Q T K Y;I
R N T Z V O A P | Z T A O P N R;V
T V P R Q U S H | H P U T R V Q;S
P K S Q V Z I R | K R P V S Q Z;I
H B L N M S V W | W L N M S B H;V
E B J W C V G M | B C J V G E W;M
S L W E J G A O | L S J A W G E;O
F S V P R T I L | I R L V P F T;S
P N L S C F O E | F E O L S N P;C
G U V E M R L S | G E S U V R L;M
J D C W S U Y A | A C D J U Y W;S
K I H O R U L P | O K P I L U H;R
M F Y T Z V K Q | V M Q Y K F T;Z
B D L H N W C Q | D W H L Q C N;B
N E K H J D Q T | E J D Q H K T;N
K Z V Q A I J F | I J Q V K Z F;A
F G Q I V L E X | X G Q E L V I;F
P S X H N W M C | N X W H P C M;S
F P T H E N L X | F P T L N E X;H
L U Q A K H E F | U Q H F L E A;K
R W N O F K S P | W S F R P K O;N
V W U I R G K J | I G K J R U W;V
G Q S V K Y H R | V R Q K H S Y;G
I G X T E W B J | T E W B I X J;G
A H Z L I U O P | I Z U P H L A;O
V H C Z O Q R E | V E Q H Z C O;R
B L P R F O N E | N B E L O R F;P
Z L V B Q H F C | H Q C Z F V B;L
P C Q M U A E Z | P Q A E C Z M;U
Z G Q V J X W P | P X G V Q W J;Z
A P I M K U W D | U K I W A P D;M
I S N H P D L V | N L P V D S I;H
M H Z U C B Y S | B M Y Z C U H;S
Z N V H R J P B | B V N P Z H R;J
J Q Y V R D I C | C I J V Q D R;Y
Y A N V T X Q M | X T M Q Y N V;A
J K N P F H S B | J N S K P B H;F
G K E S T L A N | A L S K T E N;G
Z D T H E L M I | Z H E T M D L;I
V P S Z R E D A | D R S Z E A V;P
R U W Q O T G S | W O T R S G Q;U
H A I F C T B N | T I B A C F N;H
Y S V Z P T G F | S Z V P T Y F;G
X F G S C J Y B | Y G X S B J C;F
J X I E N B H G | B J N I G E H;X
I D Z P V K C Q | Q Z K V D C P;I
T J Y W A M G X | G M Y A T X W;J
P F W D V Q I Z | Q F W V I D P;Z
E T Q Z D S Y K | K D Y Z E S T;Q
U M S X P E B I | M I X S P B U;E
B O W Z E Q P D | D E W P Z Q O;B
I C M O W Q F V | I Q C F O V M;W
C X L Z Y U I K | X K Z L C I Y;U
E B H X C Q T Y | T X B E Q Y C;H
L S D J O Y F K | Y J K O L S F;D
A J C N B V Q E | B V A C E Q N;J
J A S M I B C U | I B C S A J M;U
N M J X Z U B L | L M Z X B N U;J
P M D E A B Q S | A S D Q B E M;P
X J B E G A Y V | V E B X A J G;Y
F D L V M C T G | L V M T D G F;C
P J N H T E M X | H T X E J N M;P
R Z B S Q A J I | Z S J I A R Q;B
F U I R P J W C | J R U C F P I;W
Y C I O X G S J | I O J X G C S;Y
I G S H P J O X | H J G I X P S;O
U I Y Z O K D G | D U Z Y G I K;O
L Y E D R Q N A | D A N E Q Y R;L
M X U Q N P V S | V X Q S P U N;M
I D U S O F V J | V F D I J S U;O
E Y P G N Q O D | Y N D O G P E;Q
V W H N U J P T | U H T V W N J;P
P Y W O J T G B | G P B O W T Y;J
U Y Q S B L G H | U S L Q B G Y;H
X V D A E K L I | I K A D L E X;V
C R A E D V O F | V D A R C E F;O
K W U H Z B T Y | U H B Z T W Y;K
Y C P R D M Z I | D P Y I C Z R;M
A N Q G Z F T O | A Z N T F G Q;O
M W R Q G C N X | Q N M R W X C;G
A D W N O S G Y | S O N W Y G A;D
I N S E O Z C H | I E C H S O N;Z
Q O U H B S X L | B H O U Q S X;L
X E W G Q C P D | X G P D C Q W;E
N B W M A R K T | T A B M N K R;W
M S P I W T V Q | Q M I W T S P;V
T M D A O R C U | T M C R D A U;O
T A O F D M E I | T I O E M F A;D
K E Q M Z F Y J | J Q F E M Z K;Y
Q D V S C L G A | C G D S V Q A;L
D G E Q C I A Y | A G C Q I E D;Y
P S J K U A G L | L U P K A J S;G
E Y V Z W D M J | V M Y J E Z D;W
E Y K Z H W G O | Z K H O E W Y;G
Z C Y L V U N J | Z N Y U J L C;V
H P Y T V G M J | H Y T P G J V;M
A O D B Y F C I | Y A D C O F I;B
B K A T X E I O | B K O A E T X;I
J X O B U A C V | B A O U X C J;V
L D Q N H G Z O | G O N H Q D Z;L
S B E X Z G N L | G E Z S N X L;B
S A D L J O I V | J D I S V O A;L
G E A I J U L T | L I A G U T E;J
U V Y Z S E L T | L Z E S T V U;Y
C Y V L G R O D | D Y C G R O L;V
H G O B T I J E | I T G B J E H;O
Y X T V G M F J | M X Y V T J G;F
F G Y W S M B K | K M B F W G S;Y
M F T W P J X L | M P F L W T J;X
E J V A U B R H | U J A R H B V;E
U B T J X Z Q G | U B T Z J X Q;G
R V B Z Q G O I | R O B Z Q V G;I
P E Y U T M V R | P E T M U V R;Y
L S T K B A O P | P A L T O K S;B
G I R S Q A W U | U G Q W R A S;I
F X R G U Z S L | Z R S L G X F;U
Z U A T B K H Y | U A K H B Z Y;T
C Q U J Y S E L | L S E Y J C U;Q
Q E V F P R K W | W F E Q P V R;K
N U Q E P T Y X | N U P Q E T X;Y
I H R X C N Y D | X Y H N C I D;R
M S V K X W T C | V T C M S K X;W
C G U J R V W K | J V R U W G K;C
O A G W T S Z P | G A S Z T W P;O
R I J U N K Y A | N R I J K Y U;A
Z H V A D C N Q | N D Z C V H A;Q
K D L V T H A S | V K S A T H L;D
I H G S W F E Y | I E G W H F Y;S
F V Q D T Y C I | V C T F Y I D;Q
L M O C E F V W | O M V F L E C;W
X A R H I C W F | W C A R F I H;X
O N V P F J H G | F V J N H G O;P
T Y F V B R U D | Y F U V T D R;B
E L G B Q I T N | I Q G B E T L;N
O X V Z T P S G | Z S P G O V X;T
N X J W Q K T G | K G T W Q X J;N
Z B R K Q D T X | D R B Z K T X;Q
L N F U K O A D | K L A O U F N;D
Y V I G P C D H | P C G H Y I D;V
Z C S B T W E M | M Z E S W T B;C
X J Z T M E Y D | T E J D X Z M;Y
U R G S E P Y Z | E Y Z P R G U;S
M F U W D B E S | D U M F E S W;B
I L O V W U Z N | W L I O U Z N;V
A O N K W R F B | A N W K B O F;R
U L M K A Y I P | M Y L I P K U;A
R F H J X E T O | R J X T F H O;E
B Y J E O Q I L | L Q O E Y B I;J
V G R B K Y S C | B C K R Y S V;G
C E D Z R B P A | D C R E B A P;Z
U I C M Q P T K | U T Q C M I K;P
Y R N B E Q F V | F Q N R V E B;Y
F Z J S P X W B | F X Z S P J B;W
D S A B C Z Q U | Z B U S D C A;Q
L C R I T Y E B | Y R E T C I B;L
U H Z O E D Y J | J D O Z U Y H;E
W J X O C H V D | H X O V W D J;C
B X L Q F T R J | R Q B F L J X;T
V L D U P Y F I | U I Y V D F L;P
T C B L U Q E O | T C U Q E L O;B
J V T L M Z I D | V T L J Z D M;I
T W L P Z H F E | W H L Z E T F;P
J S I N P F M B | F M B S P J I;N
J E W R N B U D | B E R J D U N;W
Q K E O Z G M X | O M K Q G Z X;E
Z E N Y V A J U | Y Z E V A N J;U
O E Y D K F S A | F A O Y D E S;K
X U M W E O V Z | Z V M X W U O;E
M C N F P I R Y | R F N M C Y P;I
B D P A Z N R G | Z N B A R G P;D
A F J C X P Z S | F C P S X Z A;J
A I P Q G D K L | D I P Q L K A;G
D J M C F H W Q | W Q J M D H C;F
I S V J T O Y U | V T U I J S O;Y
P V F Y L I M T | P L I F M T Y;V
R W U T G Q H N | R N W G U T H;Q
X N L O C B J Q | Q X L N J O B;C
L Q D U Y E R V | E D Y R Q U V;L
J G V W K D A L | D K W G J L A;V
Z C X G S H U T | X G H Z U T S;C
J Z R I M L G K | Z L M I R J K;G
T R H Q L A S M | L R Q S A H M;T
M Q R K G P V T | R P T K Q G M;V
P L C D A Y B Q | B C P Y L D A;Q
V J I B U X K F | F X V I K U B;J
Y A N E X H O R | R X Y A O E N;H
J U S H P F A B | A B P S J F H;U
Q G S W I V N U | Q N W G U V S;I
T J O I M Y C X | Y J C O M T I;X
X G D L B U Z I | L B U X Z D G;I
S J D U A I G Z | G A U Z S D J;I
Z D T L Y K C S | K D C T Z L S;Y
Y A D C Z E L Q | C Z D Y A L E;Q
A G H D M P U E | P G M E H D A;U
F G R O L X S T | O T G F L S R;X
X P S C N K F Z | K N F S Z C P;X
W J P X S D G Y | D W J P G Y X;S
E A Y B F X J M | E B Y A M X J;F
F K H I N P R X | K H F R N I X;P
K U T L I P E Y | I K T L Y E P;U
L E P X V O U S | E O P S U V X;L
J K L O N B V I | B N V K L J O;I
W T N A P L K V | L V P K W N A;T
R K G D I Q H F | I D R F Q G H;K
R C Y Q T D P U | P Y D U C R Q;T
Q T G H A P U M | H U P M G Q A;T
T J C S F P Y H | H J P S F T Y;C
Z E H G I N V F | E N H G F I Z;V
T J Q N D L C X | Q L N D C X J;T
S E Z T P M L Y | S M T Z P L Y;E
I N J B S P F Y | P J I N F S Y;B
Z U C A O B K S | S A B K C U O;Z
J T X M Q O C G | C J Q O X G M;T
D K L W J V H B | W V L J D K H;B
L O U D N X Q S | X N U L S Q D;O
P D H Z C T V O | V D P C T O Z;H
T R L K X A Q P | Q K P R L T X;A
N X Z U M B Y G | U M G B Y Z X;N
D H Z B T U S C | S Z B T C D H;U
Z R I V O H A C | R A I O C V Z;H
G H N O Y P I J | I J N G P O Y;H
X M I B Z G L A | Z X M B G A I;L
O Z E H P X T N | N E P X Z O T;H
O L Q E J K U G | U J E O K Q G;L
U N H J M Z X K | Z U H K X J N;M
N D E L U H P F | H L U N D F E;P
D C L P I G V A | C A P L V I G;D
M Z N D K V P H | M K V Z D N P;H
I R K E H Y G N | K I R N G E H;Y
X I P E S W V J | I X S P W E J;V
N A R L Z C T X | R T C A X Z N;L
R L T V O I K X | K T I O V R X;L
W Z U X R T Y E | T X Y E W R Z;U
J T H W C X G R | T X G W H R C;J
P O G U F C T J | C T F J G U O;P
Y H C V X A T D | T C V D A X H;Y
D V R W E M Q H | Q R E V W H M;D
C T Q U S L X N | X L N C Q S T;U
Z W S E N P H L | W P E L N S H;Z
I B H X O K C F | C I H F O X K;B
H B Q F S X J G | X B Q S J F G;H
T R Y Z H F V J | V R Y T F Z J;H
I W O N Z C L Y | Z C N I W L Y;O
G S K T Y X E P | K G E T X Y P;S
R T I Z F W J N | F J I T R W N;Z
U X R J A C P Y | C R J Y P A U;X
L Z V C N Q F T | F N T Z C L V;Q
O E J S Q T R B | T J S R E O B;Q
F R K H Y S L A | R Y F H K L S;A
D W N K Y X J C | W J K X C N D;Y
A Z Q J S M I H | Z A H S M I J;Q
D Z H I L N T S | S I L H T N Z;D
G Q E S O B Y R | S Y O R B E G;Q
O A D T G H C R | R C O T D H A;G
F D U X K Y W C | U C K W Y D F;X
R Z J Q T W E P | Z E P Q R J W;T
J W V R A O X N | O W V X A N J;R
S I Z Y J G B N | Y N S I Z B G;J
F P X O S N W J | O N P X J F W;S
Y G J C O E F H | J C F H O G Y;E
F N K U W O G Z | U W N Z O G K;F
N I G B C E R Q | N C B E I R Q;G
D C Y N F A V M | V M N C Y F D;A
P B K C L F S E | B K P S L F C;E
W N I K O Q D T | Q W N T D O K;I
S F H Y W K P M | P M Y W S H K;F
W J U B Q F M Z | W U Z Q F B J;M
W J M A I E B F | B M A J F E I;W
X K N L U V P G | V K U L N P G;X
N C G P D W U L | L W N D G U C;P
U G O E I N B M | B M G I U E O;N
X B L N K M H C | B H N M L C X;K
W V R D Y I E X | I X R V D W Y;E
N Q X J Z A D G | N G Q X J Z A;D
C X O V Z T P W | Z V T X P C O;W
R N Q O E M K G | E O G N R K M;Q
M Z H X I U S F | U S F Z H I M;X
B E P H S C N G | P S H E G N C;B
B O F L V M S W | L V O F B W S;M
D J O R Z Q N W | N Q D J Z O W;R
Y I C M B G J Z | M I C B J G Z;Y
A P D L Z B I H | Z H P I B A D;L
C A B H Z O Y N | C Y H A N B Z;O
Y J H O P X Z D | P H O Y X J D;Z
X P W U L E H Y | H P X W U E Y;L
Q S G F R H E N | G Q R N S E F;H
V W L J I B S Y | L V W Y I J S;B
E T D L X B V J | X V D J L E B;T
J L W M Z V E D | M V W L D Z E;J
B L O A Y J X V | X Y J O V B A;L
F R Y E Z B G O | O Z R Y E B F;G
T R V Z X Q K N | X R T Q Z V K;N
A Y L K T Z M J | K M Y L T Z J;A
V Z X F T H J S | Z S V J F T X;H
P Z D B W N F J | P D J F W B Z;N
V T B M U W F C | M W C F U V T;B
M B L Y Z N Q O | L Q N O B Z Y;M
Z R P M Q I A F | A I Z P M F R;Q
Q N V C A R I G | Q N G C V A I;R
U O D L E G W J | E O U G L W J;D
B R I N S Y V X | N I B V S Y R;X
J Y S T E A V P | V Y A T S E J;P
C S B A K J O R | R A K B O J C;S
H Q R P C D M Z | Z Q P H C M D;R
Q C X N M F I R | X I M C R Q N;F
M F V K U C R Y | M C U F K Y R;V
G A R V M F T Z | F A G V R Z M;T
X C J W F R E S | S J F R C X E;W
N C A S O Q L H | O A S L C Q N;H
R J W Y A Q U H | J R Q A W U Y;H
K J S V Z B X L | X Z J L S B K;V
Y A J G W P I H | Y P I H W J G;A
O Y J X W K L A | X Y L O W A K;J
V J W Q M F O E | E W O V M J F;Q
C H L E G I S U | H U L C I E S;G
K M N C A T U L | M A L T C U K;N
C B J Y I N P E | C Y I N B E P;J
M B C P K V J I | M C K B P I V;J
H C Y U I K F X | K H F I Y C U;X
I T N U J R M H | I M N H J R U;T
M W S Q D X J R | J M W R X S Q;D
V P L G O N S Y | S P N O G V Y;L
Q D G F Y E Z P | G P E Q Y F D;Z
Z P V M U X F G | U P V X F G Z;M
S C Q F I D V W | D Q V W S I F;C
M P G Q Z V K U | Q U P Z K V M;G
W J S H A Q F M | J A Q F M H S;W
O Q E G J T F Z | J T F Q G Z E;O
D U O H W Q E I | W H D O I E Q;U
Q P W G L D Z V | D V G Z L P Q;W
Q D Z J E Y G K | Z K J Q Y G E;D
S D K I V Q H Y | K Y H S V D I;Q
P V U C T A E I | P A T I V C E;U
A H T N Q B G W | W G A N H B Q;T
P L E O J T G V | L P V J O T G;E
L S Q I O B J G | L G B S O J Q;I
Z P C U Y J O R | Y U O Z R P C;J
J N M F O B U R | R N F B U J M;O
S O G C E B W P | G P E B S O W;C
N Z X Q K M Y V | N Q K Y Z X M;V
O T Y U Q H J K | Q Y J T H U O;K
G Q T O K L I X | Q L X I K T O;G
M V D I F A P K | I M V D A P K;F
I P W R Y X G A | X A W P G Y R;I
H F D Q X U A W | A Q F W X U H;D
K E U S T W Z Y | S U T K E W Z;Y
V L P B G W F D | B V D W G L F;P
R U S E G C B P | C B G U P E S;R
E V J N X A C I | V E J A I X C;N
Q V H Y W G D J | Q H D W Y J G;V
H M S J W Z Q E | Q M W Z S E H;J
P D Y N J R V E | N J D R Y V E;P
S Z Y P C A M V | Y M P A V Z S;C
R A H X B C M Z | Z A H R X M C;B
X B N A Q M Y I | N A B I X Y Q;M
B Q I F D L Z E | B Z E F I L Q;D
Q B O P F H G I | F G H I O B P;Q
E V T C I J Q G | J V Q E C G I;T
T V H D F O I A | A D T F V I H;O
J L A Y Q O F H | F J L H A Q O;Y
M I S Z P J A H | M Z I J S H A;P
I O R Q W Y D G | Y D Q I O W G;R
I Z X C T Y K R | T I Y K C Z R;X
B L M U I A R Y | U A I L Y M R;B
X W R C N D O J | X W R O N D J;C
F X D B W P A I | D W A F X I B;P
X U L C P K Q D | K L X U D P C;Q
C J X Y R I O L | L X R I O J C;Y
I U B H C A E V | B I C E H V U;A
E R C O P N F W | P F C W R N E;O
P B H Q S L O V | O S H B P V L;Q
O E F T I W V R | V O R T E I W;F
T P Z S O U L B | L T S Z U P O;B
Q U V Y F P Z B | Z B F U V P Q;Y
E C H G F D M X | E D X C G H M;F
A M V I B S P F | M B V S I F A;P
K L V W B A I S | I S K A L V B;W
Z K T F Y V J W | F K W T Z Y J;V
T B Y Q I R W D | Q Y D R W I T;B
Q X J V O A N L | Q A N L O J X;V
O D F A U E Z L | L U A O Z E F;D
K F P V O J Z C | V O Z J K C F;P
P Z E T I G K B | P G I B K E Z;T
G E Y H R V I F | H V I Y F E G;R
M R S A J T X V | T S A M X V J;R
N G L T C V M I | V M I N T C G;L
H U M Z N Q D O | Z H M U Q N O;D
V U X D K Q R Y | R D Q X V U K;Y
O A Z R C K D T | Z R D O T C A;K
Y A N X H W O M | A O H N X M W;Y
C Y L P R J U D | J P D R C L U;Y
M E K C J Y Z X | Z E J X M Y K;C
B H O M P N K T | T K N M P H O;B
H N T Y V M D J | M J H Y D V T;N
Y Z K B E F S M | Y K M Z B E S;F
S H X K M O C R | K C H R S X M;O
T Q E U A Y V M | A M T V E Y Q;U
M A S D E U Z I | S M E I A U D;Z
K P E N B M U I | N U I E K P B;M
U F R P L W O Z | R W F O U Z P;L
D I E U V H M J | V D I E U H M;J
S K M G H U Y L | H S U K G M L;Y
F O U J R X I H | U R F J H I X;O
Y S M C Z D L O | D C L Y Z O S;M
A G F W V X O N | O A F V G W N;X
J C L H R W A Z | Z J A R L C W;H
B W S I D L U E | W I U B L D S;E
U K Q W J V P L | Q L J U P K V;W
T C D G P Q Y O | T Q P D G O Y;C
R U V B W N F Q | Q N F B R V U;W
C Z O Q Y K W H | Q Y C Z W O K;H
F H A J T C O Q | T J A C H O F;Q
Y I E Q D O R J | D Q I E J Y O;R
B R O P Y K A F | Y A O K F R B;P
A F L Q X E Z H | A F X E Z L H;Q
W M F P Y Z D T | Y F M W T Z D;P
A H D T S Y U R | R T A H S Y U;D
B W S V G X D C | C G S V X W D;B
K F Z S H B A T | B T A F S K Z;H
T F S A E Y B R | T B E Y S R F;A
Q S N E P J K W | E J K S N Q P;W
B H C X U P L V | X L C P U H V;B
X B C U G Y T O | C G Y O X B U;T
A N Z F K M R H | Z F A K M H N;R
D Y X C S M Q N | N C X D Y S Q;M
T U D Z A K Y F | Y A F Z K U D;T
Y B F V O G Z X | B Y O Z X F G;V
N Q D Y E B S H | Y N E S B Q D;H
L P D Y H A Q T | Q T D P A L H;Y
C E P J K D I B | D C P J I E K;B
N L B O R G J A | J A R B L N G;O
T R V A M O U C | M R V A O T C;U
W O T D L I G Y | G L W Y I D O;T
R E W V X K O H | E O R K V X H;W
L V M A E T C P | E L A M C P T;V
I Y A U Z M P G | G U Y Z I A M;P
P O Y S T U F J | S F U Y P T J;O
B V H J L Z S W | B W S Z L H V;J
O Y U P S X F Q | Y P F S Q U O;X
N B W M T Y U R | W Y R M U T B;N
R A P J O E K B | O P E R B A J;K
J O V I K Z D P | D P V J Z O K;I
H V L K R O M E | O H R K V E M;L
U A M T O F R P | T O M R A P U;F
E S D R M A O V | V E S O D M R;A
T N X U Z B J I | J I X N U B Z;T
K A N J R P T Q | R K Q J N A T;P
D H L M R Q Z G | L G D M H Z R;Q
B Y S X D W V G | Y X G S V D W;B
Z J M W L V Y N | L Z Y M V J N;W
H Q G S W N U Y | H Q Y W U G N;S
O R E W P T I V | W T O V I E R;P
Q G F P J X U K | K P X G F Q J;U
X H S K C G O Y | K S G H Y C O;X
R H S L N G E C | C L E S H G R;N
Y I U M N S O F | F U S O I Y N;M
G J Q C H O M T | G M O Q J T H;C
J E Q W M P Y B | E J W B P Y Q;M
N W A C Y X U Q | N W Q C Y X A;U
I R T K O H D B | D T R B I K H;O
T M B E V C R U | B T M V E C U;R
L A K U Z Y V R | A Y Z L K V R;U
H E V K I P U J | P I V E H U J;K
L K N P E H S X | L X S H E P N;K
C J M O R H P A | R O H A C M J;P
G F X Y L R U N | X R G Y L U N;F
G F T Y V I E J | V J Y T G F I;E
N J Q D W P T S | D Q W P S J N;T
L U V Q H N C A | U V A Q L H N;C
Q L N J P K D E | J E L N D Q K;P
L C K J P R D F | D P L J F C R;K
A L F S O D T P | S O T A F D L;P
K I W U B D E Q | B E Q U I K D;W
X L I H Q M O Z | Q M I X Z O L;H
H Y J R A M V X | Y H V R A J X;M
P U A X O D V Z | X D Z P A V U;O
S E X F H I L C | H S C X L F E;I
V L U W P G Y Z | U G V L P W Z;Y
O N V A Q H S M | Q V S A H O M;N
Z J P U K T G C | G C K J Z T P;U
S K F C Q N H R | H N C Q S R K;F
W E S F A O U I | I U W F S O A;E
B J G F P Z L H | B P J F L H Z;G
M O W Q K D I C | W K D O C M I;Q
V H K U C F D Z | K C F D Z H U;V
H T N Z S O J K | J T O K N H Z;S
W G O K T R L D | O T R K L D G;W
A H R F J C M O | R O F J C A M;H
W D B K H U Z Q | B Q U K W D Z;H
Y K B I A P H Q | P H Y K B I A;Q
C L S J K W G Q | L S G K Q W C;J
C A B M I H G F | M B C A I G F;H
V R T J O C N L | R T N V L O J;C
X K L D T U I N | U K T D I L N;X
I A T L K Z C W | I C W L A T K;Z
R J W M O C N D | D C M W N O J;R
V E K F W L T D | E F V L D T K;W
L Q V D C P E Z | P V D E Q L C;Z
V U E J F A K B | J F E B U V A;K
J P N O K C T U | N K O P J C T;U
V G D U B Z M R | U Z D B G V R;M
Z N Q E C K V L | C Q L E Z K N;V
C X F B L P R D | D B X F C L R;P
M D T L E F W U | E U D M W L T;F
Z N E Y X Q R A | N X Y A R Z Q;E
R S O I W G K M | G S K O R W I;M
T S M Y Q U E B | M S Y Q U E B;T
Z G U O J L V T | T V J Z U L G;O
B U D N J O M H | H B J D O N M;U
L G S V Z M D X | M X V D S G Z;L
N E H Y V D C W | V N Y E H W D;C
L R N Z V G E Y | G V N E Z L R;Y
A L S R H W E U | S W U A L E R;H
U R H F Q J Z K | Z H Q U R F J;K
W K C T F X G M | W G K T X F C;M
J I T E H Z C X | J T H X I E C;Z
M V R L G W B Q | W R L Q V M G;B
F R M J B I H W | M I F B W H R;J
F C S I T X U B | U I S B F C X;T
U V Y O S H R Z | Y O Z U H V S;R
V P W T H Y S C | H P Y V T S W;C
O J T M R F K B | M O T B K J F;R
Y I K V J L T Q | K J I V Y L T;Q
X R L O S A P T | R A L P S X O;T
O H W L R C Y J | O H W C L R Y;J
S K J V E B N A | S E K A N J B;V
P R D O G Y K Q | R Y D P K Q G;O
J Y W K R O X C | Y R W C X J K;O
I Q U Y R B A X | B Q R U A I Y;X
V P M Q C W H S | C P V Q W M S;H
U N S R D O P B | R S U N B P O;D
S P A Y V R X I | R Y P X A V S;I
S U I B P Z T R | I R B T S U Z;P
N Z U H B A L C | U L N H B A C;Z
K Z X G O B Y H | G O Y X H Z B;K
B R E X K G C V | C X E B R K V;G
K J N O D W E M | N W M E J K D;O
P D N R K S Y M | Y D M N S K R;P
Z K M P Q U G S | P G S Z K M Q;U
L R E B Y V U S | V S E L B Y U;R
V K F P L Y N W | P L K N W F Y;V
M S I E U F B H | B H E F I S U;M
E U L S P A R B | R U S A L P B;E
R Z I D T S X O | D I T O Z S R;X
N F T R V P B K | F B R P N T V;K
F D R Z U A J I | D U Z F J R I;A
H Z L W G U R P | P H L W R U G;Z
D A I O Q U Z B | B Z I U Q O A;D
U R H O D C T J | R T J D H C U;O
B K W J H G V L | J V L G H B K;W
E U R Z N G D Q | G N D R U Z E;Q
N C R X F V E H | F R V E C X N;H
M A G W R U D H | R M W D A G U;H
E G V X F N O U | U G E F O X N;V
S H T F M I Q K | I K H S F T Q;M
Q Y C O D P E R | D Q C O Y P R;E
F V O W J T X U | J X O F V T U;W
L Y G F A E M P | L A F E M P G;Y
I X W H N Z G B | W G H X Z N I;B
J M W N V P Q S | N W Q V P J M;S
S G R C Z F X B | F S R Z B C G;X
E B D X Z Y N P | E Z X B D Y N;P
Z I H X F E C S | F H S C E I X;Z
L Q Z T E A Y X | A Q Y X T L E;Z
L C U M R F Z Y | Z F Y R C L U;M
X Z N G M U P F | X M G N F P Z;U
L J G Z V A E K | A K Z L E G J;V
O M A R K W I E | E W A M I O R;K
P M E Q V A U L | E P V U Q L M;A
N P J Y C F T I | N Y T J P C I;F
P W F E M N S J | W F J P E S N;M
E I R Z N B M P | Z B I P M R N;E
O A M S H R T D | R D S O M A H;T
O L H Z C A F Q | C F O H A Q Z;L
E G J B N T C H | N G C E H B J;T
P U O Z L E Y J | O U L J P Z E;Y
P F K E Q A U X | U X F A P K E;Q
Z S M K G U C I | I Z C M K S G;U
M R Q O H J P I | I J H O R Q P;M
E O M C R Y K X | O M Y E K R X;C
R W A S O D L U | S W U L R A O;D
V W X F Q G L H | V X Q H L G W;F
I T V B A H F K | K V I T H A F;B
C O G N Q H E V | O Q N V G H C;E
Y Q S N L E C O | E C Y L S Q O;N
L M V I E S U B | L V M B I U E;S
B G V H W J R C | W G H B V C R;J
X Q Y P B H C Z | Y Q Z X P H B;C
A X M K P E F U | F A E K P X M;U
X E M N W Z J I | M I W E N X J;Z
Z P S Q W I T L | W I Q T P Z S;L
O T S J Y I Z D | T I Z Y O J S;D
A V T L M N F D | V D L T A N M;F
J Y X D E S R M | M R E X J Y D;S
U J X T W Q V Z | U V W Q J T Z;X
H Y D U Q O V X | H X U Q Y D O;V
C V B E P R X K | P K R E V X B;C
V R F S C W A M | A C S W V M R;F
O J W S C P T Q | S P Q O C W T;J
C O D A X Z H P | H P C A O D Z;X
I A Y M C P K W | Y W A C M P K;I
Z J Y V O Q P G | V G Q Z O J Y;P
T J D N A U K R | K A T N D J R;U
W G L C Z Y E R | G L Z E W Y R;C
K U L H N Y Z D | N Z U D K L Y;H
G J V L N Q A Y | N J V L A Q Y;G
I H E G A Q T B | B E T Q G H A;I
E B P H A G I V | E G P H B A V;I
A W I F E M N G | N G F I A E M;W
A N V T G F M B | B A M F N G V;T
H N F U K O M T | H F U M T K O;N
W K B T U A X P | W K B A T U P;X
O B D M S N L W | W O M S B D L;N
P D E X L Z W I | D E L P I W Z;X
E B A U Z F K N | Z B E F N U A;K
J U M P N S B K | K N S U P M J;B
H W T A D G P B | G T H D A W P;B
P E D X C N T B | E D X T C N P;B
U V G O J W E I | G W E I U O V;J
O T Y R G A L K | G O Y T R K L;A
L N U V A Y P M | P Y L U M V A;N
N L E B M J C P | C E P N L B J;M
B K Z L H W E T | B Z K H W L E;T
H N W E F Y I D | W H I D F Y E;N
J T N G S H Q Z | T Z H N J G S;Q
Z Y J C H L E R | L E J H R C Z;Y
I W K R J E C H | E C R H K I W;J
F X S A U R L D | A F X S R D L;U
I V C E B S R N | B N S V I R E;C
R D S U O E Y V | E O S D R Y V;U
K M X F R I C A | I A R C M F X;K
Z G Q L E A S M | A E Z S G M Q;L
O Y P B N M U Z | Y U O M P B Z;N
F W P C O Q T B | C P F Q O T W;B
I N K Y W J P D | P J I Y N W K;D
U Y R T J S N P | Y T J R S U P;N
V Z P Y H S F K | V K F S H P Z;Y
R V H W P G C B | V R H P B C G;W
V D E Y L T S A | E A V T Y L D;S
U G T B A V Q F | B T U A V Q G;F
T F R K Q X W B | T W B K Q X R;F
D L F C N S W U | U S C W N D L;F
N I T E O V K J | O T I K J E V;N
T U I Y C E A F | U I Y C A T E;F
U L V G I P J O | P O J G I U L;V
O J K T W Q L N | J N L W Q O K;T
F G P Y L O K W | F L Y O K G P;W
B U M J V P K H | M K V B U P H;J
S F L X Z C B P | P X Z F C S B;L
C V S I M B L K | L B I M V K S;C
F B T Q I M G U | U Q B G I T M;F
Y U I J D Z F B | U F Y B I J Z;D
W H R M G P X N | N P X G W H R;M
C K Z N R Q G J | J Z N R K C Q;G
T N X C I K L B | B T X L I N K;C
O P A D F H U X | O P F X H U D;A
Y N B D R C S H | D S Y H C R B;N
I U W J E T B Z | I J Z U T E W;B
H W Y N S F P I | S F N Y W I P;H
U Q A V M K N T | M Q N U A T K;V
Q V Z R L Y N J | V L R J Q Z Y;N
R T P I C E V N | I R T C P V E;N
D V C S L Z M T | T V L D S M C;Z
C Y L N O I F D | Y O L N F C D;I
Z U R N F H X Q | Q Z R H F N U;X
C L M R J U D I | R M L C U D I;J
H V C L R E B M | B V C H L R E;M
V G K Q D O S B | Q K D G S O V;B
Y B R M Q D W V | V M Q Y D B W;R
L I D V W H J K | L J H K I W D;V
L P W U F R D Z | W Z D U R P F;L
J E C V I Z D G | V I J D G C Z;E
N S I Z P D R H | P I D S Z H R;N
Z B Y R C S N H | H Y R Z C N B;S
X A H V C E J R | A H E V R C X;J
B O T E X L R H | T E L B O R H;X
I T O L F A U C | O A U T F L I;C
L J Q V S E A Y | A V Y J L E Q;S
Y B Q F L Z T W | Z Y Q W F B L;T
T P C E V U W G | E P C T V U G;W
Q J I D A B N R | J I R B A N Q;D
V P Q F S O T U | U S V Q T F O;P
V Y X Q R E T A | Y A T V E Q R;X
K G L S W U V N | K N S L U W V;G
U Q K B Z N L P | Z L K Q N B P;U
D T W R U F M I | M R I T U F W;D
K Y V H Z J D L | Y D H J L Z K;V
B P J E W Y M C | P Y E J M W B;C
R J Q L W X H G | J G L Q X W H;R
Z Q J W K C E H | Z E Q H W K J;C
H Q Y B F G S U | B S U Y Q F H;G
M V E D Y Z L T | Z M Y T D E L;V
J I W T O M Y X | O X Y M J W I;T
J Q B F W M X H | H F Q J W B M;X
R Q E K O Y M X | E Y O M Q X R;K
D P J K A W H O | P H W O K A J;D
C Q L G P X S B | Q C B S X G L;P
E F M T P Z X Q | F Q X M E Z T;P
D G N Y A W X B | G A Y X N W D;B
U C Z D F N Y J | C F Z U N D J;Y
P C G X B W Y Q | P C X Q W Y G;B
S L Z C Y R I J | Y C Z S I R L;J
A K I L M R C H | M H K I L R A;C
X T H S Z Q U L | Q L X Z H U S;T
E A L Q Y X C T | E C Q X T A L;Y
Y V C Z R N D M | Z N C D Y M R;V
R D V K A F Q S | A F V K S D Q;R
Z D H P O C B K | B K Z P C O D;H
L C O A T R H Q | A Q L C T O R;H
I R H N E S B M | E H M R B N I;S
S A R G K W O E | K O W R A E S;G
D O T P X C N S | N T S C D P O;X
F Q Z B T G W H | W Q H B F G T;Z
Q B T I H V F C | T F V I B H C;Q
H L R X Y F C A | L C A R X F Y;H
W O X U L Z S C | O S L W Z X C;U
Z A H J E Y P B | Y H P A E Z J;B
D C U I Z V S A | D S Z V U A C;I
L Z U T H S C Y | S H T Y L Z U;C
P S R V E O G B | O S B V R E G;P
X G S H E L O C | E H C S O L X;G
H W V D I E T X | V D E X T W H;I
B X K E C Y O S | B Y X S K E C;O
I U W B V D Z A | V B W A I D U;Z
Y V R Z D I U C | D V I Y U R Z;C
J W V A M X B N | X A V B W M N;J
N U P L W B X Q | Q W B U N X P;L
U I J O V E T K | O U I T J E V;K
M N E D O A T Q | D M Q O T E N;A
O L D V X J T M | M V L X D J T;O
A H I R Q U T Y | R T Y U I A H;Q
L J F E O Z Y A | E J A O L Z Y;F
J I W Y Z C X O | I J C Y O Z X;W
I L D U C Q Z E | Z D Q I E C U;L
L Q U N X R V B | L U V X B Q R;N
U I R J N X K M | U M I R K N X;J
K E P T W F C Y | W K E C F T P;Y
R J L Q T E G H | E J L T H Q G;R
G S I W P T M R | I R T M S W G;P
G Y K J Z U A W | Z W K J Y U G;A
L P Z W S X T B | T P B X S L W;Z
W G L U Y H P N | G Y U W P N L;H
K A P I D G Q V | A V I G P Q K;D
J L G C Y Z U V | Y V Z C G U L;J
R G A U Z L X N | A U X L Z G N;R
H W J B L E R Z | H W R B Z L E;J
W S C D B P M A | P W D B S C A;M
S E T N X I K P | P E S K X T I;N
W X E R T B L F | E X R T W B F;L
T M Z J K W B X | T J Z X M B W;K
D R C Z I P E F | F D E Z C R I;P
D P J Z Q G Y S | S P Z D Y Q G;J
V Y K Z F N H C | F K N C Z H Y;V
J E Q H W B O T | O W J T Q B H;E
P W I Y Z A N U | Y U N P A W Z;I
N K O P V E F I | I V N K O E F;P
T J O V C S G W | O G J W T S C;V
L D O B V N F Q | O L B F N Q D;V
W A D I C F L V | W I D V C F A;L
G K L J U Y E A | U E A L K G J;Y
Z O W F C T A K | W O F C T A Z;K
N O Z K M S A P | S A N K Z M P;O
Y A G Q M S P O | O Q P A Y G S;M
R X N J E C H O | R O C J H E X;N
P A Q F X T E Y | T F Y X P E Q;A
G U O J T P Y D | U O T J G Y P;D
S U P Q T W Y I | P W I Y T U Q;S
B H R M Y P K W | B R Y K W P H;M
R Q S E L I K A | I L R S E K A;Q
V M W D L O F X | W F O D L M V;X
M S D K X Z E U | K Z E D U X S;M
O R V K F D A B | F O K A B V R;D
W X C G Q H M O | Q W O X G H C;M
J I H S A R T V | S T R H I J A;V
L A C B Q R N J | R B J A C N Q;L
O E F Z X W T G | O X E Z G T W;F
Q N F L D K V X | D X Q F N V K;L
P I V B W Z M Q | Z B V I W Q M;P
M Z W N D L S K | N M Z L S K D;W
Q S K F B H T X | X S B T F H K;Q
Q L Z K T A X H | H L K A X Z Q;T
K W Z Y L O F T | T W Y Z K O F;L
R Q I S P G B A | Q I A G B P S;R
G P D O S L T H | T L G S P H O;D
X H D Z E P T A | T E H D Z A X;P
S F O T Z D I C | D C I Z T S O;F
Q M L Y I B J E | M E Y Q L B I;J
J D X L Q H M R | D R Q J L X H;M
J R K G W Q U Y | Q W R Y G J K;U
N G Z A K X Y W | A G X K N Y Z;W
T X I N E H Y O | H T I O X Y N;E
E I F K B J D N | F I E K B J N;D
R H B F N V C J | B N R F C J H;V
Q L X W K U I J | L J I Q W U K;X
D O R P N T Z L | Z P N O L R D;T
A B M N T V X G | A B N V M X G;T
T Q X Y H U W C | Y X C H T Q U;W
A K P L O N Y X | X A O Y L P K;N
H B O N I V X K | V B O X I K H;N
I G B P Y K A X | Y A B P I X G;K
Y S T I A L X K | K A Y T L X I;S
V N G Q Y L W A | Y G A W Q V L;N
S X Y L I K J G | J X S Y G L I;K
P Z F C B R H Y | Z F H B R C P;Y
M W C Z B D G T | Z C G B M W T;D
C F U X K L P I | I C K F X P U;L
G R Q J M P X O | Q O M G R P J;X
V Y J U Q L P B | P B V L J Y Q;U
R S Y J A B X V | X V A S Y R J;B
K A X R B C Q N | X A Q N B K R;C
H Z N U A L W T | T N U H L Z A;W
M H E L B O V Z | O V M E H B Z;L
A R G F Y M W X | W F R M A X G;Y
N O U H T Q Y C | N C T U Q H O;Y
N Y K S W T H F | S N Y K W F T;H
D K S E I U X W | S W K E D U I;X
S H F J O U P I | F I J O H S P;U
J U O S T M A I | A U T O J M S;I
Y P Q R F E O C | C O P Y E F R;Q
O G A U Y J Q E | Q E G J Y O U;A
P J Z U C R Y O | Z C P O R Y U;J
V Y E O H S W P | E S V O W P H;Y
D U Q K Y G T S | D T Q Y U G S;K
H I M J X G B V | X M G V B H I;J
C H D M G S Z I | D C G S M Z I;H
Z Y A L X K M R | X Y K Z A R M;L
H E Z C X O U F | C O U H E Z F;X
J D S W A K X E | A E X S J D K;W
L B G F K W P C | P B C W L G K;F
S L T W R X G A | R A L X T G S;W
N B L P W U V C | V L P C W U B;N
C E F N H J K D | D K N C J E H;F
D J S A E H K X | K E J H X S D;A
N F C R L Y P V | F Y C L R P V;N
F E Z K M S R C | S Z R E F K C;M
J R A S K Q C W | R C S W Q A J;K
Q O E K A Z Y L | O Y Q K Z A E;L
V U R S F M B O | R O M B S F V;U
E H Z G Y F S C | H C S Y E G F;Z
F X G I P S Z O | I F Z O S X P;G
Y M N Q C S P G | Y P Q M N C G;S
L I M P Z E B Y | E P M I L B Z;Y
K W T I D S U A | W U S A K D I;T
F R Q G N Y I V | Y N G Q R F V;I
T B Z O P E U V | V O Z B P E T;U
H A P U O I Q V | U H Q A I O P;V
X O D H J L Y R | O L R H D J Y;X
T A C M P I U Q | Q M T U A P C;I
E B X A G H M S | E H B M S X A;G
X I P G V S T U | S G I U V X T;P
L K O U C G A B | O K B L C A G;U
B F C Q G K M T | K T F Q B G M;C
M O N H J Y R F | R H N O Y J F;M
U G J P L M E K | M J L U E G K;P
J U W S X G E M | M G X W J U S;E
P O N S Q V I L | V L O I S N P;Q
U W S R T M A B | M R B A U W T;S
G Q O E T N Z P | Q G P E N O T;Z
S W X O K I T H | T K O I W X H;S
X D G F K T R U | T D X R F U K;G
G S F R I U D X | F I R D G X S;U
E Z S A N Y M Q | A S E M Z N Y;Q
J F I O S Q V D | Q F D O V I J;S
X B Y W P Q N I | Y I B X W N Q;P
P G L V M W N T | V N M G P W L;T
I X Q P Z Y A F | P I X F A Q Z;Y
X D K Q U R P W | K X Q P D R W;U
X E F C M V J Z | Z E V F M X C;J
D P N W E Q F O | D Q E N F W P;O
M H L U Q D X B | B L Q D H M U;X
K N Z J M D W E | E J Z K M D N;W
B N H M A F C T | F M T H C A B;N
P U T E X H D Q | H E Q T U X P;D
X U T I Y E S O | E Y S I O U T;X
K H Q V X B U W | U K W H X Q V;B
Q H A E D T W F | T H F A E D Q;W
B L V Y R T J F | T L V J Y F B;R
O A S J K Z N I | A O S N K Z I;J
O B D T V S M J | B O S J V T D;M
C S N W B O R X | W B X O R S N;C
V M X Z A S O W | A V Z S O X M;W
C R J S B X V I | X S I B R C V;J
S B I K Z E U F | F I Z B K E S;U
C U G J Z K Y V | V G Z C J Y U;K
L H M B K E W Z | W H K M L B E;Z
L B E S I A H X | X H I L B E A;S
E S Y M B F W Q | S Q F Y W M B;E
I A F E L R T Z | F L T R E I A;Z
F V L S P R X N | X S P L N R V;F
K R G P V N Z H | K P R V H Z G;N
W Z B E X T D N | N X E Z D B T;W
V Q B O Z C W T | B Z O T W Q C;V
M X P Z S A Q H | P H X M S Z Q;A
M P L H O V J W | L W O J P V H;M
B Z V M A E L F | Z M L A F V B;E
D R X Q C E V P | R V Q X D E P;C
J H I O D R C Z | D C H J Z O R;I
L R J Z K T V B | J B L R V T Z;K
P E N Q K V I H | H I E K V P Q;N
B V Y P A D K X | V Y D X K B A;P
I U C L N S W Q | I S W U Q N C;L
G T U A Q E V P | Q U E G P A V;T
R L Y S W H A G | A G S Y R H W;L
S F N O M W H A | M W N S H O F;A
P C Y M X L R V | V Y L R X P C;M
M E X U I J D L | L J U E X D I;M
Q E R K J S Y N | R K S Y E Q J;N
D P A V F C X I | A I P C D X V;F
B K U J Z S C F | F Z S K B U J;C
W I P B N M U O | P I N O W M U;B
J M S W N R O X | M S N X O J W;R
Y I R L U D G H | R D L H I G Y;U
J Z D M K W T S | J M T K S D Z;W
H D B T C Y V X | D T V Y H B C;X
Z C I L K H T N | Z I K C T H L;N
C G U I H Z J E | G H Z J C E I;U
G U F I B K Z H | Z G B K H I U;F
C E W V B N R Q | B Q C E V R N;W
R N P W I H K U | P U K W N H I;R
J X V G I L W R | G I J V W X R;L
K D L M R J U T | J M U T K R L;D
T S X V U L J R | T J L X R U V;S
A H S J W K C Q | K Q J W H A S;C
H T V M U I G B | G V M I H T B;U
W N O K P J F Y | Y W P J O N F;K
M P A W K O F B | W K F P O A M;B
W U L O Y V H B | U H V Y W B L;O
J O W F D E X Q | J Q W F E O D;X
H M F P L Y I U | L H P I F U M;Y
G X F I A N D Q | F G X A Q I D;N
T S Z C N B P G | Z N P C G T S;B
R L J A S Y K N | N A L R Y K S;J
C I H D F O A Q | H O D F C A I;Q
O R K S W T M I | R T K O M I S;W
A Q V G Y I D T | T A D G Q V Y;I
K T H B F P D R | F P H T D B R;K
E H Y O C M G L | H L O G M E Y;C
N G D Y T S F V | T S D V G F N;Y
X N G L E Y R W | X R Y W G E N;L
E S L C M W U Q | U E Q M L C W;S
N S E P K H I A | N K P H S A I;E
Y I W G B A H R | H R I Y B W G;A
T Y Q E H U V D | D T E Q V H Y;U
Z H C W T Q R M | Z T Q M W H R;C
H R V S C I N Z | V C Z N I S H;R
K J T D B C H L | L D T H C B K;J
O W B Z C H D J | D B H J C W O;Z
T N R G I D S H | N G T D I S R;H
U G M A W B O S | S O A U B W M;G
E O T Q N G Y Z | Q G O Z N E T;Y
U W F Z D X V A | U X Z F W D V;A
H N X Y J O C L | X Y J O L N H;C
U H G V O S J I | J I U V S H G;O
B P C Q X W I Z | Z B C X I P Q;W
L P N Y G W H J | N G J P H L W;Y
W I A K T Z S E | W K A E S T Z;I
C P X F S H R Q | C H P Q X S F;R
I H M G Y E Q A | H I A Q M E Y;G
I V C G Y S K P | I Y P G S K C;V
Z P G A S M R Q | A P G Z Q S R;M
V H D L F I Q M | L Q M I H F V;D
X S W P K V A Y | A X P Y S K W;V
Q V A F B D Z U | F V B A Q D Z;U
P F E U T H L B | L F B U T P H;E
S D B Z M E O Y | M O D Z B Y E;S
B Q X O V L K J | B J V L X O K;Q
V E H Q T G Y C | T Q H V Y C G;E
F Y B V C Q P N | V C B Y P F N;Q
B H R A P T F V | F P A R V T H;B
E L D R I N M J | M R E N I D J;L
H N F U P C S M | N U M H P F S;C
U I S N A R J P | I P A J S R N;U
N W Q P I K O C | I C Q O K W N;P
G E Y Z X L W D | X G E Y Z W D;L
G Y B V N J F O | J B Y O V N F;G
J R H S O C P N | P N O C H R S;J
O D W Z G U T N | G U D O N Z T;W
D Y H J E S X U | X J S D H U Y;E
U Z K C Q W L D | Q L D C U K W;Z
T G E Z I B O A | I Z T G A B E;O
T I S L V O K A | T V O A L K S;I
G M X P N U R I | M I G X U P R;N
C P D G A L H Q | H P A G D C L;Q
X E Z M D R A G | Z E M G R X D;A
R I Y D Z C Q M | C I Y M D Z Q;R
H R N T A J O I | T A I N R O J;H
T M U F H W D V | M U H T D F V;W
Y W B T E S F V | F E W T S Y B;V
K E O R U B Y P | P R E O B Y K;U
A F G L S Z O Y | G Y A O S L Z;F
P Q M Z A T D S | Z T P S A Q D;M
T K I B P V A O | V B T O K A I;P
J L A N U D B F | J U F D N L A;B
W C E L U I Z G | L E Z G I U C;W
L S T K I U O Q | S Q L O U K I;T
D G K F X S Y H | S D Y H G K F;X
Y R U W B M Z I | Y Z I M W U B;R
O N S I M R V Y | R V O N M I Y;S
Z P B K R G Y I | B I Y K P Z G;R
M Z Q U C K S E | Q M Z U E K C;S
S M G L X T F A | A G X L S M T;F
D T Q A O V C F | F T Q C V A O;D
G Q M N F B O C | C M O F G B N;Q
H A K F U L B Y | H L B Y F A K;U
T U S A M D W J | J W U S T M A;D
I Y H B E D N G | B E I N G D H;Y
Y M D R S Z J X | S R M X Y J D;Z
X Q S K A D F Z | S Q K A D F Z;X
Q H S M Y J V F | J S M Y F V H;Q
K U C M X R Y A | M K C Y A X R;U
U P G A J L C S | L S A C J G U;P
D R S J Y U T M | J D M U T S Y;R
G L K U Z A J H | L G U J K Z H;A
D E V B G X N P | V B G X N P E;D
S U A P H E O V | U P V H O S E;A
L F E I Q H O Y | F H I O Q E Y;L
O B P F J W Z I | O I F Z B W J;P
L H W F Z A T V | H F A L W Z T;V
P M R V K B I F | V B I M K P R;F
S G N P D C I A | G N C D S P I;A
T L P C J U R H | H J U P C R L;T
J Q I V S U C H | V I S U C Q J;H
N O Z K D Q R W | Q D W Z K R N;O
B Y S U X T Z M | U Z B T M X Y;S
H R A V C J U W | V C A W J H U;R
F U Q O A L J E | U O J F A Q E;L
O Q F W X B P L | P X W B F L O;Q
I L T Q S O Z C | Z T Q I L O C;S
M X K D Y T V I | K D Y X M T I;V
C H E T K M A R | C E M K T R A;H
X B D H U N E A | H E U A N X B;D
A I Q R G Y L P | I R G Y P L A;Q
L F Z G K P I U | P I Z L U F K;G
R D I V T B P Q | P R B V Q I D;T
L F N S A B C P | A N P C B F S;L
B W S H Q J A G | A G W H S B Q;J
I Q U F Y K M G | K I F Q M G U;Y
V C T Z F R D X | F V D C T Z R;X
Y N B K V I W M | M V B W K I Y;N
P E R A Q D Y N | Y D R N A Q E;P
U C R Q M E V D | C D E M R U Q;V
P A C M J V K W | J V P K W C A;M
J Q V Y U E I T | E Y T Q I U V;J
A Z F X I P O Y | Z F O A X Y I;P
L K G S F Y O P | P F G Y S O K;L
Q N Z J A E U Y | Z N Q E Y A U;J
S X L M V G Y E | Y G L X V M S;E
N O Q U A B G H | O U A H Q G N;B
P V Z X S Y J U | Y J V P X U S;Z
L I O V U M F H | F I O U L M H;V
K S E I T Z M O | I O K S E Z T;M
M X Y Q Z N R L | N Y X Z Q L M;R
T D Y I Z N M E | E N T Z D I Y;M
F H J O M T Y P | J T M P H Y F;O
I N P D C V G E | D G N P V E I;C
U I S M H P C K | I S H M C U K;P
J M E V O Q W C | Q V M J O W C;E
M S U I R W E X | W M X I R E S;U
Y F M H I N D A | Y F I M A N D;H
K T Z X B E A V | T B K X A E Z;V
E U H G R T L M | H R U L T G E;M
F G C U B J S A | J S A B U G C;F
R M Y Z P D X H | P D H Z R X Y;M
L O X Y P R F G | L P F G Y R O;X
G M D V H S N T | M G T N S V D;H
R V I D U X F H | H V U I D X R;F
B J N U X W T I | U J W T B X N;I
E A F N Y Z W U | Y E F N U W A;Z
M R Q A S D P K | P R A D S Q K;M
Y G R E F K B V | K R F Y G E V;B
D S X A Z F N Q | S A Z X Q N F;D
R O E C U A Y H | C R Y O E H U;A
V E Z U I M P L | V L I Z P M E;U
E T L A K C X Q | K A E T X L C;Q
H U B I Q E P K | H U B I E P Q;K
E A K P L W V Q | V E A P K W L;Q
V A E L F C U R | R L V F C U A;E
G V O N K M L E | N M K V O L E;G
E K F D Y H J P | E H Y J K D F;P
G B R S X J Z U | S U X B J G R;Z
O K D Y T Z C V | C K T D Y Z V;O
I E H P B M X J | I X E B J P M;H
P D L B K W M G | L G P W B M K;D
Q X N J H M G L | N M X L Q J H;G
J P U D V I X Y | Y U D P J V X;I
L D M Z J P F E | D L F E Z M P;J
O E X Y F Z D P | O F P E Z Y D;X
Z L K S Y P N W | P L Z W Y K N;S
P A J T Q W B S | Q P W J T B A;S
V B N Q S C U A | V B A Q S N C;U
A L M U S B V O | M S U B O A V;L
V Q Y E O F C U | U C Y F O E Q;V
O Q A B P R T D | A R D P Q O B;T
B S V Y Z D M G | M Y S D B G V;Z
I N A P Q M C S | C M S N A Q P;I
C R U T F O P K | T U O P C R K;F
F P Z T X K L G | K Z T F P X L;G
S O A C H I J M | H M C A S J O;I
G Y V F E U S J | V U F E G Y S;J
X A O G F D I N | D N O G X F I;A
W A K L E X F Q | F Q X K W A E;L
O J U C I S M N | U O J N M C I;S
U N C Z T Q H I | Z Q C I H T N;U
D U O Z A J H W | J U H W O Z D;A
O H A X I V M J | H I A X M J V;O
K R L I A D S B | B R I A K S D;L
E P D Y A G C V | D G P Y E C A;V
G T N D L E R X | N E G R D L T;X
V G M D Y C P F | M G Y P F C V;D
Z K V O W Y B T | W O B V Y Z K;T
V N R B T X J O | V T R B O X J;N
X H R L Q Y M I | I Y X L H R Q;M
Y H P C K U N A | H P A U N C K;Y
H P F W X D Q M | Q W X P H F M;D
Y B N Z U L Q H | H Q L Z B N U;Y
E W N B Q C L H | W L E C N Q H;B
W D X B Q I K U | W X Q B I K D;U
N W C T E Q S U | U C W E N T Q;S
R P M D J H Z O | M P R Z D H O;J
A P Y N H G Z S | Z P N A S H G;Y
F H N M K T Z V | T F V N K Z M;H
L O K G Y E T C | K E L C G T O;Y
W G L O C Q J M | M O L C G W J;Q
A W K R Q X O S | S A R Q W X K;O
K D R E N C Q T | Q C D T K R E;N
W U Z H X K I P | U H X Z W I K;P
J G R Z P W Q I | Z J P Q R G I;W
O W S D Q F X C | F Q C X S D W;O
B N Z P G I T C | I Z C B G P N;T
G C F O L U Z P | C P U F Z O G;L
X P O R G L T C | X T L G R C O;P
B T I G U Z N V | V T N I U B Z;G
L X Z I H J E Q | L I E Z J H Q;X
M K J C Y O G R | J K C R M G Y;O
Y S R B V O J W | J W V R S Y O;B
P D F Z I G N S | D N Z S I G F;P
M V Y R P L O X | R Y O V P L X;M
M K E C S T B Y | K E M Y C S T;B
M D X L Q N H R | N D H Q X M R;L
X E H S C T L F | X E C S F L H;T
P T E M K Z L H | T Z P K E H M;L
I W Z C V G S T | S Z V I T W G;C
F D R M V Q Y A | Q R V D Y A M;F
Q D K U M Y X G | G Q Y D X M U;K
I F K X P O D V | X D V K O F I;P
M K A W F C S D | S F M C D W A;K
G A U S H O L C | G S O H U L A;C
H K E S I A B Z | I E K Z H A B;S
D V Z U H G I O | D Z H V I G O;U
D R B S J T L P | L S B T R P J;D
K S F Y O D U R | S O Y R K U F;D
S Q L M X B G O | Q M X S B O G;L
W J A R K S Y O | J R K O W A S;Y
F B X R W P V N | P R V F X B N;W
Z B K N Y T J L | J K Y Z B L T;N
G U B H V P J M | G B M U H V P;J
Z A V C K N J L | K C N V Z A J;L
Z H P U L T G Y | U P Z Y G T L;H
S C G H I P D J | P G S J H D C;I
R E G F Z A P C | Z C E F A P G;R
E R C I K A Z X | A E R C K I X;Z
W D M U P X L Y | M D U L Y P X;W
L N J F I A C K | F L C A I N J;K
V P F N H E Q O | F H P E V N O;Q
F N D Y B X Q J | B Q J N F X D;Y
O U A I Q R K W | K U W O Q A I;R
G D T A U O F V | U D T O V A G;F
Y U R O Z T X N | T X O R Z U N;Y
M T F S E D Q I | D S I E M F Q;T
S G L M K T W Y | G T S Y L K W;M
Y W O C B Q F P | B W Q C F O P;Y
W I P L F O K A | I O K W A F L;P
M J C H W S K T | J H C T K W S;M
O B E I R A Z H | R A H Z B O E;I
U G N F X E S L | F X E G L U S;N
B D U Y T I F N | Y D T U F B I;N
Z N K L J P Q O | Z J L N O Q P;K
C J E A N U T O | O N E C T U J;A
O N Q I C T P Y | O Q C I N Y P;T
Z P T X Q R E C | Q T Z R C P X;E
Z H C M K O W P | W H O P C M K;Z
Q L T E X Y P R | L Y P E T R Q;X
E V Y O T L C R | T Y E C L V R;O
Y I D S G M X R | Y I R D M S G;X
S M R B V L Q J | V L B Q J S M;R
J K O B N H D Y | K J B D O H N;Y
Z G S H U F L O | F L Z H S U O;G
W K H Q T X Y N | Y X W N K T Q;H
Q I T G V O R K | Q O I G K T V;R
T L C N U Z A M | M Z C U A T N;L
K W X O P I C Z | Z O K I C W X;P
M Q D X E Y P U | Y E D P X U M;Q
T H G W Z V N F | H Z V F W T N;G
P Z G U O K F Q | K U P F G Q Z;O
R A C P T W L K | K C P W A T R;L
Y Q H V F O G N | F Q G V H N O;Y
Z D E G T J S N | G J Z E S T D;N
A T I M F O G B | G T F B M O A;I
H F M D V A G E | G A M F D E H;V
N O F G T Q R A | R N T O G Q F;A
Z Y M B X K Q O | B Z O M Y K Q;X
I F Y V O J A S | I V J S O F A;Y
D X B T S W V R | V X T W B S D;R
Z L M V F I J H | I H V F J M L;Z
U M L C O D Q K | O K C Q M D U;L
M I Z Y K P T D | Y K P M D Z I;T
I Y L S G P D T | T S I G D Y L;P
A O D W U P Z G | U W O Z G P A;D
E J Z U Q C G F | F G Q U J C Z;E
Y L K E J Z N W | Z N Y L J K W;E
N M V B G K X Q | K V N X M B G;Q
X V N I Z S T M | T X V I S N M;Z
Q Z T P N W H X | W X P Z N H Q;T
D H W Y I V B A | B V I D A H W;Y
B D Q S E T N Z | T D Q Z B S E;N
N G R P K S L X | L X G R P N S;K
W Y C I B L P V | P B C I V Y L;W
F M G B D J O R | F O J R M D G;B
Z A V F G T I U | G I Z T F U V;A
C K Q Z A F E T | C K Z T Q F E;A
H U B M D C R W | C B U W D H M;R
O S N A B Y W H | S A N Y W O H;B
Y Q V J F K L X | J Y Q F L V K;X
A H B N E V C X | X E N C B A H;V
K S A C Q D R L | L A Q K R D C;S
B E Y R P M K T | M E B T P Y R;K
C M V G R J L Q | C G R L M Q V;J
V P I K M W B Z | W Z P K B I M;V
W J P K F B E L | J E F L P W K;B
V I U B A S Q C | I V C S A Q B;U
V Z F E W T B A | B T V Z F E A;W
B V A Z E G K O | B Z K E G O A;V
T K X I M O J P | K O P T J M X;I
X V M K D L S O | S M K X V O D;L
J X A Y M L N B | L X M N J B A;Y
E P W H K I Y X | X W P Y I K E;H
O D P E F U V R | R P D E U O F;V
H T W J B I F Q | T I J H F B W;Q
Z N C Q L J W Y | C Z Y N L J Q;W
N U P E L X V W | U L N V E P W;X
V Y S I E D L T | E L T Y S I V;D
Y B C D O M P F | O P M Y C F B;D
Y Z F J U B I V | Y I F Z B U J;V
U L K R Y M X B | R X Y M L B K;U
Z M E H F Q L C | H F Z E L Q M;C
Z X V A M R I O | O V I Z A M R;X
O V Z C F H U A | V C H A F O Z;U
W J N D V T Q Z | Z V Q J T D N;W
M U K H B P L O | K B P H M U O;L
X V S F T Z R P | F V S Z X R P;T
X K C I Z O V J | X V K I O J Z;C
P J R M A N H I | H J N R P I M;A
V O D R L H M U | D O H U L M R;V
C J U Z L D S O | C Z J D S O U;L
N B R V E I L X | X L E V N B R;I
V M Q G N O W K | K Q O N M G V;W
I T L V B E D N | I V T D N B L;E
A C H J G X N O | J X H A O N C;G
L K S C G B U H | S K G U L B C;H
V K C M G B T Y | Y G M C K B V;T
W V R F B Z E T | R T V E Z F B;W
T Z W K F L Q B | L T Q W F B Z;K
W O F I Q N Y S | I O W N S Y Q;F
E T C U F S Q X | X S F U Q E C;T
D Z Q F S E B G | Z E D F B S G;Q
M J I S A P X L | I J A L P M S;X
H L S R Y K J I | L S I Y R H K;J
C E Y D T M O P | C O P T D E M;Y
N H Q G F E O L | H N Q L O G E;F
X K T J F V G B | F T X V K J B;G
L D U Z V M I C | M Z I V L C U;D
D Z O F T G V A | D O Z A G T V;F
Y C W F R O E N | R E W C O F N;Y
A L W X F N E V | V E A N W L F;X
U Q A W F X S I | X Q I A W U F;S
E O T N Q S J H | Q S T N E O J;H
C N H Z P G S Q | S P N Q G C H;Z
P O X C Q H Y D | C H O P X Q Y;D
T O W G B C Y R | G B O C R Y T;W
A E U S B R J I | A R I E B J S;U
X S A F P K Y E | Y F S K A P E;X
O Y V B G U Q M | V B O G Y Q M;U
P F Q M O T I L | T Q F O L P I;M
C G X F T V B W | T W C F X G B;V
U D M C Z F H T | Z T U D F C H;M
U Q V J F N K O | N O V J Q U F;K
Q W D T O E F G | T G D Q O F E;W
A C R F N G K W | F N W K A G C;R
W E D B L G M V | M W V D B G L;E
M O F I K C N A | O C A N F M K;I
K L N W C Q A D | W Q L N K A C;D
B G P V U S X H | B G V P H X S;U
A O Y U I K V H | K H Y O A U V;I
O M J T Z V I L | M T L O Z J V;I
Q M P H G L J F | F H Q J G L P;M
Q C H A P F U R | A U C F H R Q;P
X H U M V E Q D | E D M H Q V U;X
S N F L B O T H | T O H B L F S;N
J L X V W T C N | L V N C J T W;X
J Y L U Z H E I | E I U L Y H Z;J
K C H Q U J V Z | C K J Z Q U V;H
Z N S Y U V I F | U Y Z N F V S;I
Z N B T K R V I | I K Z T B V R;N
N X V S B W O C | V N S B X C W;O
K J V G F I A D | G I V A D J F;K
X P H Q B I W E | H I Q P W E X;B
R E U Q M J W Y | Q U W J R E M;Y
K S D G H U M A | K H M G S U D;A
L P V C B W H Q | B L P H W V Q;C
R E T I K Y W X | X I K W Y T R;E
S T Q L U K E G | S G T Q E L U;K
E I K P Y C O J | P E Y J O I K;C
L E T U S M Z V | E T U V M Z S;L
J I G T F M X B | T B M I F X G;J
B C I Z T P W R | T I R C B Z P;W
C U D T A O L W | U T A D W C O;L
W Z U I T D J F | Z I F W J D T;U
R A H Z S E L D | D L R E H A S;Z
B Z J O Y R F E | B Z F Y R E J;O
D B K Z Y U X W | W X U D B Z Y;K
Y I G J U B W N | Y W G I N B U;J
G X D B T F V J | D X V F T B J;G
O Q B Z W P V D | O P W D Z B Q;V
A Q W B K V F L | B K L W V F Q;A
M X I R K P F Z | X P F I K Z M;R
H O X B F E M S | X E M S H O F;B
Z C Y X M Q D E | M Y Q Z C E D;X
R J O P Q B D W | B J D P R O W;Q
U C Z H O K B L | H O K Z C L U;B
H B L V U F I X | V X F H U I L;B
N T G S K Y J L | G L Y J N K S;T
P Q S M U D I O | O M Q P S I U;D
M J V X K B U S | X B J M K U V;S
L B Z G O H D V | Z O B G L D V;H
K G Z D X N Q O | D O K X Z N G;Q
K H L R O V C A | V O C A R K H;L
G U H W C D R I | D C U R G W H;I
A W T Y C S N D | T S A D Y C N;W
P K X L F H N J | L K P X H J N;F
P L I N A M X U | N U A P I X M;L
B H W J Q S X C | X C H S B J Q;W
J D L S Y O U Z | L D Z J U S Y;O
R Y E G C A P U | R Y A E U C P;G
I G B O J Y A V | Y B A V G O J;I
H M Z K F B U V | B U Z F H K M;V
E G K P Y U A R | A R U K P Y E;G
C Y J N K Q M A | N M Y A Q K J;C
E S J Z P X F M | M F X E S Z P;J
K J R Q Y O F S | J K F Y O R S;Q
V G D L T P C N | N P T G D C L;V
U H J N E D M L | N H J L D M U;E
P J U I A H B C | J B U H I P C;A
Y X T S V U N R | X T V N S U R;Y
P L V X Z M Q I | Q L V Z P I X;M
P N T G A Z W Q | G N A Q W Z T;P
A G H E X K W B | E A W X K B G;H
F A N O X R I Q | A I F N X O R;Q
L H J A B Y C X | J A X L B Y H;C
D X Z G N R H M | G Z X H R D N;M
H E R X N U Q W | N R U E H X Q;W
K W I Y J L Q P | P J Y I K W Q;L
U S X N B G C A | C A N S X G B;U
C B I D J T S Z | B I S J T Z C;D
Q G W L J C I V | L Q J I C W V;G
U A V Q Y N W B | N Q V A W B Y;U
U J Q K G Z X V | G V K Z U J X;Q
Y E J H I X A Q | Y A J H E Q X;I
G Y V Q C A N W | V C A Q W Y G;N
Y U E K S X F O | K E U F X S O;Y
R J M G A W S I | M G R I A J S;W
P B U M O N Q W | O Q P N B U M;W
L R U B A K P J | P A B J U L R;K
X L O D Z H B V | O V L H X B D;Z
O P Q K D Y N G | Y K Q N G P O;D
P R K B J U O V | V B O J R K P;U
S Q X U C E O F | X E U O S C F;Q
M P Y Z C V I H | P H Y M Z V I;C
D W Q C B F O L | B O Q F L C W;D
R C F S J Q N V | R Q F C V N J;S
G S H U W N V O | V N U W O G H;S
B G W L P C V E | W P B C V E G;L
H W X O Z A V I | H I A X O Z W;V
S W N O T U M Z | M T W N U O Z;S
K D N A M G E X | K A G N X M D;E
F I L V Z R O K | F R L I O K V;Z
V U Q O J T D F | J T Q O D U F;V
Q W M C Z J I O | I C W Q M O Z;J
M S E C Z A N J | N M J A E Z C;S
Q U N R Y X Z S | Y Q X U S N R;Z
Q Y W R U E P Z | E Y P W U Z R;Q
A C F E O I W P | C P W E F I A;O
V G A U O H C I | G C A I O V H;U
B A I F D Z W M | I B A D M Z W;F
M O Z A V E U Y | U V O E A Y Z;M
X M D F O Q J L | O X Q J F L D;M
F Y R C U T S H | T S C R F H Y;U
J I O T H Y D W | Y T I W J O D;H
P D F W X S I V | F S W D P X V;I
P R S I Q N F O | F N Q R S P O;I
J D N S I C K R | N S J K R I C;D
W Y G V K B A O | K B G Y W V A;O
H O A K V I E F | H V O F E I K;A
Z M R W D I L Q | R D L I Q W M;Z
C D T R E K Q Y | D R E Q Y C T;K
S I N R P O L Q | S N P O R L I;Q
J Y A I P M Q E | E Y P I J Q A;M
B Q M Z E S V G | M G S Z V B Q;E
R J C F T H W Y | R J C H W Y F;T
M G U Q C D T P | M Q P U D G T;C
B E P F N Z R L | N R B F Z L P;E
T Q D K V I A O | D T K Q A I V;O
V D M Y P W H X | Y W D P V H M;X
U G X V K J F T | U V K J T X F;G
G C W K T D N R | T N R C W D G;K
R X S N O E V P | R P X S N V E;O
B C Z Y G O V I | O Z C V Y I G;B
R C H W Q G T V | T C V G R W H;Q
L G F Z H M D P | H G M L P F Z;D
Z F N E R D L O | N L O F Z E R;D
P K W M V R H I | M R V I W K P;H
K W B Q P D F Y | Q P F W D Y K;B
R H W E M Q D P | H R D Q P W M;E
G U W R D A Y T | D Y U W A R T;G
K G X Q R F O I | X I G O F R K;Q
A E D O V W L J | J D V O L A E;W
A Z Y J C X D I | A Z J X Y I C;D
O F U N Q A W J | Q J A N W F U;O
D C X B O I Y Q | Q B D X Y I C;O
J I Z S O X V E | E S J I X V Z;O
P F O N R H D X | H N O F D R P;X
L X G Y U S P A | A P Y S L G X;U
H I Z M U V N D | Z U V N M D I;H
H W R N Y C E D | C W N E Y D R;H
X A D C L H E U | E D H C X U A;L
N M T H L V A I | V I T M L H N;A
A S B V P E I U | I A E U P S V;B
T X U Z J I W F | U Z X W F I T;J
C L G K O B V T | G C B T L O K;V
D Z Y H F K J W | J K Z D Y W F;H
X J P F H K S A | K S X J F P A;H
F H P J O C L T | L J F P O C H;T
T F Z D A C R G | F A Z G R D C;T
L R M Y C B A E | C Y L M E A B;R
S C A I P E G R | P R I G E S C;A
L U P B F A G I | G B I L F U P;A
A L Q B R H Y T | R L H B Y A T;Q
H V A Z L Q U E | Z H E V U A Q;L
O U N A W D B K | B A U O W D K;N
X R B W T S M D | X W T R D M B;S
C E Q D U B Y W | C Y E Q W B D;U
R G U V H K X N | R N V H X K U;G
L F Z Q E D A B | B D L F Q Z E;A
M W L F D U S P | U D S P W F M;L
U K Q V L X I D | Q L X I U D K;V
L S G F P O J Y | L G F S Y J P;O
Y T P L C H B U | C L B T U H P;Y
M R B S Q E V I | R I E V Q B S;M
S C I M X Q P Y | S C Q X P Y I;M
S L M D H Q B C | C S L Q M B H;D
P S N Z O G K Y | K Z S G Y O P;N
C G U J X P O E | U O J P X C G;E
Y G B M O P H F | G B H F P O Y;M
Q D U Z W V F H | V U Q F H Z W;D
Y S R Q P F U Z | U Z Y P Q S R;F
S Q C K L T U E | S L Q E T K C;U
D K M B I J R L | M L B J I K R;D
K M H G B A Z S | H B M K A S G;Z
N P G V T F A B | T G F A B P N;V
L T J K Y Q V B | B Q J K T L V;Y
S G Y C M P H B | Y G H P M C B;S
G X U T R O I C | X R O T I G U;C
I L Q Z F E M H | Z E L I M Q F;H
F C A Z U S V P | Z S V A P F U;C
V Q B A W N H D | Q A D V H N B;W
Y T Z N B J U M | Y M B Z T J U;N
P I F N L T H B | I F B N H P T;L
H Z D O L E K W | O K Z L H D W;E
E P M S V G L O | S V P E G O M;L
E Y I H V K M C | E H Y I M C K;V
Y B W F T I K G | T W B Y G I K;F
I Q A N W M B G | I G W N A Q M;B
D U B F V O T C | B F T O D V C;U
S K C Y A F Z T | T S Y A Z K C;F
I R J Y B N A K | K Y B J N I R;A
E I R G B K D P | B D R G P I E;K
O Q T D J F H L | Q F D L O J H;T
F P E C H N Y G | C E P H Y G F;N
M O Y W N G D Q | G M O Y N Q W;D
Y A L M X N J U | U Y A L X J N;M
G L Y W Q U T S | U W Q T S L Y;G
X O L E W P M N | W N L P O E X;M
S F Z T W D Q K | Z W K S T Q F;D
F V N L D R H C | N R C F L D H;V
P O V Y D W H N | P H V O Y N D;W
M Y K A L C N H | C N A Y M H K;L
R Q U K B E I G | R K G E Q B U;I
J Q C T X U F H | F H T X C J Q;U
I N V S Z G T J | Z J G S V T N;I
I G W B C R L Q | B W L Q I C G;R
K S P O C A U B | P S O B K A U;C
G M Q A F I B S | A B S I M Q F;G
M N S F O C D J | F S D C N M O;J
W A X V O M K E | E W M O A V X;K
S M Y F N C V Z | S V M C Y F Z;N
G D O W M J B K | O B G D W J K;M
U V Y M S W C K | K M C V S U Y;W
S L U D Y E A I | U Y A E S L I;D
Y H K F V A W N | Y F V H A K N;W
Q P B N L H F M | L F H P Q N B;M
O S F H P V C D | V S D O C F H;P
A I Z P T B L G | L B I A Z G P;T
P Y C V X G O R | C Y R V G O X;P
S A T O Z V J C | Z O A T V C J;S
Y H S I P L W K | H Y L S W K I;P
D Q A X T R U S | Q D S A U T R;X
M R P E H V N Y | H R P V M Y E;N
U I M C Y V R K | C I K V U R Y;M
I W H C S B G R | W C B G R I H;S
O F K E W X J H | H J O X K F W;E
U X F T Z M H O | M Z T U X H O;F
P J S T F I G Q | Q T S G J P F;I
E X C A U L J M | J M X E U C A;L
C Z V S Q L J P | S Q P V J Z C;L
M T N G Q J X A | M N J A X G T;Q
X V Y N L U F J | N Y X J F V L;U
O Y D J I R H E | D I O J Y H R;E
S Z J E G R U I | U R Z I S G J;E
T H W J V R K Y | V J W K H R Y;T
I Q M A L D U S | L A M D Q I S;U
W K Y H S I L R | L K H Y W S I;R
Z W O B U H D L | H U O W Z B D;L
L Q I D X S B T | I Q B X S L D;T
T X I B U A F W | F X U T I B W;A
Y I W D N S T X | D Y T S X I N;W
A Q G W I R H C | R G Q W H I C;A
T Z I K X S M P | I X P K Z T S;M
C X M O W I E F | X O F E M W C;I
Z U I H E F P W | Z E H F P U W;I
N U J K X G M Q | M J K N U Q X;G
F E W C Q T Y R | Q W T E F R C;Y
V B A C I S L K | I A L C K V B;S
A C V T Z P W D | A V P C T D Z;W
P S F R A J I X | F I P X S R J;A
L I Y M S W A J | I M Y L J A W;S
G B V K U F W Z | B W V Z F U G;K
R K D O A L C V | A C R K V D O;L
L H D J Q I T S | I T S Q H D J;L
A L P K R V Y M | Y A R M K V L;P
Z W T N X R O P | O R T N P W Z;X
N I Q A E V Y X | Y X N A I E Q;V
S M P N E C A G | S G C N A M E;P
C W Z M P D J Q | Z M W J P C Q;D
R F A W M Z U I | I U F A R Z W;M
N B G K O F Z Q | Z N O G B K Q;F
Z P U A N B T W | Z N T W A P U;B
P G U H X D Z B | G Z B D X H P;U
O U D P M C K H | O M U P D K H;C
M D P T Y A W O | A O P D M W Y;T
I J V O X L E Z | V E I X L J Z;O
R F I X H M E W | F H I R W M E;X
P T I W F M U E | U F W T I M P;E
C Z F P Q T X A | A T Q X P F Z;C
M F L U P H I A | M H P I A L U;F
N J V D W M B U | W D J M B U N;V
P D A Q I B G S | Q S G P D B I;A
V W J Y K Q P S | K S W J P V Q;Y
A K H Q V I P S | K I Q P A V S;H
M V Y I U X S Z | S V I Z M X Y;U
I N L P T C G J | C T I L G P J;N
T E K B N Y M J | E N M J B T Y;K
M C K U O H F E | C F K O U E H;M
W Z V X R F Q P | Q V X F W P Z;R
C I P H S X Y M | P M Y I S C H;X
O Q K Z I V G M | V Z Q O I K M;G
S O L G Q A Z W | S O Q Z G A L;W
C O I E J S H Z | I S E O Z J C;H
K U V B D I Z S | D U V Z I B S;K
A B J N G W S F | W J N G A F B;S
L S Y A R K W M | M Y R S W K A;L
Y L R E F T D U | Y E R D T U F;L
C T D L H B G I | B L G D I T H;C
O G D S Y T C H | D H O T Y G S;C
C Z Y P H T L J | L C Y Z P J H;T
R E A W J T Z X | T Z R X W E J;A
G R U S N B V P | N R V S G U P;B
H D R C Q Y K M | Y D C R M K Q;H
W P L B X F I H | I H L F B X W;P
H Y D B F G A M | B D G H M F Y;A
T C I J A K Z H | I C H Z K T A;J
P T M B D Z N X | Z T X N M P B;D
Z E V N X M C U | X V U M C Z N;E
Q S G Y B R F T | G F Y S R Q B;T
Y J B R O E Q W | O W B E J R Q;Y
D U V A F G Y E | U F Y V E A G;D
M G W V E H B C | B W E G M C H;V
J U I Q M G Z B | M G I J U B Z;Q
F J D H C A T M | C H J M D F A;T
W Y V A H R O Z | H A Y Z V O R;W
L R Y F S U B D | R D S Y B L U;F
I F Q T J U N R | U F T Q J R N;I
Q U O P W I C T | I U C T O W Q;P
P H K U O Y B I | P U B I H Y O;K
D W I O E U J Y | U D E O Y W J;I
I F E M C T Y P | I Y C T P E F;M
M E T I K A P U | I K E M P U A;T
I O C Z P J X L | L I X C Z J O;P
L G J Z I T O R | O I G J T L R;Z
D O C T I Z E X | T X C Z D I O;E
H N F B Z T E A | N A H T Z B E;F
J Y V L T C F U | L U C F J Y T;V
A Z Q P F O J T | A F T Q P J O;Z
G P M I V Q L O | M I G O L Q P;V
H R J A X U G V | G A H V U J R;X
F O B M V X A Y | A F Y X M B V;O
W S V L H N G X | V W G L H N X;S
O E S N Z J R V | E O V S R Z N;J
F R G T A K W B | F A W B G T R;K
J L H M D Y U K | H L K D M Y J;U
F Z A I Y N E J | Z A F J N I E;Y
G F S I D U M J | M S I F U J D;G
R A K H S V T Q | V H A Q R S K;T
X B Z M F Q C V | M Q C B Z X F;V
P Z D T I A N O | D P A N I Z O;T
A U O V M E I B | M I O V U A E;B
M G V J D L I A | M A J L G I D;V
T L D B E M K N | N E D L T K B;M
I U J L G Y T Q | L Q T G I J U;Y
F D R H G M T S | F T G D M H S;R
M G N C I U E K | K M I E N C U;G
X V M E Z K Y O | E O M Y K Z X;V
Y W Q C E X R V | R W Q X Y C V;E
A Z L J D X Y C | C A D Z L Y X;J
X P R E J S G H | G E J X R P S;H
D A X I B T G P | G X P T A D I;B
W O H S X Y G V | Y V G X O W S;H
Y T G S I Q A L | Q Y A I T S G;L
X G U W B C V J | X V B U G W J;C
F V W P Z A S X | P V X S W F Z;A
B K Y V I M O W | Y M O W V K B;I
I W Q M L C A R | C W I L A Q R;M
R J C Z I S U P | U S C J I P R;Z
X P E R K V F M | F M P V E R X;K
J O D P V T Y R | D V Y J O T R;P
S G W R E D U X | G R E W D X U;S
J L X A N Q D R | J R A Q D X L;N
A K Z M P B R O | R M B K Z A O;P
U F W J E H Y N | W F N U E Y H;J
V D P H L R N S | V D N H R S P;L
B W G O D A L K | W O D L K B G;A
B Z I D V U J G | Z D B G I U V;J
O U M W X C V J | X W O M C V J;U
X R K F T U M G | G U M X F R K;T
M H C T Z N F X | N M T C F Z H;X
U M B G E V D Z | B U M E Z V D;G
V L A F J Y I T | Y J I V F T A;L
K T A H O Y B L | Y A L H T K B;O
X F H C O N D B | D C O H X B F;N
K D N R S A E T | E S T R N A K;D
F Z C V B M U H | F M V B H C Z;U
M U V O K A G F | U O V M A K F;G
U R Y T G K S P | G R Y T U S K;P
Z Q V P S A K X | Q X S A P K Z;V
P U A B D X W O | X O P D U A W;B
S I A R L N J Y | L J Y N A R I;S
T G I E Q D A W | I A G Q E D W;T
N I E S X C P B | P N C I X E S;B
Q X N F L A O P | F X N L P O A;Q
P X M Z C T G J | M C J X P T Z;G
X B L J C E N F | N F X J C B L;E
X W Z N P I M T | N P M T W X I;Z
J I O Y P V M B | O P M Y J B V;I
Z R V U D N I T | D V U N R T I;Z
W R A B H G O J | A B J H R G W;O
E S Y G M U O N | E O S G N M U;Y
R B M Z X Y A E | Z M E X A B R;Y
H C Z S K O B W | O B C Z H K W;S
K F D A Y T I R | R F Y T D I K;A
H Y V W J C M S | M J Y W V S C;H
U R W N Y X G V | Y X R G W U N;V
F G O I J T P C | P O F C T G I;J
B D P Q S M T A | Q P B A T D M;S
A M S E U T Q W | T Q E U M S A;W
N V S W K L B O | S L N W K B O;V
I E K W A M V X | V A M K X W I;E
B W N T H E A Q | B W H N T A Q;E
N C Z F G R P S | F C S Z G P R;N
E Z M O G R P C | O G M C Z E P;R
S P H I M B Z L | H I M B L Z P;S
Q P N L W T C Z | W T C Z L Q P;N
U F Y B G A R S | F G R B S A Y;U
H P G F D C E X | E G C D H P X;F
F X C Z G V Q A | V A Z F G Q X;C
U A W F B R X M | A R W X F B M;U
H M U S W K Q P | M Q P U H K W;S
G R I E S T P F | S P F I R E T;G
C N D V R F E J | J C D R V E F;N
Z P G C H W X B | W C X Z B H G;P
L P I S O F G T | L T P O S F I;G
S V E N D O B X | O D N S B X V;E
O L X K N Z S C | N Z S O X K L;C
U M Z W H X J T | T X W U H Z J;M
D T O F W P N I | N P F O I D T;W
W Y B V H M T N | V N Y M T H W;B
Y F M D N W H E | M D W E Y H N;F
P N T K X A B D | T N K B A D P;X
K Z M V D C S U | K V S Z C D U;M
E L B O R D S V | L V R E B D S;O
W O X M L A I V | W I O X V A L;M
P Y N U F O R Q | Q Y R N O P F;U
J K N Z U F I T | F Z K U I J T;N
B S Y I D L W J | Y L I S W B D;J
L F R P C V J W | F W R V L C J;P
Y H V G C F O R | Y G F C H R O;V
P A B O D U K J | D U P K A O J;B
F T H S G K C X | H C S X T F G;K
F O M L J N G H | F L J H O M G;N
N M X D H I R F | I R X D F H N;M
V O N T X Q P S | V Q O P N T S;X
R B K P V S L W | W S P K B V R;L
K P Z V H T D I | V D Z K T I P;H
U J T B K C W D | J W K T C B U;D
J Y E A L I W Z | A I Y Z L W J;E
O J D T E L U K | J O U K L T D;E
V I G B K U J R | J G U K I V R;B
G Y B L T F R P | P B F T G L R;Y
U W K X H O R C | C H R K U W O;X
O N P A D W Y R | W O D Y A P R;N
T M U Q N V Y L | L U V Q Y T M;N
D O Y R G M V K | K V R O M Y G;D
K H U E M L C Y | Y H C K M U L;E
X Y A P R C Z O | Z R O P X A C;Y
E B K S I W H P | K B W H P E I;S
S I X U J W A V | I S A W V U X;J
W A O L M D N C | M L D N W A C;O
Q W V N Z U C L | Q L U C Z N V;W
O Q N C F E B H | N B E H F O Q;C
P Z O M N Y L H | Y Z O L P N M;H
N Z C R A O Q D | N D Q R Z C O;A
S T Y N B Q X I | T I S N B Q Y;X
E P N G Y F W O | Y N P E W F O;G
O U J P F L C V | F V U J O P L;C
S Q I W D C A B | B C Q A I S D;W
B P Y N S K Z A | K P Z B N S Y;A
V A X B E Y N R | E Y X N R V B;A
G E O K J P Y L | O K Y J G P L;E
S P Y I G X U E | U E Y I S X P;G
O K D H M R J A | A R O J D H K;M
I Q P N O U S G | U S I P O Q G;N
U Y W B A Z K Q | U B Q A Z W Y;K
A T M V Z H E G | E G A H Z M V;T
T X J O K B L W | K X T W O B J;L
M Z O R H Q U V | M U V H Q O Z;R
Z J W H U G Q C | H Z C J Q W G;U
S Z N I B R W Q | Q I R B W S N;Z
F K T X Z V D Q | Q V F Z T X D;K
M V Z X E U H Y | V H Z Y X M U;E
K L Y U R X J Q | L R X J Y U Q;K
D X J S R Z E A | R E A J Z S X;D
J G D N Z O L X | O D G Z L J X;N
C H B D G W J Z | Z W D H J G B;C
X U M F K D W R | U W K X F R M;D
G Z Y D C E O K | K Z D O G C Y;E
D B H O Q F P K | D K F P Q B O;H
L Y R F D Z M N | M N Z D F Y L;R
U B Z D F V Y G | Z V B G Y F D;U
R H X T I N O K | O N R T I H X;K
B Q J S C X R Z | Q J Z B S R X;C
T I Q N F H V E | Q E T I V F H;N
P T D B A W U O | T P U O W A B;D
W E F P R X B Q | E Q R B P W X;F
D R H O A Y F X | O R D F Y A X;H
Q X Y T E S M K | K Y X E Q M S;T
W M B R N Y E Q | M W R B E Y Q;N
X R D Z U T V I | T X Z I R V U;D
W F N T L A Z H | H Z F N T A W;L
H Z O W T I S F | O S T Z I W F;H
R H V S Y O I L | R H S O I Y V;L
A O T L B W G D | G D W B L A O;T
G L P Z N B O M | L G N O M P Z;B
Z J L P U M B X | Z U J B M X L;P
U A I X F Q Z L | A Z F I U Q L;X
I L M Y U D J F | M J U F I L D;Y
E K Y Z A B T S | B S K Z Y E A;T
X D U P Y B A V | D V B P U Y A;X
U O D L I X Y A | L O U A X Y I;D
A Z J G O Y Q V | V G J A Z Q Y;O
D Y K O X G N V | X Y O N D V G;K
C K B Z J D S L | J Z C L S D K;B
Z S A P O W U M | S O U P W Z A;M
V Z W Q F G L P | G F P V L Q W;Z
C W B O E U K V | E B V C O U K;W
U L C O S E F P | P U S E F O L;C
C V S T K O N Y | C T K S Y N O;V
V J P D L E K A | L P D J A V K;E
R O E J M P U A | R E M U O P J;A
C I O B M L H X | O X I B L H M;C
M G S W T Q B D | T M D G B W S;Q
R Q E K Y N F J | E Q N K J R Y;F
D M C P I R A L | C D L I A M P;R
X O F Z A I D U | I A D F O Z U;X
K T R V G P M C | V M K P G C R;T
V H A R Z M S P | P H A S Z V M;R
J K C X G F R O | J C R F X G O;K
E J I O G B W Y | I B J W Y E G;O
D J R Q O L K G | D G Q J L O R;K
T U D G C F K A | U C G A T D K;F
V L C U W R H K | V L R C H K W;U
X M A R C Z B W | W Z A X R M B;C
S Z W N L A K O | S K Z A W L O;N
L G H Z Y S O D | D G Y L O S H;Z
D H J C X T W U | C U W J X D H;T
Y N L D X G J E | G J L Y X N E;D
J R C P M E H V | J V M R E P H;C
V M N H Z Y Q I | Q Z H N M V Y;I
Y C W G S J L D | L C D Y J S W;G
Q Z X B Y G F P | Z Y G B Q P F;X
B C R L F A Y P | Y C A L F R P;B
P W Z I K T L N | P K T I N W L;Z
V S Q W E D H R | E W S Q D V R;H
U O W N P M Z K | W N Z K U P O;M
R Y A M V S I X | X Y M V R S A;I
Q Y O C M I X E | Y C M O I X Q;E
A W H E S D B R | H B D A E R W;S
K A C H S L B F | S F H K A C B;L
A V T J M C G B | T V C G A M J;B
Q Z W I D L Y B | Q L Z W D I B;Y
E L U T X G V M | V X G U E M T;L
O U X D Y G F K | Y O D K U X G;F
J R X V E P G A | J E A X R G P;V
H I B A L J V Z | B H J I V Z L;A
I S B R A C Q K | K A Q S I R C;B
R V O H S B I M | B M O V H R S;I
M V R Q A H I P | A Q M H P I R;V
Q C S N M A K L | Q M A L K S N;C
S L M Z T C V D | T L M S Z D V;C
A Z B H M Q O T | H T Q Z A B O;M
Z D Y S M V R O | S Y R M Z O D;V
P Z L R S N H T | N R T H L Z P;S
N J F Q T H I R | F R T Q J N I;H
A P Y T K L H G | T G H L P K A;Y
Y F P E R X K O | F K E Y P R X;O
