N D M X R E K Q | N E D Q K M R;X
Q R V X S U T K | K X S U R V T;Q
B A S T L X R V | T B A S R L X;V
K B U I N Z D R | D Z I U R N B;K
S O F D T U R K | D S R T F U O;K
P C K H A R G B | H P A K C B G;R
V N G K F B J I | V J F N B K I;G
S Y F C D W X L | W F C L X Y S;D
U N I D H B E Z | B U Z I D H E;N
H T E G J R Q X | E R J H G Q X;T
G S K R Y B I N | G K B N R S Y;I
W O Z V B H I T | T Z W O I B V;H
O Q Z F W D M R | O M R W F Q D;Z
Q U G C Z V W M | U G Z C W Q M;V
U V J N I F X L | V N I J U L X;F
H F T W A P Y V | A T Y F W H V;P
T J S K F R Q Y | Q R S J K Y T;F
O Y A D N L M K | N A O D K M L;Y
L F S E P K X T | F P K T X L E;S
H J B S U F K C | K H F J S C B;U
X V D W Q S U I | U V W S D X I;Q
X O F U Q W B Y | U Y X O F B Q;W
T W B I G E C A | I C A B T E W;G
H G P M W V X R | R X H V G W P;M
H G N U J O R M | J N O R U H G;M
C R L I S V Q J | L I S R Q C V;J
U R O Y K I S F | O Y I R F U S;K
W L O F D I U J | W U D J F L I;O
Z I W K M Q D F | D I W M F K Q;Z
F N A T C Y G W | A N C T F W Y;G
N Q U Y K I F M | Y K F U Q M N;I
X O L D Q F A K | F D Q L O X K;A
D K M O I Z A B | O Z A M D B I;K
O C T L H P Q R | T C O L Q H P;R
W H U B I A G L | B I U A G L W;H
B L R O G P A U | G R U L O A B;P
P U O Q Y R S B | U Y Q R P S B;O
D T M W E U H N | U D M N W E H;T
X F U I S T K L | L X T K I U S;F
D A S G E F R L | A S F L G D R;E
N C R B H D Q O | B Q D C O R N;H
C A N V Z G J S | V C S A N Z J;G
R B S O M C K Y | Y R C S K B O;M
J W G K V F Y U | F W K Y V J G;U
N Q I O F U B C | F U N O C B Q;I
W T N X C Z K M | C T K Z M X W;N
L I F Y B W G C | F L Y B I G C;W
C L Z M Q N E U | M U C Q L Z N;E
M L D W B H V Q | B Q M H V W D;L
P C X G Z Y S Q | P Z S C Y Q G;X
U L D P T G O Z | G D O U T L P;Z
D B L A H X E J | X H A E J B L;D
V L G H Z O Q B | V Z Q L B G H;O
L Q O Y U X E W | U Y E X O L W;Q
V R P J D W I G | P G J W D V R;I
Q A J M C T B D | D T M Q C B A;J
Y U P C O R X Z | U O Z P C R X;Y
B Y C V Z A O T | T A B Z O V Y;C
J B N W M I E Y | W E M J B N Y;I
X L R D J T P M | D M X L R T J;P
O M B S J T P K | T J P B S M O;K
S D T W G R I X | S X W D R T G;I
Z Y B W G U P J | Z Y U B W G J;P
S L K U D P T M | L P D U T K M;S
D Y B S A J F E | A J B S D Y F;E
K U Z V H G W D | Z H U K D G W;V
D G Y E I F U Z | G U Y F I Z D;E
N Z E F Q V X J | E Q J N X F V;Z
A W F I Z E R V | V F R A Z E W;I
G V B E X O M T | V T G O E X M;B
Z M E N K S R Y | M Y N S Z R K;E
O C Z N D U P V | N Z U P O C D;V
W S C J D Y K M | S W J D K C Y;M
Y T Q E C G L O | O Q Y E T G L;C
Q Z G C Y I R M | Y G I M Q R Z;C
G D E J I A P V | V I P A E D G;J
J X I M Q K W T | W K M T J Q I;X
X Z W T R U C G | T Z R C X U G;W
C A N P D H S T | D S C T N P H;A
I L E J C H Y M | M L H C I E Y;J
H C D T Q G P V | T V D H C P Q;G
F R M H W U V B | H F B V R W M;U
Z K M C R N U X | M R K Z C N X;U
K S R G D P H E | S P E R H K D;G
L H T B D Z X N | D N X L Z H T;B
B X N F M Z C W | B X Z W N M F;C
P F D A S H I L | D I H F P A S;L
X C F U A R G J | J U G C A F X;R
Z C V L R Y A W | Y W R Z A V L;C
J C K L M T W S | S K T M L C W;J
Q Z E F O L H W | E L W F Q O H;Z
K V J O R Z A S | A J Z V R O S;K
R U E C X T W S | U E C T W S X;R
Y R M C L U X G | M L G Y U C X;R
Y Q I R B K C A | K Q A Y I R B;C
L N B U O M A I | N O M U L I A;B
L W Z M E D O Y | D Z L O M Y W;E
R I A K L U P Y | Y P I U L R A;K
Q S R I J W B T | W Q S J I B T;R
T C U B S E Z L | B Z S T U E L;C
Z L I C X E M R | C Z M E L R I;X
C B Z T N X M V | T X B N V M Z;C
X L R W D A S O | A O R W X D L;S
S T V H C M I F | C H F M V T I;S
Q I H W U G B L | W L G I Q H U;B
C K N M R X O D | N C O D M R K;X
P J A R Y I Q S | Y I A R P S Q;J
I S Y G Z B X C | S I G B C X Z;Y
W F T G L N D P | L G P N D T W;F
V B C S Z O P Y | Z V Y O P C B;S
G Y X K M T N C | X G T K N C Y;M
X P K L O G Y S | O L S G K P Y;X
O B N I P D X F | D X I N P B O;F
N A O U S G J V | A J N U V G O;S
G H R L O T S P | R P O G S L H;T
K R Z E Q U M V | E R Q U K M V;Z
N L D Z E W G S | S W G Z N E L;D
K O P D W M T Q | W Q T O M P K;D
W I P C U T O H | O C H U T W I;P
S X P U T F Z D | T D X P U S F;Z
U J P G I C O A | C A P U O G J;I
B L K J E D P C | C K L D B J P;E
N U I T Z F H K | U H Z K T I N;F
N A P W F H Y D | D H A P Y W N;F
M J H U W Y N E | M W Y E N H U;J
L J M A D R Q T | D Q M A J R L;T
W S Y G B N A L | S B A Y G N L;W
E A P J Z G H X | Z H X G A E P;J
A L P R X W Y B | A Y B W P R L;X
S G H K T N I O | I N K S T O H;G
Y R S Z D L P C | R S L D Y C Z;P
S P N D W A E H | S N E P A W D;H
S B Z H T F R C | F R S H Z B T;C
G O F N M H E D | D E G N H F O;M
F B K R U C X G | C F X R G B K;U
H B N O Z G T I | I Z O B H N G;T
R O N P Q Y D W | P W Q Y R N O;D
P B H J L G Z Q | J Q P G Z H L;B
F D X P O I Q A | D O X Q I A F;P
P Z Q O U N Y D | O N U Y Q D P;Z
Z X P N E K F G | K E F G X Z N;P
F B D M I J H Y | D B M J F Y I;H
X N Q V L F E T | X E F T Q N V;L
N H K T Q M E V | N M K T V Q H;E
D E Y W G K F N | G E N K W F D;Y
C Y Q J M G A U | C Y A J M Q U;G
F A W P H D Y V | W H Y D F V A;P
X P R G B I O M | X M P I R B G;O
A W S B X M K P | P M B A X W K;S
P V D Z R G J N | Z D R N V P J;G
T Q D A E U L N | E U D A Q L T;N
A W S C B G J I | A J C W S I G;B
Z Y S B A R N L | Z L S N Y B A;R
B W E U M R D Q | B Q R M D W E;U
C U Q H W I O D | Q I O U C H W;D
V P O Z N D I E | V O D E I Z P;N
U H X V W G T D | H T D X V W U;G
F X T C N Y U O | N O Y T C X F;U
A B Z C Q T D P | T B A C D Q P;Z
H M T D N U F L | H F D U T N M;L
R Q P U X E H T | Q X R E U P T;H
C M J I N Q T G | N J G T Q M C;I
F H Z N R O M V | H R N Z V M O;F
E A M D Q G U J | U M D E J A Q;G
U R V A H O T W | U R V H W A T;O
I X R G M B A Z | B A Z X R I M;G
I B P H Q C U Z | I B H U Z C Q;P
K S V Q Z M G O | S Q V G M O Z;K
O A E Y R U V G | U V O R G A E;Y
N S V E D B T C | E D V B N S T;C
K N Y Z R G B Q | K N Q Y B Z R;G
I M N L O W A X | O I N L W A M;X
K I A Q F W L S | F W Q S A K L;I
H U T D G X L I | L I T D U X H;G
F Q U R O Y I H | F H Y I O Q U;R
W O U Z C B K F | F Z B O C W U;K
W H Q C I F V X | C X I W Q V F;H
O I S R G W J X | R S J O G X I;W
Y W F I T C R E | I W R F Y C T;E
U L C N D M Q B | U D M B Q N C;L
J D T M A K X W | D K T J W M X;A
B G O A J X M W | X G B O M J W;A
E N I R K T A H | A R I N H E T;K
M F L B R V N T | F L V M N B T;R
Y H O R L U B D | Y R B H L O D;U
Q K A M T I C W | Q W C I T K M;A
N A D M S X Z E | N M E S D X A;Z
J H Z B P W S E | W S E B J Z P;H
U H D O P T C Y | T C H U Y D O;P
N V H P D L X I | D V I L N X P;H
E T O N R G P Z | G T P O Z R N;E
Z Q B A W I S G | Z A S I G W Q;B
A U J I Q L M K | M J I A Q L K;U
Y E O P V I N G | E N I P V O Y;G
S U N L V X O M | O U M N L S X;V
T K C H A Q M L | C K A L M Q H;T
M G U H K C T E | C T E U M G H;K
G O K M T A I Q | Q K A O I M T;G
R T O Z P A J F | Z A R T O F J;P
P L D M O I H E | H I E D O P L;M
T L E K C W Y O | C W E L K Y O;T
J G F O A Y C Q | A J F C G Q O;Y
L B S N T Y V W | T W V S L N B;Y
E V W I Z U R Y | V Z I U Y E R;W
J R U C B L P M | B R J P L U M;C
C S J L W G P E | S P E J C W G;L
D H Z J L P X N | Z N D L J P H;X
P J C E U N L Z | C Z E U P N J;L
U F E I H Y R N | H F U N Y E I;R
O A K E H D S Z | H K O S Z E A;D
J I H L M C E S | S C L H E M I;J
V B N G D J O L | G B O V L N D;J
X I J G B Z U S | S I B X U J Z;G
G H Z L N M O J | O N M L G J Z;H
N R W T F K Q S | R N F T K W S;Q
B V Z O X D L R | L Z B X V R O;D
N W L P D R C J | D L W C N P R;J
V P R J D M Z Y | R P Z D M V J;Y
G H K V D C T J | D C T K G V H;J
P A G M X N I C | I G C X M N A;P
P W Z F M V Y L | M P Y V W L F;Z
I E B K C J V T | K J T E V B C;I
J X K B G V S I | K B J S X I G;V
F X M B J A V E | X B M J E F V;A
V A L I Z T O P | L T Z O P I V;A
F R U Z E N I D | U I N F D E R;Z
X Z E H F C B K | X K C B F H Z;E
C S P F D G H T | G S F C T P H;D
R O K U B Q H Z | Z K H U O R Q;B
B V G I J P D Z | J B V P G I D;Z
G Y C U L J K V | U Y L J G C V;K
T Z A L U X G E | Z X T G U A L;E
V G E H A D S P | D S H V G A E;P
X F G T D L Z V | Z V X T D L F;G
Z B X V T A O Y | X T B O V Y A;Z
S T I Q B J W H | S Q I J T W B;H
E F U Z W A O B | E U B O Z A W;F
P B R I U N Q G | P I B R G U N;Q
N U G C Q J B M | U C J M N Q G;B
R L C Y N A V S | Y R L V S C N;A
V M A Q O W K Y | K Q O A V M Y;W
Y T N R M C Z E | E T R N Y C Z;M
X Z W G N F D L | N Z X F D G L;W
Q V D Z W R J L | Q L R Z D V W;J
W K M R F V G P | V F M P G K R;W
R D P I S Q K W | K R I D W P S;Q
G H N R V T W E | N H T G E R W;V
M U H Q C J F Y | Y M U Q F J H;C
X P W Z C S I R | X W Z R I P C;S
D X Z V O C F R | O X D C F V R;Z
Q K V O N U Z W | K N W Z V O Q;U
H W F V T L G E | V T F G H E L;W
X Z C G Q N I V | I V Z X N Q C;G
J A O Y F C V Q | J V Q Y A C F;O
H Y N K R Z D Q | Y D K Z R N Q;H
D M V K Y S B A | B M Y S D A K;V
O K J V P U H B | U V J K O P B;H
R H Q D T U Z M | U M R Q H D T;Z
H I G V Y O S X | S V O H Y X G;I
H O L B F S I R | R L I O B H S;F
M V F D Z P Q E | F E Z Q V M D;P
Z O W K A L E P | O W E A Z L P;K
S O I D N V Z Q | Q O Z D V N I;S
B X Q K N H D L | D L B X N K H;Q
F G U B Z S I X | F X Z G B I U;S
H Q X W Z Y T M | X H M Q Y T W;Z
M T V G F E Q Z | Q V Z E G T M;F
Z W R L Q X J E | Q R L E X J W;Z
Z S Y P N V L G | P V G S N Y L;Z
P W F J H D O B | H O B P W J F;D
T Z U A O R E N | T E U Z O N A;R
H O I D S R C Q | H R D C S O Q;I
B O I R U D E P | P D E U R I B;O
W P X J I Q M G | J Q G I W X P;M
H O L V Z R N B | V Z L N R H O;B
S H A Z N Y K G | N K H Z G A S;Y
N D T Z F R Y K | Y Z F D K T N;R
V S W O Y H M T | S H T M O Y W;V
D H T I G O B K | O T I B G D K;H
J S L X E D C I | L J D X S I C;E
N E L K B X M V | K B M V N E L;X
I G Z A F E U Y | Y F A G U E I;Z
C V W E Q M D U | M D E V Q C U;W
W P E S Q H V A | E P V H A S W;Q
Z N H E V Q W R | R W H Z V Q E;N
P I L O V E K R | R K E V I L O;P
S C W K R Q Y P | K P C S Y W Q;R
F E M N K O G B | F M O N K G B;E
L D T U I O G A | A D I U T O G;L
E L I Q A P X W | X I W L E P Q;A
S F K V P Q L H | P S L H V K F;Q
K X T B M E A N | X M N A T B K;E
G N K L T P Q B | N B G P K T Q;L
H U O P K M N Y | P H Y K U O M;N
O F I V S G C M | C V S M I F O;G
P O E V D W Z S | O D W S E P V;Z
N J U G I V W C | N C G J W U V;I
H X N K D G V I | X N H I G V D;K
S D V P J X T H | J V H T X P D;S
V I N T M Z H S | T V Z M S H N;I
X D J S A M P Z | J S Z M D X A;P
Q H O P B X V W | W B Q X V H P;O
T E X K Y F S M | X M K S F Y E;T
I M P E X Y S U | U M S I E X Y;P
V L B K D C U W | L K V D B U C;W
F D G M E T I Q | Q F I E D M T;G
Q W B K O T I Z | W O T B K Z I;Q
A U L O P G S N | G P U N O S A;L
S P V A L J Z T | S T P J L V A;Z
M I X V U S K J | X V M K J U I;S
H F Z W D Y V B | Z D V W F Y B;H
Z X B W L C S N | X W Z L N C S;B
X Q G T P V F S | V Q P F T S G;X
N L F E C B A W | F E B N L C A;W
E V L P Y D M G | Y M V P L G D;E
Z Y U P B W I X | Y B U I P X W;Z
Z C V S N W Q D | Z Q V C W N S;D
U F A T B P C E | U P E C B T F;A
X O B T P F S C | P F X B T O S;C
Z X H N U O J G | G N O H J Z X;U
M A D O V W I E | E W D M V A I;O
D L R A W S U G | U D R L W S G;A
Z I R M K N X B | R M Z X B K N;I
D Y Z R V G T S | T G Z Y S D V;R
C I Q S R D F O | S R F O I C Q;D
Q B N P Z K J R | J P N K Q Z B;R
W F M A B G C N | F C B N A W G;M
T N V W I L K M | M K T L N V W;I
P K Z W J N M Y | W J K P N Z Y;M
E J S A V B P Y | A E P V J S B;Y
B J H X D L A M | X M J D L A B;H
X C B H W J I L | X W C H I J L;B
R N T H V U C D | U T D R V H N;C
X I L D P Q R V | Q P I V L R D;X
W D S X G C J H | S C D J G X W;H
U B V O R N D T | B O R N D V T;U
I V R M K E U X | U R K V M E X;I
L A R U M Z T I | I M Z T L R A;U
D S J A G K W U | G U S D W K A;J
F N D R M T G K | M N F D T G R;K
M X N K D U Z W | M D K X N Z W;U
V W B N R Q F D | W Q R V N F B;D
A R L Z E M G Q | E Z R L M A G;Q
K L A N M F W Y | F Y L N M W K;A
N W H O U B I X | W O N U I X H;B
V R W D P M Z C | D W Z V P C M;R
P U Y Z I L C Q | Z P Y L U C I;Q
F B T S R G I Z | F S G I R T Z;B
C B K I M J N Y | N Y M C B K J;I
D K J S R U Z O | J U K D Z R O;S
W R Z U C L D J | U D Z W R C J;L
Y A W Q U R V X | U Y W V A R X;Q
A B L M E J G P | E B P J M G A;L
E N R D P V X T | R E V X T D P;N
B K A C T S H O | A C T H K S O;B
U H L N C Q F Z | Z L U H C F N;Q
O T F I D X G Q | I O D X G T Q;F
H B I Q N K U V | Q I B H K V U;N
T Q B I R N U E | R T B I Q U N;E
C W T F Q E L P | E F W T Q C L;P
N W B U C I G A | W I G B A U N;C
N D L S T V H G | N T G D H L V;S
Z I C T X V R G | X V R C G T I;Z
D J E N R H C U | R H E D N C U;J
A E B Z V F M P | Z M A P E B F;V
M L I N T B W E | I L W T N M B;E
L R F V T S I A | F S V R T L A;I
V W S G R N P T | S W P G T R V;N
S L P Z U R X F | R X U P Z L F;S
O J B R T L A C | O C J A L T R;B
U R K Z O J T M | R Z K J M T U;O
F G W K C D Q N | K Q F G C D N;W
V U J L Y I M E | V I U M Y L E;J
K M J G R D T Q | M D K Q R G T;J
R N V Y F L Q G | G Q L N Y F V;R
D R X Q I H P W | P D X R W H Q;I
R V M F K W B X | V M X R B F K;W
Y T J D O R S U | U J Y O R D T;S
C U M F I S E Z | U S F C M Z E;I
X R K U L A J G | X L K R A J U;G
M E Z J L Y R C | Z Y C J L M R;E
K F A I O T B S | T B O K A S I;F
R O A Y I J Z X | I J R O Y Z A;X
L C U E I G S N | S N C E I U G;L
Q Y V B H Z P S | Y B H Q S P Z;V
J Z Y B D V P I | J D Z I Y V B;P
C I V B Z J L G | G B L V C I J;Z
K Q H O I J E X | K O E Q J X H;I
D S R G X E M O | R S O G X M E;D
J F I L D Q V B | B I L J D V F;Q
Y W U L P T E D | Y L D P W E U;T
H X T V C K W I | H C T K X I V;W
Y B G T S F C Z | C Y G T B S F;Z
R M D N T V O K | N O R M D K V;T
M V R C A O K B | B O V K R A C;M
N H K S E W G Y | E K N H W S G;Y
Q W K N L B A S | A B Q L S N W;K
N F I W L R J M | I J W R F N M;L
Y C M U N E K G | N K E G Y C U;M
D C V M L F Y U | C D F Y V M U;L
O E V Y Q I B H | E V Q Y I O H;B
B Z F N E O C Q | Z F O B E Q C;N
B A F D U S R H | D A R S F H B;U
O C U A Z D H G | C O D A G Z U;H
Y C K D O T I R | R K I C O Y T;D
W T Y J K R P D | Y J T P W R D;K
T F B O L C A D | D T L F C O A;B
X Q U Z A F P D | D P Q Z A F U;X
M F X U T I Y D | T X Y M F I U;D
R Q A G M F S T | S Q M R G F T;A
V O B S D R X A | O X R V D A B;S
O L G N E S R B | G O B L N R S;E
R O L D V N P Y | P R N Y D V L;O
Z L N U E C I G | N I U G L E C;Z
H O E J X Z L T | Z E J X L O H;T
J Z X N O W V M | O M N J X Z V;W
W V F Z E M A R | W Z V A R F M;E
Q R S V P E J X | E P R S Q X V;J
O I C J V E Q L | Q V C E J L I;O
J E O V Q Z I S | O J Z S V E I;Q
X O A T M D J C | T X D A C J M;O
S D K R A H N B | B A R N D H S;K
I A G L U V X Q | U A Q X L I V;G
Z M N X E O S L | E S X L N M O;Z
Y Z J Q R S H W | Z H Q R Y J S;W
M G W N J R A T | J N G M R T A;W
Y B K X Z E A S | K Y B Z X A S;E
Z V G D X Y K E | Y D E V G Z K;X
Z T H J X B I A | A X B J I T H;Z
Y Z E X F A R V | X E A F R Y Z;V
A N L Q U G H Y | U H L Q G A N;Y
O J F T U W D Z | D W F Z J O U;T
C E W K P B A X | E B P A K X W;C
B I J W G V Y F | I G W B J F V;Y
P I B J K H S G | S H P I J K G;B
Z X E D I W T L | Z D X I T L E;W
Y O E Z S V T D | Z D V S Y E O;T
U S A T H D R Y | T S R A H Y D;U
C U E V R W K O | E U V K R W O;C
I E X V F Q P Y | X E V F Y P Q;I
G Y M P V J Q L | Y P Q V M J L;G
C G J T L Q W Y | G L T Q J C Y;W
A V S K W D N G | G W N D A V S;K
Y Z F Q K V D S | K F Q Z Y S V;D
Q A G H X D Y I | H I Q D A X Y;G
N M L K A Y X S | L Y M X N A S;K
H P D E V A X Y | D A E X V P H;Y
O G H I Y A Z K | I Y A G K O H;Z
I R U Q X N E A | X Q I A U E R;N
L W F G T D O C | F D T C G W L;O
T N D A Q H M S | S A D Q H T N;M
G Q Y D M H J V | Y H G D M J Q;V
O A P X N M H W | M W P X N H O;A
S W J U O C F B | O U C B J W S;F
F Y A B S W K G | B K Y S A W F;G
X P T M D W H A | H A M X P W D;T
A B F S H W Q J | J W S B A H Q;F
W P V R Z Q E D | P V Q Z R D W;E
Q K S P D B H V | K H S P D Q V;B
B U E T K A V O | U E K O V A T;B
X G Y V T A B P | V P X G Y B T;A
D V U G A I B Q | G A B Q U D I;V
Y W A N D F T H | Y W A F T H N;D
P M X E Z G I C | I Z X P C M G;E
R S M N K D T A | R M A T D N K;S
X W G P Y K H S | G Y X W K P S;H
E K M H V Z S N | H V S E M K N;Z
S O M D I W C G | O D G C W M S;I
R O X E Y U L J | X J U O E Y L;R
Q E M S H G J B | E G B H Q M J;S
E L W D B N A O | B L D N W E A;O
R B C O I Q J H | O I B Q J C H;R
R X B S C A T Z | C T B R X A S;Z
L S J A B P T G | L T G B S J P;A
H Q M P I N D T | Q D T N P I H;M
M C U I X V K O | O I M U C K V;X
E S R F Q Y P N | P R Y S E F N;Q
M O D U B F S Y | O D S B Y F M;U
A T U M X E B P | U P T E A M X;B
F H Q M R A Z O | A M F H O Q R;Z
Z F R A L D J C | Z A J R C F D;L
D C Y P X I A Z | A P Y Z X D C;I
W K Y S M H Q X | Q Y X M H K W;S
D Q V A C B I Z | I Q B Z A C V;D
C D Z J B T I P | D Z P B I C T;J
K N D P M L J H | P H N M J K D;L
O I P S Y F D M | S O Y P I M D;F
C I H E F J L K | C L F H E I K;J
Y B I T N D R F | I D F B T Y R;N
I J Z N X G B R | G X Z I R B N;J
N V S U D E O Y | S N U V O E Y;D
L E G B H Q S F | B F Q G H L E;S
O K H A T M E R | K M R A T E O;H
M Z B R X K Y E | M X K B Z R Y;E
X P O K T J I C | P X C K I J O;T
N H S Z I E P G | Z I N G S P E;H
G U V L B Q A X | V G A X L B U;Q
L H I B N C P A | L H A N P C I;B
E Y C H D G P K | K P E H Y C D;G
C H L V E S N Q | H N Q C L S V;E
R X E P N V O K | K P O E V X R;N
R G Z L N Q X K | K G Z R X L Q;N
T C Q E B O P G | E G Q C P T B;O
P C U J Z F E B | U C Z E J F B;P
X G U L R B A O | A R L O X G U;B
X R M U I O L K | R U L K M O X;I
Z X J C P U E S | E C J P Z X S;U
B V J Z T I S L | Z S V T L J B;I
S L Y E P I V U | S U V L Y E P;I
F S Z D O J L Y | J Z F Y O S D;L
W F Z H U B X N | W B H F N U Z;X
H F K Q V E X C | C X E K H F V;Q
I R Q F L H P N | F R N H Q P I;L
U R F V C I A J | V I R C U J F;A
O M Q Y U N A V | O U V A Y M N;Q
T V P U R G S H | S P H V R U T;G
H I K T J V M W | T H K J I W M;V
I Y T X Z U V R | I Y U V R Z X;T
T F B N A C Q Z | Z B A F N C T;Q
V B Q N S F I E | B V S I N Q F;E
F H V O K L Y X | Y K V H F X L;O
P B O C X Q D K | Q C K D P B X;O
X P H W B C A G | B C A P G X H;W
J A D L I Z M V | Z A D V M L J;I
D G V O T U P L | P V U D O G L;T
U L I K N E X C | X C N I K U L;E
K J G X N T O A | G A O X K J N;T
J B Z K G F C E | F K C E G Z B;J
F H U O B K Z D | Z F K U H D O;B
C L Y X U Q O D | X Y Q C D U L;O
Z D N R I Y J M | N Z J R Y M I;D
L M P G J R T Y | Y G P L R T M;J
M D J X R B C H | J R C D H M B;X
T X Z V N R L W | L X R W T Z V;N
C M V J U K Z G | Z C J M G K V;U
Y U A V E X T N | Y U V E T A X;N
Y M R S O G B L | M O L R Y S B;G
H V R B F C Y D | F R C V B H Y;D
W K A Q T I C N | T C W N Q A I;K
K X L R P U Z I | R L X Z K I P;U
I U G C P H F S | I H C P G U S;F
H E Z T O A K N | Z T E K O A H;N
D B P E V K Y U | E U Y V P B D;K
L U Y B H R P V | H Y B R P L U;V
U P M O J A Q V | O U M J A P V;Q
K S Q T H F E Y | K S F H Y T Q;E
X G K Z H O W R | O H X W G Z R;K
Y O U J Q N M F | Q O N F U Y M;J
R B Y N J K X H | Y B J K R N X;H
F A L O J R I S | J I S A L R O;F
V S H O L Z M W | M O S H L Z V;W
Z L O M S W H I | S H L I O Z W;M
F G L P W C O J | J O L W P F G;C
R C N L V Z U I | Z I R C U N V;L
F V K I G H W Q | Q F G H W K V;I
N O Q W F S C X | Q N C S F W X;O
X J L Y S I K V | I K S L Y X V;J
D E C Y J Q F A | Q E Y D A J F;C
C M H N I G P S | M I P H N S G;C
M I D J H U X T | T D X I U H J;M
O Y L P N U E C | P Y O N E L C;U
P A F M J L C Z | L Z C P J M F;A
W Y F K M G E J | W G M F Y J E;K
K H D C J N Q F | K F H J N Q D;C
J E Y N L D A W | J W N D E L Y;A
A Q D Y F C S X | D Q A S F Y X;C
H F G U M I Q E | G Q M U E F H;I
K T F L X H M N | X K L M F T N;H
N D R H B U K T | T D B N H U R;K
V U Z D E F N G | E N F U V Z D;G
Q I N V X K T J | N J T X V K I;Q
J R D G T P B S | G B D J T S P;R
P C F H A L J I | P F J H A C I;L
A Z F B C K D S | S K D B F Z C;A
L Q W C J A S B | Q A J C B S W;L
F R T E O Q X S | F X T R S O Q;E
N L T V H R M J | V J M L H R T;N
W T H I R M P G | H P M W T R I;G
O L A T E G V M | L T V M O A G;E
C O T S M Q Z W | T S M Q W C Z;O
K I J T O N L A | T J O N A L I;K
G R E D J Q S H | G H D S R J E;Q
D F T L S X R G | X G T S F L R;D
U G O S P X T J | J X P O U S T;G
T Z W X B O D M | Z D W M B T X;O
D S J E Z K G C | G S J D Z K C;E
X F H A B N U Z | A H U X Z F B;N
X B N O K Q I T | I N Q T K X O;B
V K Y L B P Z A | Y A P L Z B K;V
X H N V T U Z S | V Z H S U N T;X
F X L S R D B G | L X G B S D R;F
Y D G Z L I H C | G L D C Z I Y;H
X Z U B J M C Q | Z X U J B Q M;C
D L V P W Q S G | L S D W V G P;Q
Y S L O F B A Z | Y L Z S A O F;B
T U N G M K E B | T N K U M E B;G
J C B G D E I S | C I G E S B D;J
M E N X F T J S | X J M F S T E;N
M P S O W A E J | O E W J S P M;A
O C S I A W X U | S O W X A C I;U
N U J T I O P G | P O T N U G J;I
S M N R Z J W I | S J M Z N W I;R
L Y F Z W X B P | P B Z W L F X;Y
T Z I Y R J G B | B Z J T Y G R;I
H R X M U P Q W | H R W U Q P M;X
E M K N Q I R S | R M K N E S I;Q
K T F N X H C V | C F T K X H N;V
O M G V J R H E | J G E R H V M;O
D E U K G Z Q W | K E U G Z D Q;W
L S K R V P N G | S N P R G L V;K
I D O S V J C M | J S D V O M I;C
D M W H V J R K | D V M H J K R;W
D S Z F T E A K | Z S E F T D K;A
X G Y F C B P M | M B F G C X Y;P
N D G M H J P T | G H P M T N J;D
Y S M G Z W X H | Y M Z X H S G;W
D V A W Q S G I | I A V S G D W;Q
T X G J O R H F | O H X R G J F;T
J O A B W X N T | X J B N W O A;T
K N S T I M W H | W I K N M S T;H
Y J L V C I W Q | L Y V Q I W C;J
H E L F T J R U | U J L E T F H;R
C M R W J N D T | R T C W M N D;J
E K C Z N X T G | E K Z X G C T;N
E K I F X Z Y C | X K Z I Y C E;F
Y K U R O E F B | B O K F E Y R;U
H L K N D M G E | L H G E N D K;M
D L F Q H A W X | W A Q L X H D;F
N K X V S M F P | X P N M V S K;F
S X J E K Q T Z | E S Z X T J K;Q
F B O A S T X E | O S B F X A E;T
J Z N X L R D M | Z X M J R D N;L
F K R X C L B Z | C K R Z B L F;X
J U Z H R G V T | V U R J H T Z;G
N S D H P B Y K | B Y P D H K S;N
V T Y W P Q E K | T K E Y W P V;Q
G V Y T A Z U J | Z V J Y G A U;T
V M J B H E Q N | V M H E N B Q;J
O K Y G C B R X | C X R O K G B;Y
K S F L V W R T | W T K S F R L;V
F O C T J M Z E | C O E T M J F;Z
H Z L F W U G A | L Z W F U A H;G
G Q E P W Y B U | Y B W E Q G U;P
L O E M S X C D | E S D X L C M;O
D C T V P W O B | B W C T V D O;P
J R C A U B N K | J R C N K A U;B
H W P V R I Y F | W I R H F P Y;V
B Y M X K H U C | B H K C X M Y;U
S Z Y H T R Q G | H Y T G Q R Z;S
O M L U S N T D | O L D T S N M;U
I Y H C G K P Q | P I Q K C G Y;H
L R F Y S C O B | Y C L O F R B;S
Y M L V Z A W D | D Z W M V A L;Y
B L U Y A N O K | U A B O K Y N;L
X P R V L D B E | L V X D E R B;P
K J C V L W O E | O L W K V J C;E
L Z B C M F U V | Z M V C U F B;L
X J P S K F W V | W F S V X P J;K
V P A Z E W X O | W X V A O E Z;P
C M F T W D P Z | W T C M F D Z;P
Z A E G B N J Y | J E N A Z G B;Y
Q Y L T X P D H | Q P H D L T X;Y
N J T Z R L G A | G R Z T L N A;J
X C V F P H Q J | X P V Q J H F;C
S N C O V W U H | H S V W N U O;C
I O S V J G Z Y | I V S J G O Y;Z
K Y Z J T G I W | G K I W J Z T;Y
Z F L M W E C V | W E Z F V C L;M
B L V O T W J X | X J W T V B O;L
U K X C I G E H | X H G I K E C;U
A J N E L W K V | W J E A L K N;V
M Z H S P X I V | H Z X S I V M;P
T K L Z J H D M | L M K J D Z H;T
M J K W O B I Z | J B W I K M O;Z
R N S P G X Y A | N S G R X A P;Y
S E L M O U W H | W E H L U S M;O
D P A R U O L J | D P U R J O L;A
O W G T D Q L F | T D O F L G Q;W
W Q R P K I C T | K T I W P R C;Q
B U J C O S T H | T B O C J H U;S
O Z M H R S B D | M H Z D O S R;B
P Q C D U T K N | D T N Q U P K;C
Z N B Q W E L F | Q B Z L N F E;W
H M N S I V B L | S B L V H M N;I
H R C M T P S E | H S R P M E C;T
W U K C J A F L | J K W U F A C;L
J X Z S T D Q N | Q T X J D N S;Z
O W U F E Q K I | I O E Q F K U;W
K C Q O R W B P | Q K W O R B P;C
E X V F U H S P | X V P S E F H;U
M X B E H D K F | H F X B M D K;E
T F B K M D Q H | M Q D T F H K;B
Y C M H B X J N | N X M Y B H C;J
H E S Z J X O R | J R O S E Z H;X
N K E R Q F P A | F Q N K R A P;E
Y A V R M Q X T | R Y Q T V A M;X
P F R J B N W L | N P R L F W J;B
L B U A J W G T | G A U J B W L;T
Z E A M Y I P J | P J Y M E Z I;A
D H Z R U G N S | N G D U Z S R;H
C Y L X Q D M U | Y U C Q D X M;L
H G A J W L O T | G H T A L J O;W
T P N R J Z F I | R F I J Z N T;P
N I D X M J Z B | B J Z X N M I;D
S E R J V Y B X | E X R B J S Y;V
Y V Z X G F M L | L F Y M X V G;Z
T W F R M K C P | K R T C W P F;M
J W D P M R G T | W J P G T R M;D
P E Z B D I C A | P I E A Z C B;D
U P M R N A Y X | A P R Y U N M;X
Y U X Z B A L W | W B U L Y Z X;A
B E Q V O I K F | E F O V Q I B;K
C L H S U R Q G | Q U C L R S G;H
M A U K B E L D | L A B M E K D;U
Z F S D R U B E | B F S Z E R U;D
Q E J B N F C A | N A C F Q B E;J
B D X O Q K F R | B Q R K X D O;F
B Q J P X H R I | P B I H X Q R;J
H Q F B T S I J | J F S I H B T;Q
B X R G D W N Y | D R N W Y B G;X
X K Z Y S C Q B | Y Z Q K B S X;C
Z J E X F T A K | T X Z E F K J;A
K A U Y Q S V C | S K A U Y Q C;V
J X Z E U G C N | G E X Z U C J;N
Y X C G K Q N M | M C X Y N Q K;G
Y T Q N U O G P | G N U O Y P T;Q
Y A D M J R F I | F J I R Y A M;D
F B D W C I P V | P F I V W D C;B
M X N P O J T Z | M Z J T X P N;O
U Z R X J P M Y | J Z M Y R U X;P
I V D P R W T J | D R P V I T J;W
L F G I C P U S | P U S F G L C;I
Z R X S J W T G | X R T J G Z W;S
J X H Z W B S C | Z C S B H X J;W
N B Z G Y T J R | G R J B Z N Y;T
D N F V R O W Y | W V R D O N F;Y
M F C A T H S B | A S H M C F T;B
T M A O L Z Y F | T Y F A M Z O;L
H D K R U F Y A | D H A R Y F U;K
P O X Q I B E S | S P B E Q I X;O
L G R D N H F U | L R G U D F N;H
F N D S I V E G | E V D S N G I;F
Z Q T P E N C R | R N P C E Z T;Q
M L O Q A Z I P | O P L A I Z Q;M
A E O G D Z X Q | O Z G D X Q E;A
S F M Q K Y W A | W F K S M Q A;Y
R B H G K A U O | H A O U K B R;G
Y A B E K N X M | K A E Y B X M;N
B F Y M N R C J | N F C R J M B;Y
J F E M K S Y R | J E Y K S F M;R
B D A V G F S U | V A D B F S G;U
F D X C O Z W I | C W X Z F O D;I
C R D P N K E V | N K P R V E D;C
B Z S R F D P Y | S B Y D Z P F;R
Q V H S R A C F | V C H Q S A F;R
E B Y X N G H U | Y E B G H X N;U
C I H N M P Q D | H N P D I M C;Q
U O K N P R E X | O R P E U N K;X
X U S N V R I L | R N V S I L X;U
W P Q U K S N O | P S Q W O U N;K
K M U W E I Z O | W Z E M K U O;I
F L O W G V S P | W L P O F G V;S
Q R J D Z B V Y | V Y D R J Q B;Z
O I L E P V D N | D I E V L N P;O
P E U T Z L Y Q | L Q T P E Z U;Y
V D Z K N A C M | K Z V M D A C;N
K Y F T E P I W | T Y K P I E F;W
H O Y N W J S U | W H N S Y O U;J
S P O M C I E W | E M P O W S C;I
K F X L C V N P | V K N L F X P;C
L N G I Q J F Z | Z J G F N Q L;I
X F G L J C T U | C U F X G T J;L
O Z C B M J T P | O B J M T C Z;P
G Y H Q E J S Z | S E Y J H Q G;Z
V G W S L Y T P | L V S G P T Y;W
C J I F K A M Y | J A F I Y C M;K
I O D L M R A F | O I A F L D R;M
Y I X R T E F S | S X I Y E F R;T
V J L F X N O P | F X N J P V L;O
R A V W E T L N | W E V T R A L;N
U P H R G E Y F | F E R U G P H;Y
E L D F Z B O V | F O Z L V D E;B
W Y Q G O V I K | I G K Q Y O V;W
U R X J H W G I | H X U J I W G;R
X S V L C H N G | S H L V C N X;G
F I A P M R O D | F P O D R I M;A
G R D J Y O Q Z | Y Z Q R J O G;D
L Q B Z M K V X | X B L V K Z M;Q
N D L K S P H J | P L D H J S N;K
Q D Y A B U H K | K D Q B Y U H;A
W D O F Y I X Q | O F Y X I Q D;W
N Y X T G H W B | B Y N W T H X;G
U L A W R F J N | A R J F N U W;L
S H D E P W Q F | D S H E W F Q;P
Y S B A L N R O | Y S A B N R O;L
T G S A B P I U | U A T B G I P;S
X W L B N Z O J | L B X O Z N J;W
O E K T R J Q N | R K J E O Q N;T
P Q J N X T K D | N K X Q J P D;T
S X J E F K I L | X K J I L S E;F
E O B V N S W P | N P E O B S V;W
Q J D W U Z T O | Z O U T Q W J;D
J T N V I K P Z | T I P J K Z V;N
L H R S B D U Y | H Y S B U R L;D
E L F X N I J P | P N F L E J I;X
V E K X R Q F C | K R V X C Q F;E
P U B X T O C W | W P T C O X U;B
L F K J P N Q U | J L N U P K Q;F
V Q X S I H R M | Q V X M H S I;R
K C O H F J P U | O P K J U F H;C
I D Y Z Q H K T | Y K H I Z D Q;T
X L T Q N E H J | T H X Q N J L;E
O N B G S W M H | O G N W S H B;M
T N B C F A R X | C N T R F X A;B
J O G E Y S D I | Y S E I O D G;J
M C Q E B O Y W | Q Y E C O M W;B
T R J U G E V Z | G U Z E T J R;V
S Z M B N L T Q | B Q L M Z N T;S
A N G Y Z P D I | D G I Z Y N A;P
S Z O B Y P J M | J M S Y P O Z;B
W M O G L A J R | W J R L G A M;O
E M B P C D Q A | D A B E M Q C;P
Z R N L E A P Y | L A R Z N P E;Y
O M I H V B Z A | I O H B A M V;Z
V G K H S Y M X | M V S X H Y G;K
Q I V D Z X U G | U X I V D Q Z;G
M N E U Z S C T | N U S M E C T;Z
U P N T C L A Z | U A C L T P Z;N
A K V J M E O D | J K M A D O E;V
S N V Z J Q K W | S V Z J Q N K;W
F Y E N L P Q I | F I E L P Y N;Q
U I P G T Q B S | B S U P I T G;Q
S H X Q V O F E | F O X V H Q E;S
V S W Z J G K U | V K G W J S Z;U
R L S H J T M Z | T L S Z M J H;R
N I F Z C S G D | G N Z D I C F;S
L Q G Z Y V M O | Y G Z L Q V O;M
V J R C T H O E | H V T E O J R;C
E T I H J B X Q | J B I H X E T;Q
I D P T Q N V R | I D V Q N P R;T
I E Y V U L Q K | L Q I V U Y K;E
X F Y E G V T S | F X S E G V T;Y
O D R E X C F S | C E O D F R S;X
L N D W I T A S | I D W S A L N;T
Z P B Q J C A W | W C Q A B J P;Z
O R A J B Y N Z | O J N B Y A Z;R
U N W H V G Y D | H N D V U G Y;W
O Z B Y N P D A | D O Z B A Y P;N
T O U J Z L I D | U D I O J Z L;T
N W Z B E L Y C | Z W B C L N E;Y
S H F I K D T X | S H K F T I D;X
H E W S Q T Y Z | W Z Y T S H E;Q
S M N I C E F K | I C E M S K N;F
A I L E G P V T | E V P A G L I;T
N J R M O L V Q | R O J Q V L M;N
X S H C W R V J | W R H S C J X;V
I A U Y F J X C | F C Y J U I X;A
X C S J M E T U | E S U C X T J;M
A R O C W V J B | C R W B A O V;J
B N P J F M R L | R B L J P N F;M
G A Y E H K O U | K U A E O Y G;H
G Q E L I C J S | G E J S I C Q;L
V Q R C S E I A | I A C V S Q E;R
N D K L Q B G E | Q L K G E N D;B
B L M Y P J S H | M P Y B S H L;J
S R J P G Z D O | S J D O R Z G;P
Z F T C M I N Q | T I Q Z F C M;N
O P W Q L F T B | B F P O L T Q;W
C I D X B G M K | X B D M G K I;C
K E U O R D W G | E U R W G D O;K
Z E K D U F R T | T E Z F U K D;R
K U N E B A Y X | B X A Y N E K;U
U G J V N R O D | U J O D R N G;V
F W I B S E D A | E S I F W A D;B
D C J I W G K Q | K C D G J I W;Q
I J B Q H A K G | B K A G I H Q;J
D J Y A S H I G | S A J D I H G;Y
H O P X C K L W | W X H O L K C;P
M V Q D J I Z E | I Q J E M Z D;V
X J B T D M R V | M J B R V D X;T
A L X Z P T O K | A T X O L P K;Z
N F G C I L E K | K C F E L N I;G
A Z I W Q S M U | Z U A S W I Q;M
R Z U C G W A K | Z W K R G C U;A
W J H X E L F A | W F X J H A L;E
H V B Z S N E O | O N V E H Z S;B
J P N O M I X V | X M J N I V O;P
W U I Z N O R F | N W I U F Z O;R
Q C G A V R K H | A K V Q C H R;G
C H O B E F J T | H C T E O J B;F
Z Q G N Y K W R | K G Y N W R Q;Z
R J U H T C O P | P U T R C J H;O
K V P T J M Y A | V J A Y T K M;P
L W Y C B T X V | W L X V B C Y;T
S D P G F K N M | N G K M F D P;S
Q E K O V L B T | O E K L V T B;Q
Q E X K J D N C | D E Q N C K J;X
L Q X B P U R Y | B L Y R P U X;Q
N F E H O A T W | N T A E H O W;F
X A P G Z Q D S | D P Q A G Z S;X
P R H W X C M K | R W P C M K X;H
N E W C Q A K G | E N C Q W G K;A
C A B R Y Q S O | S Q R B A C Y;O
Q F E I H C S W | E H W S C Q F;I
P K O Q L E Y X | P Q Y L X O K;E
G W T I S C Q D | I Q T G W S C;D
T L Z H D B Y V | Y Z T B D L V;H
M I O P D C Y Z | Y I M P D Z C;O
W Q T X U N O Z | Q X O Z N U T;W
M F K L G Y N J | N L J F G Y K;M
N Z P V R Y W F | Z R W F P Y N;V
Z Q W V P M D B | B V Q M W Z D;P
W S M G N T Q C | N S W G T Q C;M
I Y N T P Z A W | W P I N Z Y T;A
N R A D H U B O | R N U A B D O;H
X H B T R I A L | T I A L H B X;R
N I W L A O G M | N A L O M W G;I
F W G D S I L Q | I F S D W L Q;G
Y Z E K G S M P | S E G K P Z M;Y
S T F A Z N X G | F A G N S T Z;X
Z D M C E K I S | M D S I C E K;Z
V I R H G A B E | H B V G I R E;A
F S H K J W O L | S J O H W K L;F
G H M Z C Y R Q | G M R Z C Q Y;H
M X K O I F N H | O X K H I M N;F
I R T B Z J Y S | Z T Y R B I S;J
Y E D V N C W P | N P Y V W C E;D
U X W Y O Q R K | Y W U Q R K X;O
E D P Y V Q U T | U T Q Y D E P;V
C N Q K T M B Z | B Q N T Z M K;C
D G S H O N U A | O N A G U S H;D
G E X Q Y N A W | Q N Y A E W X;G
R G K T A Q I L | L I A R K Q G;T
J S X U H Z N D | N H X D J U Z;S
I V L X K H P C | P L X I V H C;K
P Y A H C D I K | A C Y P I D H;K
Q K U W Z D G J | G K J Q Z W D;U
A T G C S D Z I | I T A G C S D;Z
H D T B O N P F | H P T D O F N;B
C A U N E M Q K | C U K N Q M A;E
M K L O F S T V | M L K S F T O;V
G D V P K I E Y | G E I Y D K V;P
B L E H K Z I O | E K Z O H I L;B
R K S L A D I E | E I S D A L K;R
T L B R I S Z A | I A B R Z L S;T
J Q I E H K C S | J K I C H S Q;E
Y R Z E U S O W | Z O U W R E Y;S
P I W X M O B K | O B M P W X I;K
Q E H O C N G L | G Q L C E O H;N
Z C J N E I M X | N X C E M J Z;I
V A R J X H G B | X G R J A V H;B
T F R O P L W N | O T F P N W R;L
H Y O A W M N I | I H O A M W N;Y
A I O K J B C Y | Y A J O K C B;I
J D I M Q Y G T | G M J Y I Q D;T
Z H J V B F L D | V F Z L B J D;H
X Q Z B W S Y C | Q W C B Y S X;Z
Y N D C R Z S F | R C S D Y F Z;N
M T A S X C J P | A P T X M S C;J
C V G S R B L W | L G B R V S C;W
A Q E Y K D G V | G E Y A D K V;Q
V M D T A C B E | M E T V A B C;D
H Y B G X K I C | K Y C X H G I;B
P H A Y T X S M | M X S P H Y A;T
Z B K L C S U E | Z B S C U K L;E
X V Q P K I N U | X K P N V I Q;U
Z H L Q X T W G | H Z L X T W G;Q
Z W D L N H U X | D Z W L U H N;X
R B M G H N J K | N K R G H B M;J
S O U W A X Q H | Q O W H S A U;X
L N J W I G X F | I F L X W N J;G
P X H C J B Q Z | Z H X J P B C;Q
N U G B Q Z T F | U F Z Q N B T;G
C R O K E U Z I | E R I K C O Z;U
W Z T D A S Q B | D Z A T Q S W;B
N Q R Y F H X U | N F R Y H U X;Q
E D Y T V C W K | E T C W K Y V;D
X A T F D G W B | W X A G F D B;T
F T U A P Q X G | X P A U Q T F;G
R S E A N O L F | L E R F S N A;O
G V F M L A C U | F U M V G C A;L
W A S M F H D B | A B M W H D F;S
B X N V Q J Y K | Q V B K X J N;Y
V U M Q I S K P | U I K S M Q V;P
Y X O N E Z B T | T E Y B X O Z;N
L B E O T Y H N | E L O H Y N T;B
A T Y B K E S M | T S A Y B M E;K
A K B P N O I J | O J B I P K A;N
A M R N E O U Q | M A E Q U O R;N
M G L P W T I V | V L G W M T P;I
B K I Q T Y W M | Y T B M Q W K;I
N Z Q E J X F I | I J Z X E Q F;N
J X O N L T P M | J X L N P T O;M
Z Y C A H R D P | D R P Y A H C;Z
U Y R C V H K M | M Y H C V R U;K
X S Q K M L W O | W S L Q M X K;O
V X C T P B O G | T V X P O C B;G
L H X U P Y Q B | U Q P X B Y L;H
B K G D Y M Q U | U Y D K G Q B;M
L U A N X H J I | N L X J H A I;U
D W J P Z G N Q | P W D J N Z Q;G
K H L C D U X R | X C D L U H K;R
L V P Q T F O U | T P U V Q F L;O
F B Z A V T X E | A Z T X V B F;E
G L Y E V Q Z K | E Z K L Y G V;Q
I P O S B C J L | O P S L B J C;I
O P M Y I W D U | D P U W Y O M;I
F I N Y Q T B X | N Y T F X B I;Q
Q C B H L S U X | H S U L C X B;Q
O V H M I X B L | B H O L M X V;I
M Y X B Z F D R | F D Z Y X R M;B
D F U A G S X Y | U D G F X Y S;A
R K J F B M I Q | K I R M F Q B;J
T D B O U C X F | F T D O X C U;B
S Y O Q V X B E | X S V O B Y E;Q
Z E G V L U Q J | U L E V J G Z;Q
F L U S Q A B G | F A S G Q U B;L
N A E F Z B P Y | E F Y B N P A;Z
B U S Y H M X L | B M Y S L H U;X
P I E R A S X Y | P S R X A I E;Y
G D L O E A X V | A E D O L X V;G
S T Z C B P Y N | S C T Z P Y N;B
Z Q Y V M O R C | C O Q Z R V Y;M
I W F N L H R U | N R U F W I H;L
L Z R E I G X T | L X T G Z E I;R
P I E M Z O R T | E I R T Z P O;M
Q K N O X G F S | F O Q S G X K;N
S J C K A I B Z | J C B I S Z K;A
N F A O Q H I Y | Y N A H F I Q;O
C E P R Z G S Q | Z S P Q C R E;G
K Q M V D W T S | T W K S V Q D;M
G T J O C X W H | H T O W G C J;X
Q H P A V G R N | A R V P N H G;Q
F U C P H Q K J | H K U J C Q P;F
N A H B D F Z L | D Z L B H F A;N
V C K X U H B W | U B X W K V H;C
F U J Z B L D X | X D Z B L J F;U
D K M U V H A Q | M D A H V Q U;K
P V W D X C A K | A K P X W C D;V
S U O I N T P M | O P M N I S U;T
P M E C F K X W | X W P M K C E;F
Q C E I B G A M | C E Q I G A B;M
U K A Y O D B E | B D O E K A U;Y
C M K R O U D A | A M U R D C O;K
Q Z W D O M C J | Z M J D O W Q;C
F C Y A N O E W | A Y C N O W F;E
U K Y B Q I M D | M I K B Q D Y;U
K Y Q T D H F P | T F H P D Q K;Y
H G T S F K V E | K S T F H G E;V
X R C B U W A O | R X U O A B C;W
K O T I E Y B Z | E Y Z B T I O;K
K V Y G E X I B | B V G X E K Y;I
C B D A R Y F Q | Y C R F B A Q;D
S T Z F U V I P | S U I F P V T;Z
Y F B Q P A V G | A G Y F B P Q;V
E K W U F X Y J | U F X K E W J;Y
O L S W K Y H T | W H L O K T Y;S
B Y V A K O E C | B A O E C K V;Y
Z U B C S E D Y | Y B U Z E D S;C
D X M P N T E V | N D P T V E X;M
Q A M Y V E D F | E F Y D M V Q;A
O V B A X N J Q | Q B O X J V N;A
O D K Q F V A B | Q B A O D V K;F
I A E V U K F J | E A J I U F K;V
M W F Y K D P I | D P M F K Y I;W
L S F Y R N D W | R L N S W D F;Y
G N K A H U M C | G A N K M H U;C
N Q W V L X G E | V G L W N X E;Q
A E S H T I Y M | H E M Y A I T;S
G V P Y F M Z D | Y D F P M Z V;G
I O F Y Z L W A | I L Y W O A F;Z
J N A P C X D Q | D N Q X A C P;J
V L Q Z S E G B | G B E Z V L Q;S
V F Q W O N K J | F J K W O N Q;V
K D R M Y S Q H | H S Q Y R M D;K
U I T P J X Q L | P Q L U I J X;T
M E U G J V L S | J S U L E M V;G
B N H G Y K O E | K N G B Y O E;H
C Z B Y R E N J | J Z R N C B E;Y
K D I W Z R G B | Z W G D R K I;B
Z N G X W L C Q | G W Z L C N Q;X
X F P T V E Q B | E F X V Q T B;P
V S N P C O U G | V P S U O N G;C
F Y M N V Z K G | N Y F V K M G;Z
H P Y I X R D N | N P I Y D H X;R
H F D L S O U X | D L X S F H U;O
O J G M N C B D | J D G C M N O;B
N R L U G P S F | U L N P R S G;F
T Z W R I B Y X | X Z Y B T R I;W
Z K B Q O C N P | O B C Q K Z N;P
F I Z Y X C S E | X F Z E Y I S;C
L K S J V H A Q | Q S H K V J L;A
W Z S O H E P F | P Z O F H S W;E
X O Q F C R V K | Q C R O F K X;V
B Q O Z R I D M | Z D Q O M I B;R
Y D A V O Q T C | A C Y Q V D O;T
B G R K N F X E | R N F X G B E;K
X R D L Z T C N | C Z L R X N T;D
A I D W Q C B T | Q T B I W A D;C
D O T P U V X M | U M T V X O D;P
M F B H U J D K | K M H B U J F;D
J R P N V G C E | J R E P V C G;N
K S U O M C G Q | S K U G M C O;Q
V K B W P F Y Z | F W V P Y B K;Z
K Y Q R O X L E | E L R K O Q Y;X
Q V R N H D A L | D H L V A N Q;R
G R T L O X P F | G T R P L O F;X
E K A O Z Y R U | E U Y Z A R K;O
I A L X W E B P | I W B A L P E;X
E A G Q L J T W | G A L Q W J T;E
X D J T P W U B | J W P X U D T;B
Y E X W F M Q H | Y H W Q E F M;X
Z Y R E N J M D | J E M Z N Y R;D
S N H X Q K G C | X H N G C S K;Q
Y S A U K O T E | E Y O U A K T;S
Z A S V U E Q X | S A Z V E U Q;X
U A G L X R E V | E G A X U L R;V
R P F X J G E S | R E J S F X P;G
C I O D M U X E | I U X O E M C;D
Z F I A B K Q N | B K Z I A F Q;N
Y N J M H P W K | W P M K H Y N;J
T U J D Y H M E | T U D Y M J E;H
T R S N W J A E | W N R E J A S;T
U N D V T L G J | U V L J T D G;N
S Z B F A Y O J | Z Y F J B A O;S
O G D K Y J V C | G J D V Y C K;O
K M A O B N Q J | B M K J O A N;Q
P B F Z L Q Y E | E Z P F L Q Y;B
D B E F N H L J | H E F D B L N;J
Z Q U V M J H T | U H Z T J V Q;M
A W U E O F N T | W U N E A F T;O
J G H C R K L V | R J C L H G K;V
N F R Y M L D J | Y F J N L R D;M
Q A S W I X Y R | Q R A I S Y X;W
H B M W L T Y O | M H W Y O B L;T
A N E T S H Q M | T N S H M Q E;A
C J V Y E W Q F | Y F J C W Q E;V
I L K D V R M T | I D R V K T M;L
I B O N Q A S U | B N I Q A U O;S
V X E T W G U A | E A T W G X V;U
S O E Q F R M X | M O F R E X S;Q
C T P D G O H S | P O D C H G T;S
Z X B V L I H E | L V X B H I E;Z
C U A S H E Q O | E O H C S A U;Q
X O Q V F P Y M | M F Q P X O V;Y
W A X C D P Z O | D O A X P C W;Z
P B C Y S X K U | X P Y K C S U;B
S F M V L W C K | F S K V C L M;W
B D X M R Y Z W | D B Z X W R Y;M
P B A G S V F I | B V I A S G F;P
Y P N G J O S W | Y G W J P S N;O
B W E Z D Q A X | X D Q B E A W;Z
M B R T C S L I | M B C R S T I;L
J R W A M H F I | W M J A I F H;R
Z I H S F J P B | P Z H J S F I;B
X M V P I R Q K | I R Q V K M X;P
N Q H I C U A W | A C Q I H W N;U
H N O R Z I A J | O N H I Z R A;J
E L A W K C Q J | L E A J W K Q;C
M Z H P U S E Y | U H P Z M S Y;E
U L W A C Y F H | W L Y C U F H;A
V E B L M U F Y | L U B Y F V E;M
C M B W I J S R | M J R W S B I;C
R N V M D X W E | V N M D R W E;X
T M Q G P Z V D | P Q G D V T Z;M
Q D G X O S H U | D O U X S H G;Q
A O W I P X D U | A D W U X O I;P
A M O J X L I V | O M I A V J L;X
K X M T G D I A | T D I M A K X;G
R Q Z J V Y E X | E R Q V Y Z X;J
T V Q X C K W F | K C W Q F T V;X
J O G C E X T H | T E C O H G X;J
U X S C G L W Z | Z S W L X G C;U
T F L R Z I V Y | Z F T L R Y I;V
C P J F H M T V | H C V M J P F;T
G F B O N Q V A | V B A G N Q O;F
J F Y V Q N A W | Y W F N Q J A;V
B L M F T H Y A | F T A M L Y H;B
A D Q H U F W E | Q U D H A E W;F
B K L I X N W E | I K L N W E B;X
N O J L G E X P | L P G O N J E;X
H D Q U G L S B | L S H D G U Q;B
B F L V C S N U | V C B F S L U;N
O Y B U L C W G | G C W O L B U;Y
I M F N S E C D | C I F D S N E;M
M T I O L F J B | B J M L I F O;T
K C V J S T E U | S E U V K T C;J
Q A Y F R T S K | K R Y A S T F;Q
L I R J E U X W | L U X R I J E;W
L S T Z H G W J | H S L G T W Z;J
G V J Z U O B N | V U J Z G O N;B
W L X D H E G F | E X H W F D G;L
Q Z I P F D Y S | F P I Q S Z D;Y
B V O Q G H S R | S V O B G H Q;R
N F I A G B Q H | Q A I G H B N;F
Q W R L F H D Z | D H F W Z L R;Q
U Z W P D L K S | L P W K D Z S;U
N F G I W M S A | I G M N F A S;W
L A W F B T G H | F L B A W H T;G
Z I A V M Y C U | C A Z M Y U I;V
L Q U J K F B Z | K L J F Q U B;Z
W C T Q O Y J E | E C T O Y W Q;J
S G Y V T H Q J | H S V T Q Y J;G
Q N Y B D X E O | D B E O Y N X;Q
N Q J W M C G S | M S N G W J Q;C
F A P I X T O Q | F O T I A P X;Q
Q C L K S W P T | S W L T Q K P;C
T I D A Z O G S | I G S O T Z A;D
T D C J R G S A | D J C T R G S;A
Q O M I K V B T | M B Q I O V T;K
U X M L T Y A J | L X J A M Y T;U
M N X B S T I W | I N X W B M S;T
M Y O R B Q L C | B O L Q Y C M;R
A N Q W B P O V | O N W Q A P B;V
S O C K V T H X | O X H V C T S;K
C Q L U G M J K | C U G L M K Q;J
R S Q K I W A H | I Q W A K R S;H
D R X O E A U I | D I O E X A R;U
Z Y F A I W Q X | W I A Z F Y Q;X
A N U H E Z P M | N U M H P E Z;A
T G Y B V S M D | B D M Y V G T;S
F U X J Q Z H Y | J X Y F Z U Q;H
I Q M S N P J U | Q M J P S U I;N
Q W N D Z G I H | Q G N D I W Z;H
Z W B O X D E V | B X W E Z V O;D
L W U I K D F A | W K I U F D L;A
F J U M N A B O | U O A B J N M;F
D B N A Y V O U | O N U A V Y D;B
N H B A O I Q P | Q I A P N H B;O
T N L J S U K R | J T R K U L S;N
M L Z Q O E D P | E Z D O L M Q;P
C L B Y X I J D | C Y B L X J D;I
U J T X H B C M | B C J U M X T;H
R B H A S J Y P | R A H P J B S;Y
J F E K C A S U | E C S K U J A;F
X Z G R H N B K | N B G R H Z X;K
I T Q D F M Z U | F Z D T Q U M;I
M V I X C Z G H | H G I M V Z C;X
X I P G B S N W | P S N W B X I;G
M P E X A I L G | M L X A E G P;I
M L Y S N Z G O | G N O S L Y Z;M
Z R E T W S Q N | S T W N R Z E;Q
Z G F R X I D S | D S I F G Z X;R
M N A Q O E Y X | Q A Y M O N E;X
J Y N X T U K O | N T X U K Y J;O
N H W C T G K M | T M C K W H N;G
S G J E R F C U | F G J C S R E;U
T M F L G Z Y W | G L Z W F M T;Y
F B P N Q U H O | O U Q F N B H;P
E R I H C Q U G | H C I E Q R U;G
X Q Y R E Z I D | I Y X E D R Q;Z
C I W J E B F Z | C F W Z E B I;J
F J X A N L T U | N F T U J X A;L
U R D S H T C G | S T C D U G R;H
X L P O B H Q A | O A H Q X P L;B
T E U S W H A J | H S A W T J U;E
F Q S D U C G M | G U D S Q F M;C
U P W G L S F C | W L F S C P U;G
U L G D M P V W | P W M G D L V;U
A S Q D F T P O | D S A P O F Q;T
N U M H P Y V G | P Y G V M N U;H
Y V C X G J T L | T L X V G Y C;J
V J O Z H T B I | Z I O J H V T;B
Y O K G X Z L N | N G O X Z Y L;K
W J B Q A I N M | M N A J W Q I;B
V E C W I H K Z | E I K V C H Z;W
Q C T S G U M N | C M Q G T S N;U
M R Q E P T J H | Q E J R P T M;H
L W S U D E H K | S W L D K H E;U
X E D N A U O S | D X U O N S A;E
G N H T L X K R | T K L R X N G;H
J R H E C T B U | J B U C R H T;E
H K W C L A J U | K L J H A C U;W
J L S G D T W A | T W G D A J S;L
F U B V T J M N | N T M U J F V;B
X Q I Y G K J C | Q Y X I G J K;C
D W G B Z X M F | X G B M F Z W;D
D L X S H V Q K | Q X H D V K L;S
Q I N K Z S O J | K N Q Z J I O;S
R A S W I J G L | S L J R A I W;G
S B G E I J Y K | K S B J I Y G;E
R S Y P F H U X | R U Y H X S P;F
I K Z H P Q E C | H Q C I P E K;Z
P O J K D X H M | H O K M P X D;J
Y D F X I S Z G | Y X I Z S F D;G
K G V T X J I W | T G J X W V K;I
U I P B A K Z N | N P K B A I Z;U
S L X Z J T A D | J T X S A L Z;D
P K I B C Y T N | B K C N P T Y;I
E G H A R W S L | E G H A R S W;L
D E Q A B R U S | A D E Q U R S;B
Q I T R P K F G | T Q I F R P K;G
T E N O P Q G L | O Q G T E L P;N
S M J U R D W L | M S J U R W D;L
Z N F K O B L J | N B J O L Z F;K
Y E J T R S P O | E R P Y T S J;O
Z R V K X G E N | G K X E V Z N;R
R U L Y C N D Q | C Y N R L D Q;U
U X Z K N H E S | H E K Z X S N;U
N Y G E W T V U | V Y E N W T G;U
Z R K N V P S Q | S N V P Z Q R;K
J E Y H R P N V | R P E J V Y N;H
N R V F B U S H | F H U V S N B;R
H E M F P L Y X | P L X E M F H;Y
Y C A R D W V I | D A C W R Y V;I
E S O X K T G A | G E S O K A T;X
B M R I C U S G | G B R M I S C;U
H P X N D Z R O | O H P N X D R;Z
C M Q P R Y I F | P C R M Q Y F;I
N S Q Z H P M G | P M H S G N Q;Z
L B M K R Z H O | O H M L K Z B;R
V W F I B U T P | U P F T W V B;I
H J K P E T Q G | E Q K J P H G;T
N F G O I E H R | I F R N E O G;H
Q B R T O I L U | Q B T L I O R;U
H I E V C J T X | H T J X E I V;C
G J D K V C Y W | K D J Y G V C;W
Q T M R P S V J | M P J S R V T;Q
G Y Z N O S U H | Z G O U Y S H;N
C T K V E G L M | M G V C L E T;K
B W T O E R V M | V O R M E T W;B
M Y I X N Z J L | N M J L I X Y;Z
T M E F X G H R | E M G T R X H;F
O V Q D Y N E M | N M O Y D V Q;E
B H T O I W N C | N B W H T O C;I
I G D O F J Z C | G I D J Z F O;C
D M U X V C G A | G A C X D M V;U
L O G D M C T Q | M Q L O D T G;C
I Y N L A U W F | N A I F Y L U;W
B N J O D V R A | R A V O B N J;D
L J S I E D Q N | D N L Q S E I;J
D L C G I M P Q | M C L I P D G;Q
E Z L U X T O A | L U O A E Z X;T
G P F V S W E I | V E S I P W F;G
W U K L T X Q V | L V K U T W Q;X
B F N D E U W Y | B U F E D Y W;N
P Q S Z L O A T | Q T P L A Z O;S
D M F K L N C V | N L V F C D M;K
N V J D W Z F C | F J W C Z D V;N
C I K S J B F P | S K J C B F I;P
T O E Z X B A R | Z A R B T E X;O
J Y H D V R T X | V D T J H X R;Y
J D R S B P A N | N R P B S A D;J
L I Q P H B T X | X T H I Q B P;L
P Z K M Y V L G | P M Z Y K G L;V
U O T G W E I P | G O T P E U W;I
O Y W P Z E A N | Y W Z E N O P;A
P L Z J A Y W E | Y J L E W P Z;A
O Q Z X E G S K | Q O G X E S K;Z
Q Z R N H E J B | B N E H R J Z;Q
Q B U X F I K G | X F I B U Q K;G
J L P B G W F V | B P W J V L F;G
I H A F G J D L | L G F A H J D;I
O Z P H T B U G | B Z H G O T U;P
C Y L Q R T E W | R L E Q T Y W;C
W O M X E S Q A | Q A M X W E S;O
D K Z R U T S N | K S Z T R N D;U
K R L M O P S A | A S L K P R M;O
U F X B M G Q V | M F G B V X U;Q
Y P N X G Q O H | Y H P G X O Q;N
E X N O A D J S | O S D J E N X;A
D Z N W L U I P | N Z D P W L U;I
H J M F U Q K C | C M H U Q J K;F
D M H B Y J U V | H B J D Y V U;M
V M U N Y E L Q | U L Y E Q V N;M
J S Q W H Z V N | Q S V H N J Z;W
T B Z K X P U W | U B K W X T Z;P
E P W F M J C Y | J P W M F E C;Y
B N W M X I V O | M X V N B O I;W
T K V X J Z I F | F X T V I Z J;K
L G M P Z U Y X | X P Z L U M Y;G
L O Y P G S B I | G Y I O P L S;B
B T Z Q M H A I | Z A I M T B H;Q
O D L U K N X A | A O U N X D K;L
C Y V T U S O R | U O S T Y V R;C
X H L F K Q P E | F K E H Q P L;X
V T I W L O M F | L O I V F M T;W
T F K J S Q D V | V K F T S Q J;D
W R P G I V K L | I L R G V K P;W
X D K P Q T L R | Q K X T D R P;L
E L K S Y U F D | E L Y F D U K;S
Q T P D O F M G | Q M F P G O D;T
D F K G T Y C S | T F S D Y C G;K
U P T Q K F H L | F U L K T Q H;P
U Z H E I W G N | W I H N E G Z;U
K X F B J P C L | X L F K B P J;C
D K A W P H O C | A K H P D W O;C
P J V O D K A H | H A K O P D J;V
G R Z B E C X F | E C F B R Z G;X
B S I M K Y T P | S T P I Y B M;K
Q N S K Y U O R | K Q Y O S R U;N
P W J K Z B T N | W Z J T K P N;B
L K G N V M T C | K M C G N V T;L
U Y B O J L K M | Y J O K B L M;U
Z V A I U K H Q | K I Z U V A Q;H
H F Z S U B D Q | S Q B F D H Z;U
M P D B H X I G | H M B X P I D;G
D Q B P H L F R | P R L B H Q F;D
I S P U W G R B | R S P G I W B;U
H G J B C S I K | H G K C B I J;S
V T B Z X J G N | Z X N G V J B;T
R Z O B D U M X | Z U O R X D B;M
B D V M E X H P | H E V X D M B;P
N Y A F R K C S | Y A K R S F N;C
V R Z O M A H I | V O R A Z I H;M
D S V C A U E R | A U C V S D R;E
N V R A S P Q I | I A P R V Q S;N
N C G D X M Y W | G Y D X C N M;W
L D T Q W U S Y | Q U S W T Y L;D
W L P R O B X A | O P L X B R A;W
J G Q Z V F C L | Z L V J C G F;Q
I W B M Y O T G | B Y T G M W I;O
X I Y M J D R P | Y M R I P J X;D
A W U Z F K D Y | D Z Y U A W F;K
M H G X B C N A | G B M C A H N;X
N O W G M Z L P | O W P L G M Z;N
G C U Q W Y K A | Q G W K C U A;Y
W M J G N K D L | N W M G J D L;K
O L G D P Q M N | P O L G D M N;Q
K Q R O G V C N | G Q O C K V R;N
L A D Q V O H U | D L V Q H O A;U
J O W S T H G U | U H S O J G T;W
W J Q B E I A K | B E A W Q J K;I
Y A B Z N L T R | Y T N B Z L R;A
P R K F O X Y D | O D R X Y F K;P
H D R E V I Q U | V D H I R E U;Q
L C N U R F A E | N U R A F C E;L
V R M N J F T W | M R W N V F J;T
Z U J H T G X E | J X T U H G Z;E
D Q W O K B P T | O D T Q K B P;W
P T K J E D H N | D E T N H P J;K
N Z I U Y V A O | O A U Y I N V;Z
I D L N A M U R | A M I R U N D;L
W Z B X M J O C | J O B W X M C;Z
B C Z G V O D K | C B O D V G Z;K
O P J X V W Z Y | P W J V X Z O;Y
X N Z G E W V K | E W Z G N V K;X
Y G A H W F J O | A Y F G O H J;W
O K D S P A F Z | D F O Z S A P;K
D L N F X K J Z | D N J K L F X;Z
J R H Y Z N L O | Z O N H Y J R;L
H B K F Q W V N | Q B V F W N H;K
S U M A C W Z J | M C Z U W A S;J
N H D K V A W L | N A H K L V D;W
T G P U D K F Q | P F U D G K T;Q
C U N L J Y K W | J C L W Y N K;U
R W K X T M F V | R X W V M F T;K
B D M L X F J V | B J F L V M X;D
J Q X H S Z T B | J T Z H Q B S;X
L Z D U Q N J M | L Q J D Z M N;U
D X T R Y H N J | J N H T X R D;Y
W P D B V Z L Q | B V D P Z Q W;L
J I T C P N Y R | I J T Y C R P;N
T X E W J D B Y | T Y B X W D J;E
Y N H P J W F O | J W F H P Y N;O
Q M R Y G Z X E | E X Z M Q R G;Y
F C N P B G M V | G F B N P M V;C
R S T G W U N B | G T U R B N S;W
S Q E V D N X B | V X E Q S N D;B
W N Z D J A C O | O Z A W D C J;N
R Z N W I Y D X | N I X R D Z W;Y
L W M S X U A T | M L T X W U A;S
V L T C M X G N | L X T V G C N;M
Q Y O P U K F D | O K D P U Y F;Q
Q U O I F B Y D | D O I B U Y F;Q
S Y O G J V U T | V J G U T S Y;O
D M Y R L Q X S | L Q R D M S Y;X
K B V O U F J E | O F J V E U K;B
L P V I T G B K | P K V L T G I;B
O P R F Q H K D | H P D Q O K F;R
R V G A X P D O | V D A G X R O;P
F A G X M C I N | C M F A X N I;G
O J G C U K X L | G C X J O L U;K
N L P G M D K H | P L M N K D G;H
G Q V X A F Z Y | F Z X G Y Q A;V
Z K O E M S B X | M S Z E K X B;O
N Z C R E M F G | F M R G Z C N;E
E M O F R B N G | N B O G M E F;R
Z V X D S T B C | C V D X B T Z;S
Z Q H G S I N P | Q P S I G Z N;H
A T V S H M L C | A L T M C V H;S
U I N A S T J O | U A I J S N O;T
E C H O W Q Z R | H Z W E Q R C;O
Y F Q P R C W E | C Q Y P F W E;R
J C X H Y D F P | P J F H X Y C;D
U Z Y D H Q F I | Q F H U I Z D;Y
E J C V A G W T | J E W G C A T;V
T W M A G H Y S | G S A H W T M;Y
W O F A Q L T N | N W A F Q L O;T
L J P R U M V H | J V M H P U L;R
Z I C E F L T W | T C W L F E Z;I
N K X G S U Q P | G X P Q U S K;N
D P X B V W K J | J D P B K V W;X
D O P H T L U Y | P H T O Y L D;U
H R M Z W S T Y | Y T M H Z S W;R
M X V Y W E Z N | E Y N V X M W;Z
T A O Z U B R M | A B R Z O T M;U
A T V X Q G C H | T C A V Q H X;G
B W E R V A M Q | B Q V E M R W;A
A Y D J T O R Q | T R Q D A Y J;O
A U T S P O H M | U S P H M A T;O
L O G B M V S T | S B M T G L V;O
P E K U O I C G | O U E G P C K;I
P G R Y M F H U | G U P Y H M F;R
D B S I G W L E | D S W L I B E;G
O U M Y P K V I | U Y I V K M P;O
J B I S L M Q C | C Q L S M I B;J
Z E B T H A K C | T Z H A B E K;C
W S X N I M K Z | X M S N K I W;Z
R K G X H O M D | G H O K R X M;D
R B Q E Y C U A | Q A Y C R E U;B
E B S X C G I R | C R G S E B X;I
I X Z J A H C K | C J A H X K Z;I
X N I R U M P C | R C N M I P U;X
Q S D Y F X L U | D X L F Y U S;Q
F V Z K P H R A | V R Z H K F A;P
S E J C F H M O | E C F O S H M;J
D S T I J B V Z | Z J D V I B S;T
B F T X G Z O W | Z G T W X O B;F
D C O T B U Y E | T E D C B Y U;O
S Q P A X Z L C | S Z A C L Q X;P
B R N P W I X D | D I W X R B P;N
X G T H C E U W | H E U T X G W;C
S N M X D U J K | D N K M X U J;S
V P L X H J S R | H J L X V P R;S
T U Y L V X H I | T X V U L Y H;I
B Y G F R Z A X | R A F X G Y Z;B
Y D T Z X R U H | Z D Y H R T X;U
M I B U A O Q N | B Q I M N O U;A
R V X O Y D K B | B Y R V D O X;K
G L O A R U T E | G U O R T L E;A
E M W G D Y Q Z | G Z M Y D Q W;E
Q Z A S X M Y K | M Z S Y K X A;Q
A O M H G B F Z | O H Z A M F B;G
U K Y C Q S H T | Y K Q T H C U;S
E F J M A Y R W | Y M A J R F W;E
W Z M L A H U X | M W L X Z H A;U
S W E G Q D H F | Q H E F S W D;G
E P A V T H M J | H V E M P J T;A
S W E Y K H C T | Y C K S E T W;H
W N I F U E K C | U W K I F N E;C
I A B C E S D Q | A D B S C E I;Q
I P W F X B H D | B H F I D W P;X
G S L I X P E B | P S E G B I X;L
E N X S Z O B Y | B N S O X Z Y;E
U W Q M V I A T | Q A U T V I M;W
C B O S W G M A | C G S W B M O;A
V G L Q Z T P J | L Z P G Q V J;T
A V B J O Q S H | J B V Q H O A;S
C A B L V E J K | B J K E A L C;V
P Y T H K A F D | A Y D T P K F;H
O H D E V I L G | O V E G L I D;H
U V D I M A S Z | U V Z A M I S;D
K F V G J X Q L | G X Q J V K L;F
F R D C Z A Y K | Y F K R D A C;Z
Z O B E L S D H | O S L E H D Z;B
F W U T K E V N | V F E T W N K;U
P F D A X C M Y | F A X Y M P C;D
R B X C L H D P | C P R D X H B;L
D Z M T L G B R | D M G L B T Z;R
O R Y V C U A Q | O U C Q R V Y;A
M G K T N V H Y | G T V N Y K M;H
Q V P E L A H O | V E O Q A P L;H
W G B T P Q M K | Q T W P G K M;B
I Q C S N K X F | K C N I F S X;Q
T K E B U P L Y | P E L U T B Y;K
Q F D E T B U Z | Q B T D U Z E;F
L U Z C K A I F | L K U F A I Z;C
K B L Q R E J O | K J L O B R Q;E
D V O I C W B E | E O W C V I B;D
J M I Y H U A E | I U A M E Y H;J
X G P J T K F C | G X P K J F T;C
H V O C X T L R | C H R V L X T;O
V M T H I J O W | W H V T I O M;J
C W P Y B O X A | X Y O W C P A;B
G J O Y E R U X | Y E U X R O J;G
I T Q N O V G L | I G Q N O V L;T
I C V B Y F G R | C B V R G I Y;F
Y U R B M A S N | M B U S N R Y;A
O K Y H S R L I | H L R O S I Y;K
Q M A L H X N B | B M H L N Q X;A
S G J D L V Q M | M Q J S D L V;G
C B L Z G M H Q | M G L H Z Q B;C
Q E P C H D N T | N D H T Q E P;C
U K B A T J N W | K T B A N W U;J
W T L D M O H Q | D O M L T Q W;H
L R M E X Z S I | I L X R E Z M;S
O Y X W G T S Z | T G W X O S Z;Y
S W M R I K H U | K H R S M I U;W
D S B F C X A V | X A F V C B S;D
Y S X M B I U N | S M U I X N B;Y
M R N C V Z L X | X R C L V N M;Z
X F Y E L W H D | E H W L X F Y;D
W A H F L R U Q | F A W L R Q H;U
E D T B C P Y L | Y C B E D L P;T
R Q Y M K B N W | N Q M Y B R W;K
K G O E V P A X | K A E P V G X;O
O X Z E U G B K | O G B X Z U E;K
E T K Y M L P Q | L M E Q P K T;Y
J G L P R Q V N | G P R L N V J;Q
D N J Y I C T B | N B D T Y I J;C
H C V W L T J U | V L W U H J T;C
K C D I Q J G L | K C L Q I D J;G
Y P O R U J Q M | Q O M J U P Y;R
P O Y M A D Z K | K D M Z A P O;Y
P W Y R M Z O A | R Y W P Z M A;O
S B W J N G C L | S G N B C J L;W
R Z V F B X C Q | C F V Q Z B X;R
W C K V O D E Q | D O Q V C E W;K
N W L T H S M K | M N W H K L S;T
H F L S T I V R | H R V S T L I;F
Y C T A L Z O D | D O A Z Y T L;C
C D Y M V O H Q | Y H C O Q D M;V
P V Q B J O C S | S V Q C B O J;P
I R U K Q S W C | K U S Q C I W;R
T M R B Q O Z P | B M T R Z P Q;O
I R Z U J Q X H | I Z Q X U R H;J
S L K J Z O H N | O H K J N L Z;S
R N X Z J W I O | J N Z O W I X;R
C Y R W E O N F | W E C R Y N F;O
Y J W H X D O F | D O W F J H Y;X
C G O A M F N E | A N O E C M G;F
Z Y F X H S R I | F H Y Z X I R;S
M K O X N J U T | K U M T N J X;O
Y P O W E D B N | N E B P D W Y;O
H I N M O V A K | M O H V I A N;K
S G Y Z H A X C | G S H Y Z C X;A
T U Q B F Z W A | Z U B A F Q W;T
O T H J X M B F | O X T M H B J;F
Z L B V F J H S | L Z V F B S J;H
A T P E I M L F | I F P T L A E;M
T P V N O R H X | R N V O H P X;T
C U S W A G N P | C A N W P S U;G
G P A M T Z U C | P C M U G Z T;A
S Y Z K Q U M X | S Y X Q M K Z;U
B M C N L W J Y | B J N L M Y W;C
S I G C Q O M N | M N C S I Q O;G
S W N D M P V J | V D P J M W N;S
A P X J H G F T | J F X T G H P;A
K L J X P G S U | U J G P K S X;L
A Y M J P G H Z | H Y J Z M A G;P
C T Z Y O L W D | L O D W T Y C;Z
F U Z C Q Y N O | N Y Q F O Z U;C
N C M B E I U G | M G B U E C N;I
W I X H L J T C | X I W H L T C;J
P R H S C J K U | K U J H C S P;R
Z A U C X K Q G | A U C Z X K Q;G
R N Y D T B X P | P Y R N X B D;T
W U A O S Z B V | B O U Z A S W;V
T Z P I B X U K | Z T B I K P U;X
M F Z N Y E P D | Y Z D M P F E;N
Q B D T U O E Y | D Y T B O E Q;U
N Y X C E M Z I | X N M Y I Z E;C
S H V W Z R F Y | R S Y F Z W V;H
S A G B U Z C F | U C B Z A G S;F
K T O J G P S W | J O P K S G W;T
G B V J K A W F | A J K B F W V;G
D T N K U A I P | U I T K A N P;D
N J F Y K T O L | F K Y T O N L;J
T F D B R A Y Z | Y Z B R A F T;D
U W H Y S E C J | E C W S J U H;Y
P A K I G M C Y | G Y P I C M K;A
D U H G S N Q I | G N U H D I Q;S
J R Y V X F M T | V F J T R M Y;X
Z M A C S Y G T | S A Z G C T M;Y
D Q C S I A M W | M Q C S I W A;D
F P W X O B M C | F X B C M O W;P
P S X N F I H Q | H Q F S P N X;I
O J R Q V Y C N | C R Y V J O Q;N
T Q M S D F J H | H T F J S D Q;M
R N C J U W D X | R C X N W D J;U
T J D G P K E B | D G P T K E J;B
J C T A P M L U | P A T L U M J;C
Q P J Z U M D R | D R Z Q U P J;M
U T S Y Z E C A | U Y E Z A S C;T
V H C F I T O N | O H N T V F I;C
I Q N D A F G P | A D Q P G F I;N
E N T A F R Y J | A F N T Y E J;R
V C E F L B S I | B L F I V C E;S
M Z W I C N V E | Z C M N E I W;V
L K B I X C O G | I X L O G C K;B
O X L B E P Z D | D L E Z P X B;O
Y Z H C N M G R | R Y N H C G Z;M
C B R D Y E J N | D B J C R E N;Y
Z T H B N E A U | H N A Z B T E;U
Y V U C Q W G Z | Z Y U C V G W;Q
M U B L J C D G | J U D M L G C;B
J E W T L B S N | S T B W J L E;N
X W R U Q O Y G | G W Y U R Q X;O
R S A X V D T E | X A E V D T S;R
K R G Y C Z P U | Y U G R P K Z;C
D P C Y F E Q V | F V Y E D P C;Q
Q Z A U G S D M | A U D Z M S Q;G
S V D E O Z G H | G E Z O V S H;D
P W Y F H E Q R | W R E Q P H F;Y
I M N T F K V D | T M V I K F D;N
T E D W M J Q X | T E M D W X J;Q
A G W I Y F L V | Y I A W V L G;F
J Z M P U L K N | K P U M L J Z;N
W L Y G T O D F | Y L F D W G O;T
N P U O Q Z V Y | O V Q U Y N P;Z
E X H U L N Z A | L N X Z E H A;U
D W E L I F C J | F W L C D I E;J
Z S M I B F Q C | F S I M C B Q;Z
H X Q R V N Y T | Y V Q H X N T;R
A U W I M T H R | A M W U T H I;R
F H P T B Y R O | P B O F Y H T;R
W U H L N P A Q | H W Q N P L A;U
O Q A P C E T V | P V Q E A T O;C
O T G L V F J M | M G V O L F T;J
I H F C Y S R A | R F Y S A I H;C
Y Z Q E K D F T | T D Q E K Z Y;F
L T J V P A K Z | T A P Z V L J;K
J Y W T Q S M R | Q W R S Y M T;J
O Z E G H I J F | Z F G O J H I;E
W X S U T I K P | K U W I P T X;S
G U M S N Q B J | G M B U S Q J;N
N B D Z A F P K | P B Z N F K D;A
L K Y T X J O D | Y D L K T J O;X
U F X Y H I C Q | F Q C X Y U H;I
M K Y X G W U L | M Y L X U W G;K
Q T H Y O X V F | T X F Q O Y V;H
Q N L E F X R W | X E W L N R Q;F
K N Q U F D W Y | F K Q N U W D;Y
R P Q A T Z X B | R T B X Z A P;Q
E A H S B O C D | C H O S A B E;D
P V C I W L Y J | C I J P W V Y;L
D Z G Q V L K Y | Y Z Q L G K D;V
Z Y F U M P G O | Z Y G M O P U;F
X V L Y W H F T | V H T Y F X L;W
S K J A H X F D | D K S J X F A;H
C A J L N X Y O | J L C O N Y X;A
N K W E I D M S | N K S M I E W;D
P U W S M I T J | M T W P U J I;S
J T M O S N B G | O N J G M T S;B
E B D G Q Y P O | Q D E Y B P O;G
Y A D H W N G P | W A D Y N H G;P
D P U R V S C N | P U S N R C D;V
V P E B Y W A L | B V Y P A E L;W
E L X C Q B I P | P E C L Q B X;I
D M P V F K Q A | A F D K M V Q;P
C Q R A P S D G | Q S A R C D P;G
O G C H P B R T | P G H R C O T;B
J I Q G S D U R | U S G D Q I J;R
B H Z X P M V A | V P B H X A M;Z
L R H X C N Z T | X H C N T Z L;R
S Y H R M I G F | G M R S Y I F;H
Q L K U I E N R | E I K L Q U R;N
I F U Q J P C Z | I P C Z U J F;Q
H V P D Y B Z O | Z H D Y P V B;O
H O N E C Y P R | P E O R N Y C;H
E J S U T A R W | T W U R A S E;J
L C M F D W E Z | C D E Z L W F;M
P W T D B X E V | X W E T B D V;P
K P V C S D W E | C P D W E K V;S
F O K U B Q X M | F X Q U B M O;K
J D Z U A B P W | W U B Z P J A;D
Z V Y J H X S O | X Y V S H O Z;J
B E T X G C U F | B F E U C G T;X
F W J E K O Q L | J O L W E Q K;F
O V M I G N X K | V O G I K M N;X
A Z U Q I T M E | A U M I T E Q;Z
G L K H S P M N | N P L M H K S;G
L E I N V R F H | F L H N I R E;V
Z S P E V M C K | Z S V E P M K;C
W O M X L V Y C | V L Y M W C O;X
A V T D J Q P O | J T O D P Q A;V
P D X E U C Q L | P D U Q L E C;X
W L J K M X R E | X J L R E M W;K
A X S Z U C G T | U T C X G A Z;S
M D R Q N L V S | R L S M N D Q;V
V K Y P D S F X | F Y X P S V D;K
H O B R E Z P J | O P J Z R B E;H
T S P I A D R G | I S G R D T A;P
W B P S G N K Z | B G W P S K N;Z
C W F Q J M Y K | Q W J K M F Y;C
Z P X G H M N K | N K M Z X G H;P
X P Y B F E J W | Y X E F W P J;B
X O S T U Z Y V | V T X U O Y Z;S
G I A D O E S Z | Z O D E I A G;S
V L D E J G R M | R J G D V M E;L
M A B R S K I N | A S R N K I M;B
T L K C Q G I J | C L Q G J T K;I
F G Q S Y B O V | V Q G Y O B F;S
Y W B R A I N M | A B W R N M I;Y
C X Y T K I S B | T C X K Y I B;S
Y E J V O F P L | P J E L Y F O;V
S E A X I N D Z | E Z I A S X N;D
S R X Y B W G Q | X Q G Y S B W;R
Y Z O N U E I T | Y N U T E I O;Z
T F R D N W B S | W R D N T F S;B
W F I Y R E A C | R C F W I E A;Y
G E Q X I L S T | L X E I S G T;Q
O A C L G N P X | L N G P O X C;A
M V B W A N G U | G A W U V M B;N
B I G M P W N O | G B N O P W I;M
W O F B U Z J L | W J O U B Z F;L
Z Q C I H J X G | I X Q G J H Z;C
U T H B Z J Q W | Z B W U J H Q;T
V D S E B H Y X | Y S X V B D E;H
V B U M T N S Y | Y S V U B T M;N
S E A G Q P D R | A Q D G R E S;P
G Q O U N P B K | B Q P N K G O;U
T W R Q E V D K | W E V R K T Q;D
H F I A Y N G U | I G Y A H N U;F
J T E F W R U Y | E U J Y F W T;R
C G V J N M Z L | G L J M Z V C;N
E A K G V B T U | K V A B T E G;U
P M V O Q B D E | D B Q V O P M;E
I H R U W G J S | S W R I H G U;J
D O J Y X B Z S | Z Y S B O X D;J
F A U S H I Z N | H F U S A I Z;N
X B R J U N I G | U J N B I X G;R
I F H N C P Q J | I N H Q P F J;C
U V K T J N B W | N B W K T V J;U
V R C N X J E H | J V C H E N X;R
I W R N F C B P | W R I P N B C;F
Y Z W R L J K N | R W L K N Y J;Z
Z Y S K J E Q X | S Y X Q K Z E;J
W K B I J X D P | X J K I W D B;P
K Q L X N Y M C | C K Y L M X N;Q
T F H E K G L U | H T G U L E F;K
F A Q U G P Y M | A M U P Q G F;Y
T Y S C V F Z R | F V C Z T Y S;R
W V A X S L I E | X W A L I E V;S
S H Q O X B V G | X O B S H V G;Q
Q W M E Y S G V | M E G W Y V Q;S
X M G K V D Q W | Q G K V W M X;D
A F G Z V Q B H | V Z A Q B F G;H
I G W C E B J N | N E B W J I G;C
X I K Z H J R G | K J I H G X Z;R
K E C F I Z M A | I A C Z K M E;F
M Q N Y T V H P | T Q M V H N P;Y
D E S A X I J B | J X I E S D A;B
G C X D O V A F | O G V C D F X;A
F M T Z K X C W | M T F C W Z X;K
H O U Q K T M E | Q K O U H E T;M
L O Y M J P U Z | Z L O Y J U M;P
D N G R X V Q Y | N Y X Q V R G;D
R U P F Q N G E | P F R N U G E;Q
F Y H J W P M N | W P M Y N H F;J
B O H A Z E W G | B G A W H Z E;O
O G P L K Z T C | L K Z G O C T;P
E T J V G Y B P | V T J P G B E;Y
D H A C P I G V | P A G D H I V;C
T K S J Q F X I | T X I F J Q S;K
D Y C J Q Z W N | Z J D C W N Q;Y
N C Y B Z Q O V | O Y N Z C V Q;B
T M D A C P J O | M D T C A O P;J
M A H S L G K T | M T H S A G L;K
B R M T G N P L | P B G R N L T;M
W Z L X K N B V | L Z X W K B V;N
H B T I R E N U | B U I N H T R;E
D R T K F C B A | T A C D K R F;B
K J Y W N B M F | F N M J B Y K;W
M V D T S U P Z | M S Z U T V D;P
H O I X T A G C | G T H A O C X;I
S Z V Q L I D E | E L V I Z D Q;S
I X O H G N T R | T G H X I O N;R
E X Q W F P A N | X A W Q N E F;P
F D G X Y U C A | G Y C A F U X;D
H L X Y U A B M | M A H L Y X B;U
A Z O L B U S M | U M L B O A S;Z
L O E D G X K V | G V L O E K D;X
C Q F V A D W I | W V I C D F A;Q
C O K P B V E Y | E Y P K B V O;C
O M R T C Z W D | C Z M W D O R;T
O Z S N R Q D L | R D S O L N Q;Z
L Y K H U D O Z | L H U O Y Z K;D
R X V N F K J W | R F V X J K N;W
S C J I X G Z B | I X B Z J G C;S
A S T J E C R G | G A R E J C T;S
U D X F J Z B S | B D U X F S Z;J
P Y X U R N D F | P R N X F U Y;D
A D I C W T F P | D P T C I W F;A
S V A J R O I Z | Z J S R V O I;A
F Q U L J G O M | L F M O G Q U;J
H Q C Z N P T D | P Z C T N Q D;H
P Z E W Y H B V | E Z P W Y V B;H
N E H V Q Z F J | Z V J F N H Q;E
P F U B E Y A C | Y P B A F E C;U
A G X Y N E I H | A G X E H N Y;I
K H G E D U V M | G U V D K E M;H
Z P G X T A C H | C H G A T Z X;P
A Y H R G D S Z | S Y Z G H R A;D
Z B U S J Q V E | J Q U Z V E B;S
F D V R M Y N L | D Y R N F L V;M
F E N G Y M L K | E N K Y L M F;G
K O U C J B Z F | J Z K O F B U;C
W E O G J H Z T | G W T O Z E J;H
V C J G X H E R | G E C H X V R;J
P N E U R H S Y | U R H P E S Y;N
R X K M H P J N | N K J H R X P;M
W J U D A M Y G | D U G M A Y J;W
F M S L Y I H C | I S F C Y M H;L
M U K W R J I O | J U K O I R M;W
D Z I N R L H C | H R Z N I D C;L
M X W F A L N I | W A L M N X I;F
A G M U B P L R | L B R G A M P;U
W Y G E L O D K | W K E O L Y G;D
L Z V J O K H W | J H L W O Z K;V
O F N M Y D K R | F R N D M K Y;O
O J E W Y M V S | O Y S M V E W;J
C X H P T D M R | M R D X H C P;T
G R K P O N I Z | Z O I N R G P;K
J V W D Z A P F | Z P A W F D J;V
O M F A Q J U P | M A Q U O P F;J
O Q G W P E C N | E O Q G C N W;P
C K O T H V Z E | V O C T E K Z;H
R T Z M D C N S | M D S Z N T R;C
F S W J L K D O | D J L S O F W;K
N A Q W F H P G | P Q H A F G N;W
G Y K P R M L V | K G M Y R V P;L
F I N X K A Z V | I K N A V X F;Z
B Q T F D P C Y | F P C Y Q D B;T
Q O C M H Y P A | O P Q H Y M A;C
F A L Z K R O P | K O P A Z R F;L
C G U T D A Q K | T G Q K U D A;C
O S A C L Z K X | K C A L Z O S;X
Y V N U L O R Q | N U V Q O Y R;L
T Z D M Q O I N | D O N M T Q Z;I
O B W Y V Q S H | H Y W B Q V O;S
S F Z B N M J I | S F J B M I Z;N
S U G P W E D V | U G W D P E S;V
S L B N W R Q V | S R B N W V Q;L
F A R Y K H W N | W F A R K H N;Y
W X P K V I M S | K X W M S V I;P
K R V T Y A I O | A I T K V R Y;O
T H N O J P W U | O P J H U T W;N
Q O F V P I H E | P V E O I Q F;H
Y Q B S I J F C | Q C J Y S F I;B
Y G L Q R O C N | L O N R Q Y C;G
C D I T J W A U | J C U D I A W;T
T E Q L U J S M | J M L E S Q T;U
L R K D P U T C | T D U P K C R;L
Z W F U B V Q J | F B Q Z U V W;J
C A U P E Z N D | Z N E C P D U;A
F R W P O D X C | W D F X P C R;O
S I K Q M E W L | W M K S Q L E;I
Q T D Z A K I F | Q D F Z T I A;K
V Q A T U I C G | I G V T U C Q;A
C A J Y Q V R U | Q J A R V U Y;C
C Y T V L K N H | V K N L C H Y;T
T P Y M X E N F | M P X N F E Y;T
G Y H S B P M T | P Y G H B T M;S
T M G U S I C Z | C U M I T G Z;S
C B U M R O N E | N E R O M B U;C
G W K Q H E J D | D W Q J H G K;E
Y C G T V L W B | W B C T Y V L;G
S F Y Z J K U H | Z U H Y J F S;K
P Y W N A K V Q | W P Y A V N K;Q
S V A Y B Q J N | S N A Q J V Y;B
P T Q R S O A L | T O S L R Q A;P
A I C N V U O S | C U O N I S A;V
Y T I O H M K Q | H O I M Y Q T;K
Q Z X N E V L D | L D V N E Z X;Q
M J D O E P C T | M J E C T O P;D
N A G V D E J Z | Z A J E N V G;D
O G B I Y Q D A | D Q G Y B I O;A
I B S H M V E P | I B M S V P E;H
T Y Q Z A N E O | T Y O E N Q A;Z
D U P S L R M Z | U D P R Z M L;S
O I Y H L B K J | K Y J I L O H;B
U B C T E K S A | E U A C T B K;S
W P Y I K S V A | S Y V A K I P;W
N S A Y U O H Z | A N Z O Y U S;H
Q D O P R G I N | G N O D R Q P;I
Z I N P D V S R | P V R D Z I N;S
B K I G N E Q R | R E K N B G Q;I
H B V R N P U I | P N R U V H B;I
L P C U O R D A | O D P L R C U;A
W V J S C U B K | U C K S J W B;V
H Y J B R K X A | X R J K H Y A;B
W V P J T H Q D | J Q D T W P V;H
P W H M B S F G | S F G P H M W;B
Z X F Q K Y U R | Q K X Z F R Y;U
S G B R P L J H | S B J H R P L;G
L W F T C R O U | L O F U R T C;W
M S X Q H G F T | M S G X F T H;Q
P B J L N G K F | J K F G L P B;N
T W D E H O Q U | Q E H O W D T;U
M Z G I H K Q C | G Z K Q M H I;C
Y S N P O I T B | P T B I S Y O;N
A R S V B O I T | O B V R S A I;T
K Z N S M A L F | A K S L Z F M;N
Y W K U F Q H S | F W U K Q H S;Y
N K O B Y V F J | J B F Y N K V;O
M A N E X P L T | T E X A N L P;M
C Y K Q Z P A E | K E Z Y P Q C;A
G N L U T S D X | N X T U D S G;L
W J C S A F Z L | S F W Z J L A;C
A L F O J H S T | L H F A J O S;T
L F V I G D P A | F L G P V D A;I
B Z P M C Y S J | S J M P Z B Y;C
X J V O W B Q I | W I X Q O B J;V
D C H R X V M G | D X R G M H C;V
Q Y V I A L R Z | Q Z L V I Y A;R
O U Q F G H Y S | U Q G Y O H S;F
W A D S M U R N | U W S N D M A;R
W U A M P J B H | U B H W J P M;A
I A P G X U L S | X I P S A U L;G
M A N Q X O D J | Q A M N X D O;J
Z L Y M R W T S | Z S Y W M R T;L
I O M Y H V Z G | O M Y H Z V G;I
G W J S F D H N | S F N J D W G;H
M U D P C I Y V | C M Y P D U V;I
T W R E U V F N | R V E W N U T;F
Z H U F I T V P | T H V Z U P F;I
C X Q N I D O H | N D Q X C H I;O
J N C F V I E H | V E J H C N I;F
K X I Y U W T E | I X E W U T K;Y
A O I B Y L X J | Y B J O I A L;X
B S Q M L C H W | B M H L C Q W;S
L J I H K N E Z | J H I L Z E K;N
A R H P G C S Q | S Q C G H P R;A
Z F J W N I E X | E N F X Z W J;I
S U W G O R I T | T O R U I S G;W
H Q L S K N J B | K H N B J L S;Q
W O F N Y G P V | W P V O N G F;Y
B S H U N D F I | F B S D I N U;H
Q F V H U O N J | F U J V Q N O;H
S N R E M L A I | M E R N I L A;S
B D G X Z P I O | G X B Z O P D;I
X Z Y O S W V Q | S Z Y Q X W O;V
N L Q F C J H V | J V F H C N Q;L
A V B I E F R N | A V F R I B N;E
T Z B K S M H V | V B K T H S M;Z
O P D Q C V A U | U P C D A Q O;V
L E T X G D Q M | M Q G D X E T;L
N H U O T F I K | H F T I U K O;N
E Z P F D U N K | P Z N D K U F;E
G D L Z C F R U | G R U D F C L;Z
E T K L F O A X | O T K E L X A;F
H P N J D E K L | D L J K E P N;H
U B X O R D C Q | B X D U R Q O;C
B Y G F P A I K | I B K P G Y F;A
Q N E G U R T Z | U N R Z T Q E;G
R D Y W V P G Q | Y Q P V G R W;D
P B Y S K U H D | B P Y K S D U;H
E O D T Q M S B | Q B S M E O T;D
K I Y L A B G P | K I G P Y B L;A
E M P H U Q X C | M C P E H U X;Q
Y O A Z G R H F | A Y H R F G O;Z
T K P J F D M R | M R P T D K J;F
I A G D Q Y X L | A G Y D X Q I;L
O V L F R Y K J | F R Y J V K O;L
Z X G I M F K Y | Z M G I X F K;Y
Y U C Q X M W H | M Y H W Q C U;X
Y T Q P H O D M | P T Q M H D Y;O
P U W E K J T G | U P J K E T G;W
Z E O J H C W G | Z C H E J W G;O
C I W E U V X N | C U W N I V X;E
N L I R C P B Z | N R B C Z P L;I
Z V M F C E P A | M A V F C Z P;E
P M I X W T Z A | I M T Z X P A;W
L P G C F R U J | F J R U P G L;C
U L J D S Q O M | L J Q M U D S;O
K B Z Q L M T N | N Q B T M K Z;L
O S I W G A K E | E I G S W O K;A
F A B J W T Q O | F J T B A W Q;O
I V R W A F N S | S W I N A V F;R
T P C V E J D A | J V P E C T D;A
Y B J I T M W S | Y W S I B J T;M
G W B N V A F M | A F V M W G N;B
W N S P Z Q K T | W S Q Z P K T;N
L M W C F D U B | D W L U F B C;M
W I C M B D A G | G I A D M B C;W
C G R B H M E O | R M G H C B E;O
L W A X S O Z H | S Z H A L W O;X
Q D J I Z P K L | D Z P Q I J L;K
U E Y X Z K O G | G K U X Z Y O;E
E H Y R Z X W M | M Y W X Z R E;H
M P D Z C T U S | S T C U D Z M;P
Q A T B E I K V | A I T K Q B E;V
D A J Z K I L E | Z K A L D J I;E
I S Y A N O G H | I H Y S N A G;O
R U Z P O M T I | Z M O P R T U;I
F T W Y I U G R | Y I U F G W R;T
C Y B W X S P R | P C S B W R Y;X
O D Z G P F L H | Z P O H F D G;L
K C J G Z O B L | Z B J G O L K;C
U E O C X H F N | E U C H F O N;X
K L Q Z Y T P B | L B Y Z K Q P;T
E U G K V F I Y | V K I F U Y E;G
C M U D A V R K | D K V C R A M;U
H M I X T Y D U | X H D Y U I T;M
V X F Z M R A B | A B V F R X Z;M
E D K W L N Q S | L S E D Q W K;N
F N D K T U J I | U F N J T K D;I
L A N M J H D S | M D L H A S J;N
U P F V X G C B | B F C V P X G;U
T C V P J X K N | P K V C N X T;J
K D A M W B R G | K W M B A G D;R
H Y G M S X J T | J M H Y S G X;T
D L Q B V Z R Y | Q L R V D Y Z;B
I V M L Q G Z X | M V Q G X I L;Z
I R P C X G S B | B X I G R P S;C
D V P Y T S W I | I P Y W T D V;S
T S C J I Q V U | U J V S Q C I;T
J P Z U G B D V | Z V P G D U J;B
M W Z O Y I Q A | I W O M Z Y A;Q
L I Q B C T E Z | E L I C Z T Q;B
U M Z G R J W Q | G R W M U Z J;Q
H B D A F O Q K | D H A O K F B;Q
S Q R B F Z J E | Q J Z F R B E;S
B T G J O Y W L | Y T B J G L W;O
L G O Q T K V A | G T A O K Q L;V
T P C Y J L Z I | Y I C T L J P;Z
E M V Z Y N K G | G Z M N E K Y;V
N R B O V S D E | E R V N D B S;O
O S G T R I X H | R X T H S I G;O
X N Q L O V D S | V N Q O S D L;X
I V K N T X P S | V N I X P K S;T
N V Z W Q F G K | K F Q W V Z G;N
I F N J Z K M T | I N K M J T Z;F
R O Q H Z L S C | L Q O H Z S C;R
A N K T Y P W H | H P T A W K Y;N
E D Z H I V X R | X I E H D Z V;R
S V I T J F G U | T J G S F U I;V
Z C D W P S G R | C Z G W R S P;D
R D X I P Z Q G | X G Z P R Q D;I
V R I F Q B O X | I Q R O V B X;F
K B J O P V A Z | A V B P Z J O;K
R Q Z N V B A I | B R V Q I A Z;N
M O C S P W V X | X O P M S W C;V
L G H Z V S Y O | O G H L Z S V;Y
X S O Y N A H L | Y O S N A X H;L
D J O U T L Q V | D V Q T L J O;U
O P T X U J W B | P U W T X O B;J
Q B W U M A E S | U Q E A S W M;B
M I X N V Y Z P | N Z P M V Y X;I
Q I H J B N S Y | N H S Q Y J I;B
Y R Z Q M C S K | Q Z R S Y C K;M
T Y P G J X Z H | J Z P X T Y H;G
F Z Q W K J U D | Q D J F Z W U;K
Z A E W G F S P | F A Z G W S E;P
U S Q Y F I N T | U N Y Q I F S;T
S U M C Q G R V | U M G R Q V C;S
L Y V Q D N I E | D E I Y N Q L;V
G P U M S R L V | G U S R P M V;L
H X G K R V Y M | K G V R M H Y;X
Q W Y S V M A E | V W E S M A Y;Q
V B R A H X C N | B V N H X R A;C
K S W Z V I O B | I O Z V B S K;W
V C X E A S R M | V R X E M A S;C
V Q T Y Z W H G | Q G Z Y V T H;W
V X B Q F E Z P | P X Z B F E Q;V
X L Z Q E M A V | V L X E A M Q;Z
X F I Z E S U J | S F E Z X U J;I
I R B S C O G M | I S R O C B M;G
A O W Y C B S Q | W Y S O C A Q;B
G K B M Y W D C | G Y M C W D K;B
A G F R N H B D | A F R N H G B;D
X E S T B N P C | P X E S B T N;C
W X Y N T Q C E | Y E W X Q T C;N
S E R V N J K Q | J K V N Q S R;E
A V Q N H B C D | Q V N H C B D;A
U H E F L A K O | A O K E U F L;H
Z E N V T U S F | Z N F T S V E;U
A F L W M G P N | G W P M N A F;L
O K M Y T E G N | N K Y T G M O;E
U L Z O P I K G | O L U K I G Z;P
V L Y E P D X C | E P D V Y L C;X
K C Y V Z S U T | S K T Y U V C;Z
U F D O I R J Y | Y U O R J D I;F
J Q B Z A W C H | J C W Z H B A;Q
E Z W I O A B D | W D I B O Z E;A
Q C W I B Z L G | I G Z W Q B C;L
A J L Y C X D B | B L D X A J Y;C
R M P F O T J U | F U J P T O R;M
K X I R C S O E | C I K R S E O;X
O Z F N C I X P | F Z P O I C X;N
X V Q E I J U M | V I X U Q J M;E
X H O K V F U A | F O X U K H V;A
K P G I B X H L | P L H B I X G;K
Y M A G F N O Z | Y F N M A G Z;O
W Z H G A Q I P | P Z A W G H Q;I
I D L A M K Y T | Y L D K I M A;T
R P K B O H I D | B D P I O K H;R
J N O V I W X M | O N J I V W X;M
P K N Q M T A L | L K A M P Q N;T
B L I T V S E C | S V L C E I T;B
Y W G I M F N X | W Y F I X M N;G
M P R G B Q F H | H G F Q P B R;M
D N F K L Y A M | K F D Y L N A;M
A E W P T Z I O | E W P T I O Z;A
V B G U M H K I | K U H B M I G;V
B U T D M V F P | B F V U M P D;T
L N Q C E F G T | T Q E N F C L;G
E P J H Z X W U | E P X H Z W J;U
P J T O B A C R | J R C P T B A;O
Q Z A V F H W X | A H Z V F X Q;W
I K V G Z J X P | I J P K V X Z;G
F C Q R U J I V | V Q I F R U J;C
F V Y C E X A R | R A F X C V E;Y
Q M X O W T J E | X J T Q M W E;O
Q U E L X T D M | T E X L Q M U;D
Z S C P J F O R | P Z R C S F J;O
Q W L K G V I A | I A L W K G Q;V
Q A J P O G M N | O J N G Q M A;P
F X O T M K N P | M X N O F K P;T
J V X O C A M I | X C I V O J A;M
R E K F B H O U | R F E O U B K;H
T C W H N V R K | W V K T R H N;C
P N A C E M J U | N M E C J A U;P
V G A K B R P W | P R V G W B A;K
N D R U K T X H | T X H N K D R;U
T G B E Q Y P S | B E T Q P Y G;S
Y U W Q M B P K | M U B Q Y P W;K
R Z I Q F O G U | G R Z I O F U;Q
F X U R G I Q L | L F I R Q U X;G
S D O G Y A L Q | G O Y Q S L A;D
O U T D Y F S I | Y I F U S T D;O
Y V O U B T G S | O B U G S V T;Y
O V N T C A L K | C K V A O T N;L
A B Y L Q V U O | A B V Y L O U;Q
Q J N G H F M V | F Q M H V G N;J
O S D X U I E N | X I D N U E O;S
Q D R A K E B P | P Q R B E D K;A
W K N Y V J S E | E K W V N Y S;J
C Y T P N R L S | T C S P R Y L;N
V B M O D P J L | V O M J P L D;B
H M Z P R J S O | J M H S P Z R;O
E J V P B K N A | E A K J V N B;P
Y B N R W P A E | W R B P N E Y;A
K F I X N T R Q | Q F N R T K I;X
L P M O D Z G W | L P Z M W G D;O
P A J R W I T S | P W S R J A T;I
E O J D P N W K | K O D W E N P;J
U T N C L A I P | C P T I A L U;N
Y R B P C X S A | A C Y P B R S;X
O L X P J F S E | X P L E O S F;J
J N T P W C U O | N C T O U W P;J
Z K O P W I T R | W K I P Z T O;R
X M T Y O E K G | E M O T K Y G;X
E M S O J W A X | W A J E O S X;M
R W K Z S A Y B | W S R A Y B Z;K
T J B C V F D Z | Z D J V C F T;B
U P B E H R A I | A R E U P I B;H
E V R U L N Y J | R Y N V E L U;J
Q E R I O K W V | I W K R O V Q;E
P V K N E G Q T | G T N V Q K P;E
A G W D E J T Z | J G W D T Z E;A
P G F L Q R B X | G L F Q P B R;X
L N O C E T Q Z | Z O L N E T C;Q
V I Q L R N X D | L Q R N I V D;X
L K O N Q P I M | L N K I P O Q;M
S V N Z P U M C | M Z N P S V U;C
O Y H B N Q C R | O H C B Y R N;Q
L T U Q J S W M | W Q U T M S J;L
P F U Z W G M B | B W F G Z P U;M
F O L T V E J R | F O T J R L E;V
J W U T Z Q M B | Q M B T W J U;Z
I W X M Z U F Q | M Z U F W X Q;I
M H E O F K L V | K E V L M H O;F
X I K Y U Z D R | Y I Z K R D U;X
S O I Q X U C F | Q F S U X I C;O
G K D W R E S T | S E T K R W D;G
A O M D K N G C | G A K N M C O;D
N W R H Y K U S | W Y H K S R N;U
N J W K A Q E L | N Q A W K L J;E
P W A O G B U V | A W O U P G B;V
T S M E U V X D | X V T U E D M;S
U X C Q G J N Z | G X C Q N J U;Z
Z O S I W B E X | W Z S O B I E;X
O K M B X U Q I | B O K X M Q I;U
A U C N P K X L | N C L X A U K;P
M J Y I Q B A W | B I A W Y Q J;M
T M F A Z X C H | H A M X F C Z;T
O C V P Q Y I L | Y C I P V L O;Q
D I Y Q F X V L | I F Y X L V D;Q
P B Y R U W S V | V Y W R B U P;S
R C L M X O V Z | C O M L X R V;Z
H X F J M U A B | B U M X J H A;F
K B L A W X T Q | A T L Q B K X;W
V A O L E I H Q | O L I H Q V E;A
K E V W I R Z J | K E W Z J I V;R
O T G X W F N S | S G T W O F N;X
E N F I W R D C | C F I N E R W;D
F R U W S C K A | W C F U K R S;A
Q O M Z B E H P | Z B O M P H Q;E
L G N J M O K C | N G O C J K M;L
C E M S K U X G | K G S U C X M;E
F H Y A N T P X | T F Y X N P A;H
U B E K G J S N | J U N S K G E;B
Q N O T P Z U C | C O T Z Q N U;P
A W P O R H B Q | H P B W Q R A;O
T D M G W I F E | M E D G I F W;T
R P C G L O U X | C O X G L P U;R
L M U E W X P K | X M W K E U L;P
Y B D C J I O E | D O J E I Y C;B
Q B H N R P M Y | P Y R N Q H M;B
I Y L T F R J Q | R Q T I F L Y;J
F W X K E Q P O | O Q K P E W X;F
Y G X F C N A H | H G N X A F Y;C
X K S W Q M N Z | X M S Q K Z W;N
R K C J L W Z P | K P W L C R Z;J
E Z X F U R L W | U Z X W F E R;L
B Y S V W G L P | W P B Y S L G;V
U R H T K N V S | H S K T V R U;N
E X O L G H A Y | Y E H G O L X;A
P R U I O D K L | I P U K O L R;D
D O Z L Y T M P | Y M T O Z D P;L
O I Q W J A E K | J O W E A I Q;K
K J B V Q H W A | Q K W J A H B;V
C O X U V T B Y | U T X O C B V;Y
N Y B L T D U O | Y B O L D T N;U
H Y O A D X U J | Y A X H O J U;D
H J I X U A N C | C I N X A U J;H
J T B A W G V S | B J G S T W V;A
A K C V X Y P U | V C P X A K U;Y
A S Y E O C T R | A T Y S R O E;C
M A U G W Y T X | W A M T G U X;Y
V S Z J U Q G O | U O G Z S V J;Q
Q X J A Z W I U | Z I U W X Q A;J
O Q D U P L W E | L U D O Q E W;P
B X J C I P H Z | X C I J B Z P;H
K Y F S D G L I | I K G Y L D F;S
J U N B F H E I | E J B U N H I;F
P V B L J U I D | V J L I B D U;P
E Z P B X F G T | E G X P F T B;Z
N V K F Z C G S | F Z C V G S K;N
J T M O P F Z X | F M T Z X P J;O
Q T Y W C J E L | Q W L C T E J;Y
L Y Q T R J H B | R J T H Q Y L;B
U L W X Q O F C | X O Q C F W U;L
I S V G Z K O E | O S Z G V K I;E
L I U P G H Z M | L M Z U H P I;G
R A G E B H J U | G R U B H A E;J
X V R B J E Q L | L R E J X B Q;V
Z C N J X G T I | C G J X N Z I;T
C Q A N K Z H Y | Y A N Z Q C K;H
V A B D H Q S E | E A D S V B Q;H
N E I A B Y X C | C E Y X A B I;N
Y N K M Z C W D | D M Y W K C Z;N
O D Z E F L R B | D L Z R B E F;O
X U N F Y B R W | X F U B Y N W;R
B T G W M S F Y | M S G F B W Y;T
T J V E R S K U | T J R K V E U;S
E M T B N R I H | H B I R T M E;N
K T Z U O D N Q | K U T N Q O D;Z
M C R G Z B L U | C G B U Z M R;L
F O C Y V Z M D | C D O F Z Y M;V
L V B C U Y Q O | B O V U L Q C;Y
G O K T E Z Y C | C Y Z K T E G;O
X O U J F Q M R | M Q U F O X R;J
E Q S T O Z U J | O S E U J Q Z;T
X Y U A D N B G | G B Y U A D N;X
U C M D Y G Z F | D F Y C M U G;Z
J L M H X N A U | U X M A N L H;J
P K B L T D W H | W T K P D L B;H
F I J B X T P W | T J W P B I F;X
Y T Q F E W N M | T Q F M Y W E;N
L I W O N Q C H | Q O L N C W H;I
F D M P K G Z S | G M F K D P Z;S
L X R N Y Z H F | F H Y Z N X R;L
J L A V I C Z N | C Z L I N J V;A
W P N A I L K H | I K A H L P N;W
N I M O X C E J | O J C X E I M;N
F I X H B L V C | V B F H L C I;X
H P Y V Z X B C | V P H Y B C Z;X
Z O M V B N R L | R M L O Z V B;N
D Z G F B R W J | D F B Z W G R;J
X V L C N O I R | O L V R X N I;C
O E J B M I U A | B A M I E U O;J
D V Z C H O L B | O B D L Z C H;V
A M B E D Z G J | A B E Z M G D;J
W K Y R X F D Q | X W Q F R Y D;K
S Y J G F C X B | C B J S Y G X;F
Q H R T X J W I | T J R X W Q H;I
S J C B E X N P | P X S J B N C;E
A T W S O U P N | A T S U P W O;N
I R P X Q A Z T | T R A I Z Q X;P
P M O A X Z N D | N M O X A D P;Z
M U A Z P S F R | M R Z F A U P;S
G I V A O W T L | O W A V G L I;T
Z B A H N Y L W | A H N L Z B W;Y
N X P L J F D C | F D P X C L J;N
F C K Z G R X W | R W K G C X F;Z
Z K M V H Q G P | H V Q Z K M P;G
J Q W I K A F D | K W I A Q F D;J
S R U K H E L V | R V K U H E L;S
X S O D W F Q L | D Q F O W S L;X
V M G F U C J B | B M F G V C U;J
B R I N Z A S Q | S A I Z Q N R;B
N V T I O J M X | X V T J O I M;N
D P E L S Z J Y | S P J L Y Z E;D
R W U E C J L F | L W E J U F C;R
R E L H K T V U | T U L R K H V;E
V J D L B O E K | B D V K O E L;J
T Q S O G N Y B | O S N G Y Q T;B
C Q U J E G N K | J Q G E C U K;N
M X K Y E Z U V | V Z Y K E X U;M
F K G S P V X M | K V S P M X G;F
Z I F O R B D Y | D F B O Y R Z;I
P E H N U F O A | F A O N E H U;P
W Y Z P J O Q E | E P J O Q W Z;Y
A P S X B J Z R | S X R Z B J A;P
C U Q S D M E W | S W U M D C E;Q
B N H X A C I U | X U N A H B C;I
G V B A E T H F | V E T A B F G;H
K B S H G C R Q | K C G Q B H R;S
B F E Y I U O G | F U O G B E Y;I
N A L F T W V C | W A C F V N T;L
R W P U D B M T | T R D M U W P;B
S R M H Q I T F | T H Q I F R M;S
G V K O I F H Q | Q H O I G K V;F
T S F B J D N Z | N Z J T F B S;D
Q L P M S D A Z | Z D L A M S P;Q
S C U L A N O I | I O U A S C L;N
P I U H Q X F Y | P X Y I Q U H;F
E V T N O U M I | T V U M E O I;N
M Z P Y J I T L | J T I P M L Y;Z
E Y U G V J C T | J E G Y T V U;C
K H A L X I G W | K L W A X H G;I
C D T W B J E Q | C Q E T D W J;B
Z A O T Q F E K | K Z T O Q E F;A
G W Y B O H X E | E W Y H X O G;B
G C F U D L Y J | Y F J C L D G;U
A W B P Y H Q L | A Q Y B W L P;H
W I M B H C G Z | W I G B M C H;Z
N Y D I T X P F | T F D I P N X;Y
B J C X I S M Z | S B J I X C Z;M
Q H A Z B K J D | J D K A H B Z;Q
U W V N H K Y R | K W Y H V U N;R
E A D I L N U V | N I D L V A U;E
B N H X C R G Y | Y R C B H N G;X
J K Y T C U I D | K J I T U D Y;C
O Q E Z W H D N | O H E N W D Q;Z
G W N O V Y Q D | Q O Y G D W V;N
R Q M Y B D X W | B R W D X Q Y;M
I K M X T D S R | T M S K R I D;X
I G Z C K B Y V | Z K G I Y V C;B
A B D K M C Y S | Y A C B D M K;S
U I C R G Z M W | C M I Z R U W;G
P N T M F U Z G | G M F N T U Z;P
Y D T U J L B S | Y L D J T U S;B
R J M N X F C S | F C R X N S M;J
M P G I V R A C | R C V A G M P;I
F V D O U Y W I | F Y O U I D V;W
B T M R O K C F | K O M C F B T;R
H T A S L Q F K | T S L A Q F H;K
Z N F A G X P T | X Z A F P T G;N
N W J M F D H K | D H K M F N J;W
D S Q G I K P X | S Q K X I G D;P
N I L O U J T C | N T L J O C U;I
E Z T Q U V D C | V Q T U C Z E;D
X W L C A Q D K | X Q W C L D A;K
I Z O H B L E U | I L B Z H O E;U
N T S J R G W B | N J T W R S G;B
T Y J D H Q X I | H J Y Q X T D;I
J C L D F A M P | M J C L P A D;F
M D V U Y H I Z | Y D V M Z I H;U
P R Q N W Y S L | P S Q N R Y L;W
E S G D K C O Q | G C Q K O E S;D
K S L Q U X H D | X Q L H K D U;S
Z L E S O R N Q | N Z R O E Q L;S
D K H I F C W O | O C D W K F H;I
D H Q U F M C S | M H F D U S C;Q
D V N P J Q A R | J N A P V D R;Q
C V H L Q Y B D | Y D C Q L B V;H
Z K O A T E X M | K A E Z M X O;T
M J B A W H D K | J K A D B W H;M
E D X Y N S G F | N X D S E F Y;G
X G J N C F O Q | J Q O N X C F;G
W B S V H R A F | B R W V S F H;A
O P I R U J V Y | I U O P R V Y;J
G T W O X J Q M | J T Q G W O M;X
K O G X B D L J | J L K G D B X;O
T F P Y E I B W | B T W Y F E I;P
Y Q O S T B V C | C Y T V S Q O;B
K M D H Z T Q W | T M K H D Z W;Q
W P G S V O A J | A P G S J W O;V
K E T D W I M H | I T K D M H W;E
M F A E T U G Z | U E T G F A M;Z
R P V H I A S T | V T S H R P A;I
A S U G V F M J | A V U J M S G;F
Q Y E R W C K T | C T Q K W Y R;E
F M W Y V K O E | F M Y E V K O;W
J B C F P U E R | B C E U P J F;R
Q C M L V B Z I | L C B V M Z I;Q
F Y G J E T I A | T J E I Y A F;G
B G P D O S V C | O P B D S V C;G
D T M F C B V U | C M B T U V D;F
G E J H F P L I | F L I P E H J;G
F N P Z V G R U | N U Z R V G P;F
G S T Z B M H Y | T M G B Y Z H;S
G A U I N O K Q | A G Q I K U N;O
L P F Z N M S B | S B L P F Z M;N
W M H T C G B S | G B H C W T M;S
A E O X C N I T | T A O X I E C;N
U L M G O Y X I | Y X O G M U I;L
E H I F D Y S O | H O F E Y I S;D
N C Z R U H L J | Z N U C L J H;R
V K N F G R E T | K V G R E N T;F
E X T I S U B N | B I S E N U X;T
M Z B W S K E A | Z K A M E W S;B
P L E M I O A V | P V I A M E O;L
I T V Y G O D H | G Y D V T O H;I
R O V B M P Z I | O Z V B R I M;P
E M D C L F T O | O F E M L T D;C
H X W B M R F E | R M B X F H E;W
D P Z S Q Y U H | Q S P U Y D H;Z
G D K W A Z C E | A C Z G E W D;K
I R E H J X F M | X J F R E H I;M
D R J L G K V H | V G L D J H R;K
E Y G I B T M F | I G Y M T E B;F
T R W B G A O X | W X T O B A R;G
K F G S M T Z H | Z M F G S T H;K
J R N B P E W O | W N J B R P O;E
Q T Y J W A D I | I Y A T J W Q;D
R H K W S L Z I | Z R H I W S L;K
Y P H C V I E S | C S H P Y E V;I
L S J C R P E Q | S Q P C E L J;R
K C A E L B G P | K C A G E P B;L
C W I Q Y Z G U | Z Y W I Q U G;C
E F A V I O U G | E G F O V U A;I
X M I O C A L K | A O L X C K M;I
W T R M N X U E | M N E X W U R;T
U D F I R K Z Y | F U R D K Y I;Z
Y X Q E W A H C | Q A H C Y W X;E
O R J F C Q V W | J O V Q C R W;F
R X T O M P V E | R V M P T X O;E
R O H Y M F E W | F W O E R M H;Y
Y X T J C R N U | C R Y U X N T;J
M S G K O X T F | F G M O X S K;T
U L S T D V K J | U V T S K J D;L
W F J H C I Y L | Y I L F W H C;J
R C B P T S F I | S B R T I P F;C
U W L J D R X N | R X U N L J W;D
V B K R U E H W | V W H U K B R;E
H M W R E P G O | H M G O E W P;R
M H J A W Z D Y | Z D A M J Y W;H
X P O R G W V M | X W O P R G M;V
N I A F G E K V | G N V A E F I;K
K U W T D P Y V | U K Y D P T W;V
Y T G X M O J P | M O J X Y G P;T
M X G T Y H J K | T M H X K J G;Y
T D O P G N Y I | Y O N T G I D;P
F B X K G J L Z | G X B Z K J F;L
S O H F Z E X U | O E S U Z H F;X
F R X T Z H Q Y | H F Z R T Y Q;X
J D P K X M Q Z | X P Z K D J Q;M
I D L Z S N R T | Z R N D L S I;T
Y X W S H D B Q | H X W B Q S D;Y
D B W H O S V R | B H V S W D O;R
L K D B F M N P | L M K N P F B;D
V Q T W J L D U | D W Q L J V T;U
R D F M O L K E | K R M D E F O;L
F S I P X E Z A | A I F X Z E S;P
E P M S Y J A T | J M A S E T P;Y
F K P G X T I J | I F P G K J X;T
M V F N T C H S | S V C F M H N;T
L X V R F T M C | R M F L V X T;C
N Q Z Y O P M D | N O M P Y Z D;Q
E Q F G T L M H | H L F T M E G;Q
A L Z P V G J W | Z J W P G L A;V
F W J U C S P K | C U J K W F S;P
F Q H D E S Z M | H Q F E Z M D;S
R E F X I B M Y | R M E Y B F I;X
S N E L F U M H | N E U H S F M;L
N K W V A M Z J | N A M Z V K W;J
Z A M K P S I V | A Z K S I V M;P
C D K I Q M Y Z | Z K Q C I D M;Y
C T A R K F E Y | K A Y F E T C;R
C K Z X D M T G | D G Z M C T X;K
M T K G W L B A | M G K A W T L;B
U H B K M O F D | F K O H M U B;D
F P Q J G L X A | L J A G P Q X;F
P B W U A G L T | U W L A G B P;T
B M I W Y G A V | Y A V B W I M;G
O Y N W U J B H | W J U N O Y B;H
T C W S H J E L | W E J H L C T;S
E I T O Q P S B | T I P S E B O;Q
T E J X G B W L | T E J G W L X;B
Q M D A K O N C | A C Q M D N O;K
Q P S F T N B J | P T F B Q J S;N
E A M K C G Y V | V Y C M A K E;G
P Y D A K W E R | Y W P E A D K;R
C O A B P V F K | C V O K A F P;B
M L G U A V K Y | G K V L Y M A;U
P Q X I C L K T | C Q X L I K P;T
D A Y H C W E Z | A E Y D Z W C;H
K H Z D N C O W | O K C W H D N;Z
S U E C J Y D I | C E Y I J S U;D
D L T C X N M G | G N L C T M D;X
P Y C Q S B U F | Y U B S Q P F;C
I Y J L Z X G D | I Z D G L X J;Y
Y O V W E S Q H | V Y S O Q H E;W
J T C Y G R X W | T W J G R X Y;C
X G Z K Y D W F | Y X G D K Z W;F
Y I V J H U E D | U J E Y H D I;V
R P H O A N B D | N B D A R H O;P
Q C H A J T Z U | T A Q J C Z H;U
I T Q V O H Z M | H Z M Q V T I;O
T M Y X U E K H | Y M U H K T E;X
P F H I Y X C T | C T X Y I F P;H
S X I N A H F U | U S N A F H I;X
K C X R T Z I E | I Z K T X C E;R
P D B T S X M C | D X T B S C P;M
T Z U C F Q G N | C G F U Z T Q;N
O M E B I L Y P | Y P L B M E O;I
Q H J B F X P L | H P L B F X Q;J
A E X Z T Y N P | A Y Z T E P X;N
O I Z N Y C X S | Y C X O I S Z;N
D V B T N W Q H | W B Q V N H T;D
T R Z Y A J M I | M Z Y J I T A;R
J K S I C O N V | V S J I O K C;N
A T I F V N Q W | I T W N F V Q;A
Z R P M J V X F | J P R V Z F M;X
D Q N Y P V R X | Q P N D X R Y;V
R C E T L P I A | L C E P I R A;T
Q R K T B J W I | B T I K R J W;Q
D F R K N Y V Z | F K D R V Y N;Z
D V X M G P E W | M E W G D X P;V
U O P F G M B T | B O P U T M G;F
O V L Q J M N Y | V Y M O L J Q;N
L G N J D F A Y | Y G D J L A F;N
I J A V T L M S | S V A L J I M;T
G H B M A I W T | H B T W M A G;I
W H I Y R C X M | W H X Y I M R;C
D V O L S T M U | T M S V U L O;D
K D U R H A F P | F D R A U H P;K
J Y N E S I A F | S N F Y A J E;I
V B L J F H T K | H L F K T B V;J
O X B K C T Q I | X C T K B Q O;I
V G M Z Q I D R | G R M Q V I D;Z
U G E N W I B T | E I U T N W G;B
Z U I G P H D V | D I P G Z H U;V
Z W J S T H O L | L O J H T S Z;W
F R P L O J M V | F R L P O J M;V
E O J V K C W H | E W C O K V J;H
N B Q T X R C F | C F X T B Q R;N
E W T S Q Z M J | Q T E S J W Z;M
I R Q U B Z Y X | R Q U Z Y X B;I
F Z U K R I T S | I Z S R T F K;U
L Y C M T F N W | C W Y L N T F;M
I F R X O T G N | X N R G F T I;O
U M Y Q H T A E | A Q U H Y M E;T
D L E G F C X Y | F G L X E D Y;C
V X A E J Z L C | V L X C E J A;Z
Z L F D O K B T | K D L O Z F B;T
P D X H F M N C | P X H C F M D;N
X C D A L K U B | C L A D B K X;U
O N L J Z U H Q | J H U N Q Z O;L
D U N L A I V M | U A V N L M I;D
R W S D G Z L Y | Y R L Z D G W;S
U M F B G C H D | B C G U F M H;D
Q V T K I C P N | T P I V C Q N;K
L F X M O S B Q | L X S F M Q O;B
F V A C I M N H | F A I C M N H;V
P Q B R I A O W | O Q A I W R B;P
U V M J P H N L | J M L N H P V;U
W F X H B R L S | R H S X B L W;F
H K X V J M N A | M X A V J H N;K
N G O B W H X Y | B N W Y O G X;H
F M H W P U O G | O U G W M H P;F
Z J N Q E R I O | N E R I J O Z;Q
S F B C K N J V | S C N K F V J;B
K Z H V I P S O | O Z H S P V K;I
K Q B P X L G Y | P K Y L X G B;Q
H S B Q T Y L C | B H Y L S C T;Q
Z A B E K M X V | X V K Z M B E;A
A G H C X F W V | A X V F G C H;W
H J S U B R Y X | Y J R X B H U;S
U H W D T I E F | H U E F W T D;I
K D E S T U H I | I S E U H K T;D
J O A P V D E U | P D V A E U O;J
H B K W R S Z U | Z H W K R S B;U
R M B K J C U N | N R B U M K J;C
X Q Y M A H D L | L M Y Q A X D;H
F Z C Y B I T P | B Y I T C P F;Z
K Z Y V G S A J | V Z G Y S K A;J
X F N O K L R M | O K N L M R F;X
C P H G Z M R K | C K Z G R P H;M
X R H T I Z M E | Z R E X T H I;M
A V L J Y B F M | J M B F V A L;Y
T Y H F W K P J | T P J Y K F W;H
A O D N G Y W U | A D O G Y U W;N
K U H R Z B V N | U R Z V N H K;B
H D G F P X V T | X H F T V P D;G
D V Q H R I Z S | Z H Q I V S D;R
L D N E K P U S | S D U L N E P;K
D H P U I G L X | I G D X P L H;U
D Z L W O G F I | W I G Z O D F;L
Y J K N M H C O | M H C N Y O J;K
T J L S G X F A | X S J G T F A;L
R L F S Z C P U | U R Z C S F L;P
G W N F I Y U T | W U F I Y N T;G
D C L T I S O A | D L A O I C S;T
H V D X L M K J | K M J X H D L;V
R E G H W Q Z B | R B G E Q H W;Z
X D B Y V E J G | D Y J G V B X;E
R A U M H Q D K | K R U M H A Q;D
Z C X T B Q I O | X C I Z B T Q;O
Y U L Z H D J N | Y U Z H L J D;N
G Q N C P K U R | K C Q R N U P;G
T V P S H Q M G | M H P G V T S;Q
K L V Q I B R N | I K N B L R V;Q
S U L N R Q H D | D H Q L S R N;U
I Z S O E W D L | I Z D O S L W;E
P Y N E K Q Z H | H Z N Q Y E K;P
B C K J N I X H | J I K N X C B;H
O N E H Z M X V | H M O X Z V N;E
A V I R J S H M | I A H M R S V;J
F A U I J X Z Q | Q J I F Z A X;U
K M J W Y Z T V | Z K M T Y W J;V
L O Q X A I B U | B X L A U Q I;O
P C K S X G N O | P N S K C X G;O
B N J T H O Z I | T I H B N J O;Z
G H F Z V N D Q | G N H D F Z Q;V
Z A P R I E W X | Z I X A E P W;R
I Q J U L R E K | R Q K L J I E;U
O G U I S E H Y | S Y I E H U G;O
R X B I A P N J | A I J R B X P;N
F X A N K S R D | K D S N A F X;R
H G M O Q W Z P | Q O W H G P M;Z
T F Y G Q B I Z | I Z Y F Q G T;B
C T V S Y F L E | S F Y L C T V;E
Q C L R D S Z O | S R C O Q D Z;L
G K H Z D T O M | M T H G Z K D;O
D X C J H U R E | J X C U R D E;H
Y X C B U K O A | Y C A O X K B;U
E A D U N S W V | S E U N V D W;A
P J A F U Y X V | V A Y J U F P;X
X R L O E V H F | X R H V L E O;F
A T H V W D M N | V D N H A W M;T
W V J D Z C M S | J S M V Z D C;W
R D Q T N H F Z | N F Z Q H R T;D
T A N O U B Q J | A B T N Q J U;O
D U J Q S E P A | S U J E P D A;Q
E L X Q G O I C | O L E X G Q I;C
C B R T X H N Y | N H C R X T Y;B
E Q S T V Z I R | V I Z T Q S E;R
W C B V T S G U | U V W B T S G;C
P Z H E N I A B | A I B Z P H E;N
O W C F T E S Z | O T C W E F Z;S
T D K P E Q R O | E O D K R Q P;T
X I D U Z L C A | U A X C D Z I;L
W R U I L A Y V | W Y I A R V L;U
B T Z V G U M C | B Z U T G V M;C
T U B E J A R X | T X E B U A J;R
V A Z W Q X T G | T V W A Z Q G;X
E L U P A V G Q | L U A Q P G E;V
W T E O Y X H C | W H T X E O C;Y
X W I N K O D Q | O D Q I K N W;X
L T E D A X V R | D V R T X A E;L
A F D N L B E O | B E A L N F O;D
R U H E A X P M | M H E U R P X;A
X Z C H T G F V | X F C H V Z T;G
M X N P D O R K | R K X D P O M;N
O M E S J P B A | O A S M E J P;B
S M L A G H D Q | M H G L A D Q;S
T R O I B L Y N | N O R T Y I B;L
K S E R N Y B U | N Y E K R S B;U
Y S N G R B I P | P B Y N G S I;R
N G W Y T K U O | T U K G W N Y;O
C O L W U R P I | L C R W P O I;U
F D C X I U P R | P C X R D F U;I
M V K I C L D A | A M I D C V K;L
Q P E V M A O D | V E P D O Q M;A
A F X J Z P U W | W Z J P A F U;X
K E V A M S T W | A M S T V K W;E
R B M G L N T Z | Z R T G L N B;M
M J O L G P T N | M N P G J L T;O
E O P U I B J Z | O I Z E J U B;P
K N B T O U S D | U T S K O D N;B
K D T X F H P Q | Q T H K D P X;F
M K C H U R E D | E U D R C K H;M
Y K G U D M T B | G B Y T D M K;U
R G N D H E K C | R N C E D G H;K
O U T C Z E I A | Z U A T C O I;E
O W I N G X F Z | O X F I Z G W;N
Z U A H G S X V | G X V Z U S H;A
D Y U V F W R G | W V D F G U Y;R
V U C D P O K S | D S U C K V O;P
W A Q Y Z U N I | Y Z U W I A N;Q
B O F C L P D G | C D P L B O F;G
N E R H Y J D V | D R E Y V H N;J
V R I U B P H O | R P V I H U B;O
Y Q C F H G A W | C F Y G W A H;Q
V C X T Q L A O | C V O A L Q X;T
Z X W I N S R F | R F W N S X I;Z
B A F W K Y J O | O K J W F B Y;A
Q N Y T D H S O | H D N S Q O Y;T
A W E B I Z G H | H B W G A E Z;I
C J E M S L G W | L C G E J S W;M
T X K E P H U B | E T H U P K B;X
F C E S X M Y R | R S X Y E F C;M
C L J M U X I B | J X B I U C M;L
O Q I V W L U H | H Q O L V W U;I
Q O F V C I D S | D Q I O V C S;F
S M R K G P E X | K E X M P G S;R
K X N C P J E M | C K N P J E M;X
J O S D Y R T K | Y T S O D J R;K
Z N S P T D F Y | T D Z N P Y F;S
B H J S N X O V | V O J S B X H;N
B R N C J E U W | N B U W E C R;J
W A N H M P Q R | P N M A Q W R;H
J P B Y G L T Z | B T Z Y L P J;G
B X N I Z W O V | X I V Z B O W;N
B X P T R E O V | X B P E R T V;O
Q P N Z M D H X | P X Q Z H N D;M
E K X Y H S R N | E R S H Y K N;X
G W F U Y E A J | W G Y U E F A;J
L O H B F A Y K | F O H K A B L;Y
S L K T D E Y B | E Y S T B D K;L
Z Q W U G M X L | W X M L Z G U;Q
T G K D Q H M B | M T B G D H Q;K
D O X L E T U J | T U O X J L E;D
G Y D J U X H B | X G U J H D B;Y
I R P T A O B U | P O U B I A T;R
M G L I B A E C | M I L C E A G;B
K V Z D A Y H B | V A K D Y B H;Z
W O J Y C G M B | C M O J W B Y;G
T H B R X W V J | W B T X J V R;H
K Z U F X Q H V | F V U Q H X Z;K
S O X K A N T P | K A P O N S X;T
I B S P X Z V Y | I Y X V P Z B;S
R H W I T O Y F | T H Y F O R I;W
J L U S X R K O | K S R O L U J;X
X T R J D I Z E | Z X T E J R I;D
U O M P L V K Z | U O V M P L K;Z
X R C Q F V N B | R X N Q C B V;F
M Z R Q J V F W | V Q M J R W Z;F
N V R C Y S H L | N Y H C R L S;V
S I V R Z U N G | G N Z U R I S;V
R A J P W V F Y | R P W V A F Y;J
Y S D G I A X R | X I S G Y A D;R
F J R M Q T H G | G H M T R J F;Q
S P K L M V O J | L J M S O V K;P
T A Y P K R L N | R A T Y N P K;L
Z P J S X I M W | P X S Z M J W;I
M E S F D V J T | D J F V T M E;S
S R E U F Y T A | Y A T S U E R;F
Z Q V Y M B A T | A Q V Z T B M;Y
Q K J I F V M N | V I N M J F Q;K
X G T J Q N L C | T Q L J G X N;C
N T U C Q S D Y | Q N Y S D U T;C
T Y Q G K U M Z | K Y T Q M U Z;G
Z O E K G F C R | Z R O C K E G;F
F A N G O I Y M | G A M Y F N O;I
Y I M V C G S B | Y I M V B S G;C
V O E A K D P C | A K E O C P V;D
X D W A Z E M I | Z A I M X D E;W
L O T C I M R B | O L I M R B T;C
F P V A U H D Q | P V H Q U D F;A
O S A P T K N L | L N O T S P K;A
K N B U H M V C | V M B U K H N;C
U I D H S Q Y V | D Q U Y V S I;H
Q V S D F P Y O | V O Q Y D P S;F
L A S P Q O V Y | A Y S V O L P;Q
N H S Y V P I G | G I S V N Y H;P
T Z I R Q L D P | Z Q R T D L P;I
J F Z D Q N W B | Q F B D Z J N;W
R S U E J Z A T | T J E S U R Z;A
N P Z L F U T R | R F N Z L U T;P
K C F D E A G T | D E C F A K G;T
W P B J E C T K | E K W T P B J;C
M G L F K U Q O | M L G Q O U K;F
H C U V L T I Q | T L Q U I H V;C
L H R Q U O P X | X O H P U R Q;L
V G M A O I J B | O M A I V B J;G
A Z T B R N J I | T R I N Z A J;B
I G R N W U S D | D N R W U G I;S
Y H P A S C B D | B C P A H Y D;S
Z Y D T R E N M | N E D Z Y T R;M
E Z W G T B S Q | Z S T B G Q E;W
X E B N Y R C A | C X N R A E B;Y
H S B O U N J G | U N H O J S B;G
B F R I T J C U | T C U B F J I;R
F E S W P U C T | E W F S P U T;C
W S F M I Y P U | W P I F U Y M;S
Z C Q Y L S P O | O S Q Z P Y C;L
C B N X G S W O | O W C G N B X;S
G J D Q P A Z C | C P G J D Z Q;A
J E D Z I T P C | Z E J D P T C;I
U Y H B W N F K | N Y B W K F U;H
C A E W P U G L | A W E U G P C;L
T Y M B C F H S | F Y T M C H S;B
W J R H L A E Z | L H Z A W R J;E
F C H I G S K W | K I H G F C W;S
E R M T S Y C X | R T E S M Y X;C
H D A X M G N S | A X G N H S D;M
V P M K D U B E | V D P M B E U;K
L E W A N F G R | R W F A G E L;N
V K L G B D T P | K T P G B V D;L
J W Q O T A X R | A R T X O J Q;W
K J B O F V Q X | J B F O X Q K;V
A Y G Q X J T U | J Y X G Q U A;T
H X C S M N K L | C K L N H S M;X
X F Z Q U V L Y | Y U Q Z L X V;F
N W D J Z E L C | C N E J D W Z;L
S P R N Y C M U | U S C R P Y M;N
M R I O Q Z Y T | T Q I M O Z Y;R
F D S E M C R V | V F D M S R E;C
Q L R J A I Y W | J Q L I R A Y;W
I R T H O N G E | I R N E G H O;T
M S G J P O D B | G B J P O M S;D
W Z G Q A B J N | G A B Q W J Z;N
O S G F J D A V | D V A O F S G;J
T V U C F I X A | A V C X I F U;T
G E C Z J X N I | I E C X G N J;Z
F V T Y C U K X | C T Y F V K X;U
K P X R C Q Y N | N P K Q Y X C;R
M T W C V E B Y | Y B C E M V T;W
K J P U E S O X | K X O J S P E;U
K H S I X D N R | X R D I H N S;K
S G C Q X E B L | L S Q E C B G;X
W G I A T Z E F | W I T E A Z F;G
Q B Y U X O Z L | O Q X U B Z Y;L
B E C G S H Z Q | G E Z Q C H S;B
W L X O A F T K | K O A F L T X;W
W Y B S P Z N M | S N B M P W Y;Z
T E B S L V O F | F B T E O L V;S
Z F G C K R J W | Z F W C R G K;J
F N H R B S T Z | F T S B N Z H;R
J C O E G K V U | V G U E O J C;K
R Y I Q B A D F | A I F Q R D B;Y
C E M Y P V S R | V M R S Y E P;C
I V D Q T S J M | T I V J S D M;Q
V B O M Y Q N Z | B O N M V Y Q;Z
D S E C W L H O | L S O D H W E;C
G X Y T N M W Z | W T G N X Z M;Y
A U N X F R I W | R U X I A W F;N
A W Q C I R F E | C R F A W E I;Q
R W H P L S U V | H V P S W U L;R
B N L Y I F S U | N S B U Y F L;I
H I J V B Q N W | H N V J Q B W;I
L S H E D N U I | E I S D H U L;N
N A T O C B D W | N A O T W D B;C
D F T J Y Z M A | T F A D Z J M;Y
Y W U R E J Q T | E U Q W T J R;Y
C N T D Y O F V | Y N O V D T F;C
V E G H Y I D B | G I V E H Y B;D
E T J C Y S O L | E Y S T J O C;L
Y F L N A V E W | F V N Y W L E;A
A S B X V F H D | D B S A F X V;H
N V D L P T F B | P V T D L N F;B
T S X V B Y G J | V G J X B Y T;S
K N E J O S H A | S A J K E O N;H
W D B A G V I F | A D G V I F W;B
A R S D V Y X U | X R D S A V Y;U
K T D F M N Y B | N Y T D F M B;K
D S Y B U H V F | H F V Y D S B;U
G N X K O S Z J | Z N O S X K G;J
V M X T S F I Q | F S Q V X M I;T
N X I C Y V B P | X V C N P I Y;B
K H P B Y T R M | P R Y T K H M;B
W H A Q Z F X O | O Z A H X F Q;W
I A Z J N G L M | G M N I J L A;Z
P A R B Y H W X | A Y B X R H P;W
Y C J Q I M Z K | Q K Y M C I J;Z
X K O U C Y Q S | S Y X C U K O;Q
V Z A O U T K F | A U F K O T V;Z
N R S L A I F E | N E A I S F R;L
U B T N J Y Q E | Q J U T N E B;Y
O P F H Z X U M | H O F M P U Z;X
U P H N C F W I | U N C I P W H;F
W X C O T K Y A | Y X C A W T K;O
C X Z O U P T L | P O U L C Z X;T
J U F D P Q M C | C M U Q D F P;J
Z A K E L J P I | A Z I L P K J;E
F D X R P S I K | D X R S P I K;F
L C K G U B H F | K C B G U H L;F
J A W S T B G U | G W J B S A U;T
R O L V C G Z T | V T R Z C G L;O
R V K O A T F J | F R O A T K J;V
E G D H N U Q O | O H D U N Q G;E
T F X M E J U B | T X F U J B M;E
B U M A I Z V O | M Z I A V B U;O
X B H V W A L R | H W A R L V X;B
X E H C O J W P | E O H W J C P;X
U X P I G C Q V | I X Q U G V C;P
J Z A D G M L Q | Q M G J D Z L;A
X R V Y G T E J | R G J E T X V;Y
O Q P B G S J I | P J I O Q G S;B
L V J F Y U D H | U H Y D J V F;L
N F R X A P K D | P X A F D K N;R
O J H T G E Y B | H T E J B Y O;G
F G I L J Q X N | F G J N Q L I;X
V A H M E Q O S | S V O H A M Q;E
N E G C B T K O | B E O N C T G;K
O U J V Y T A P | J P O U Y V T;A
Y A W Z S R G P | P Y Z A W R S;G
G B S M X I R U | B R U S M I G;X
S H Q I G W X A | W A Q X S I H;G
A J F Y K P T L | J K T A L Y F;P
F J I U N P L T | L N T I F J U;P
W S D F N J C U | S U J C F N D;W
P U I Z C Q O V | I V P C U Z Q;O
Y U W H B T F P | H Y W T P B U;F
X R O K E G Q Z | X Q Z R O G E;K
J A K Y D Q M Z | Y Z M Q D J A;K
T C R U V O L P | R C T P L O V;U
R Q D I N C W H | N Q W R D H C;I
W R D U Q L S B | D B R Q S L U;W
M F A C P S R B | B M C F R P S;A
Q X H E K S N L | K N H Q L E X;S
O X V M T N D A | N X D O M A V;T
S I U L C Q N G | Q I G C N U S;L
G O V J Y K Z U | J G V K Z Y U;O
X J P Z T C V Y | T C J X V P Z;Y
Z T C D P J B R | C D T Z P R J;B
P O R U C G F N | O N G P U F R;C
A Q B S H F N K | Q H A S K F B;N
S F T W Y D K N | K N T Y S F W;D
W L G D E H X T | X H L G W D E;T
A R O G S U V E | R O U V S G E;A
S O E Z L B V T | B Z E T L S V;O
N V H R M B K A | R K M V H A N;B
J U Y F H B O W | Y U B O J H F;W
N T D X J E A C | N T J A C D E;X
N I L V H B M Z | V M L B I H N;Z
X Q F K G E D I | K F X D E Q I;G
J X K H F A U O | X A H F O K U;J
X L J V F U T A | A J T L V U X;F
T J N D L F V H | F N J T D H L;V
U I H V N O S D | D O I V S N U;H
F P J B R N G V | G B R V J N F;P
N G L S Y J H R | H S G R J N L;Y
B O T E U G K N | N K O E T U G;B
O W A Z M J H R | R O W Z A H M;J
T G N A L R C O | O C N L R T A;G
F M V E Z U L X | X U V E M L F;Z
H D K U E P J G | P D H U K E J;G
I S T Q Z M N D | M T S Q I N D;Z
D F M T R X I E | M E R X T I F;D
D G R F Q W B A | D W G B R F Q;A
L J U Z X D A Q | U A X Z L Q J;D
U F W Q G A C V | V U W A Q F C;G
N K A X V O Z H | O N H Z X V K;A
X W V D G U P I | V P X W G U D;I
N A Y Q P H R E | R E P N A H Y;Q
H O D F L N S W | O N W L H S F;D
E R U C O A I L | C A I U O E R;L
K T W N Y I M S | I T Y K S M N;W
G K M D V L E C | C E M V K D G;L
W G I H S B Y M | M W B Y H I G;S
A L O C G U P Y | L P C A O Y U;G
J Z X Y B H S T | H S X T B J Y;Z
C S H P O D I A | C I A H O D S;P
Q W P L X J N M | P J M N Q X W;L
L N Q Z U D W F | F D Q Z U W L;N
B A F I M L O E | B O L I F A M;E
P U V M C J X B | B P X J C V U;M
V N G H L Y F O | V O N H G Y F;L
P Y S G O C X V | G Y X P S O V;C
W X K G P T N I | W P N K T X G;I
P N O J Y G I K | I N P G Y J O;K
W Z H D I A T J | Z W D T J I A;H
X I W R C F U P | C U R I X W P;F
G K C J U D V B | K G V D U J B;C
V R S O E Q U X | Q O R V X S E;U
B A V J H E F G | F E V H A G B;J
Z J V K N A Y D | J A K Z D N V;Y
D Y O N C P B H | O D N C B H P;Y
J H X V D P C T | D C T V X P J;H
E H L V Z F W D | L Z V D W H F;E
S O E U Q M B X | E X B Q O U S;M
A U S P R T J B | P T S B U J A;R
W I B V S Z A Y | I B Z A Y S W;V
X G J B Y R E Z | B X Y R G E Z;J
W Z F P Y L D J | Y L Z F W P D;J
F E W D H Z Y T | H D E Z T Y W;F
U H W P B M N S | N M B U S W P;H
V Y W J U L Z Q | V Z J W Q U Y;L
C M B J L U X W | M X U J L C B;W
N L V M E U C X | M E C N L U X;V
L Z J E B P K I | B K E P I L J;Z
X T B L P Z C D | L C T D B X Z;P
O Q E B S Y A M | S M O Q Y A E;B
J U Q F N T C O | U N C Q F O T;J
M S W Y G V D F | V D S M Y G F;W
J Y B U Z F I V | I V B F Z J U;Y
N I P T V W K O | K N P W V T O;I
W R P T G V H N | N G V H P T R;W
H D V Q W T O P | D P O V Q H T;W
F Z C X V O H B | O Z F C B H X;V
S J T I M H N D | T H I M S D J;N
O R P C W Q A D | R C D A W P O;Q
R N X G A C J M | R J M X N G A;C
E J Y O A C L B | J L C O Y A E;B
Z U W D Q M A S | M Q D W A Z S;U
S J N H G M V X | G V S M X H N;J
V W L J H X M T | V T W H X J L;M
F U J A I C N L | N I L U F A C;J
G A F C V P W T | T P G A F W C;V
I V Z S F L O W | V F W Z S L O;I
O H C J Q F R T | F R O J Q H T;C
S T K E H L W O | L W K S E H T;O
A W V L I C T B | B V A I C W T;L
C S D L H X Z P | L Z P S H X C;D
K F A G D Y P Z | P G D A Z Y K;F
S B J U I K V L | V I K L U S B;J
W J G S R U A T | W S R J G U T;A
L X U H D M B V | B V L M D U X;H
P I Q J W Y K F | Q W P K Y F J;I
E S J I F V Z O | E O I S J V F;Z
X C Z A U T F J | C J U T X F Z;A
M V A J P N T E | P J M A T E N;V
Y D S O N L I X | O N S Y L I X;D
X K D P S O Y V | D O K P X V Y;S
W A N G P X C B | B X W G P C N;A
H J Z F S W Q X | Z F H J Q W X;S
Z N D L W G C R | L W R D Z C N;G
B D P X N E R S | E X S P D B N;R
C B R W F D O I | C D F I O B W;R
D K A X W G R Q | W R Q K D X A;G
J T B S O H X Y | S Y B T J X H;O
I X K T B F P S | S F B X P K I;T
I Q E G L D P N | L N I P D E G;Q
P S O G W J K Q | S P K J G O Q;W
H G X A V K C J | H A C K G V X;J
U H W X P J S R | R H X J U P W;S
J Q E T Z B K G | Q K G B T J Z;E
M Z W Y X Q N B | X B Y W N Z Q;M
L O A Q K T E P | L Q T A K E P;O
N P E T V R A U | N R P A E U T;V
F E L O H Z M A | A O M Z L F E;H
J C N G K M S E | G S K E J N M;C
D T M V I X S W | M X S D T W V;I
S Y Z G T K R E | T S R K G Z Y;E
W G N R I F Q H | H I N W R G F;Q
Y W X A R E K B | R X Y B K E W;A
G Z Y H A V P B | Z A G P Y B H;V
Y F H I A S Q U | I A H F S U Q;Y
P J W U R Q I T | U R I J T Q W;P
R Q M V G B H Z | B M R Q Z H G;V
U D N C E M Z T | E C D T Z U M;N
A D B F E V U T | F V U B A T E;D
E Y L H V M A N | V A M H E N L;Y
Y H R U Z P K L | Y P L R U K Z;H
Z D O F K G Y I | O I F Z G D K;Y
O K F A P J N Y | O Y P F J N K;A
X N F H T S W G | F S N G W H X;T
I O E J S K V Y | S V O I Y E J;K
I Y J M K X O B | I B K M X O Y;J
V T B Y H G L S | S V T B L Y H;G
Q K B N W M T G | B T Q G W N M;K
I V T G Y Z A B | B Z I T V A Y;G
Q O A F I L R B | I B Q F R A L;O
E C L D I O G F | G L C O I D E;F
N M E L C P K R | M L K E P C N;R
X W Z V E U P D | P Z W X V D E;U
J N P T F M C A | P M T N C F J;A
W U X S C Q D I | Q W D I X U C;S
L J H V Y F Z G | Y Z F J H G L;V
L K R F A C N J | F J C R A K N;L
M L Q V Y P G C | G V Q P Y C L;M
F N W Q S J K C | K F S N Q J W;C
V I G N B Z S M | Z I S G B V N;M
A E U G M O F T | G F O M T E U;A
E W M P V U Q G | W E U M P V Q;G
D M H K N Y F W | M K F D W Y H;N
R F V K C M P U | K P F M C U R;V
V I X L E O A M | L I M O V A X;E
Q F N S I J B K | I K B Q S F N;J
O X E Q H K S P | X S H E O Q P;K
H N S T J B I P | J I T N P B H;S
E P Q X A I W G | W Q A E X I P;G
P O L U Q J C A | Q L U P A O J;C
W O J M G B L C | C L M B J O G;W
T K E S R U V C | K U S R E V C;T
V T M F H G R B | F B G R T M V;H
Q Z U P A B L H | U Z L A H B P;Q
X J G H F O Y N | H O G F Y J X;N
O W G F N X V L | G W X L V N O;F
I B E S P K U T | S I P K B T E;U
B Q T D A O R X | Q D A O T X B;R
W V O S J C D R | D C W J S O R;V
Y D N T H I B W | Y B D N I T W;H
Z A T W N U I C | N W A I Z T U;C
M R Y U T E V A | Y M V E A T U;R
J P G K N L Q E | K Q J G N L P;E
A M L T I Q X C | I X C M Q L T;A
H F N V T L A B | L A B F V H N;T
Z M K B N H U S | S M N Z K B U;H
F S I V J B A G | I B F J V A S;G
L S K U A E Q D | A E S D K Q U;L
L G O S I Y R A | Y S I R L O G;A
D L P E J H R C | L H D P E J R;C
E F D P H N I Z | P H E F I Z N;D
A Y H J G X L S | L H A X G Y J;S
K B V P G Y N S | G B S Y N P K;V
T Z E F P U I Q | U T P E I Q F;Z
D Q J A B R U P | Q R D J A B U;P
L M N S U Q H J | U M H Q L N J;S
U T Q W X E J V | Q V T U E W J;X
U Z Y J R C H F | H J Z F C U Y;R
H L K B A R V D | L K V D B R H;A
G X E Z F A L K | L E A X G F K;Z
N Q L K S V R A | Q N L K R S A;V
W S L F Q Z J U | F Z J U S W Q;L
P K C M Y J W V | J V Y M W K P;C
O B K C N D H F | D C N H O F B;K
H A Y K M J V Q | M A Q Y J K V;H
W Q P V I T H C | I C T P V W Q;H
K M H F T A Q W | Q A H W F T M;K
U Y O J K R H P | J Y R U O P H;K
D Y F G T E R P | P F E R G D Y;T
A L C P G R S V | R C A P G S V;L
I V U E R S M C | U V E S C M R;I
L D Y Q K F I E | K Q D Y F I L;E
N Z D V W T S Q | V Z S D N T Q;W
N B O T K V I S | B O V T N I K;S
M C W T K A U J | U W T J C M K;A
C N M Z D F Q B | Q N M B F C Z;D
T Z Q A M W H Y | Z M Y A H T Q;W
U K H Y D E N R | E Y R U K D N;H
A N X W P L R U | W A R L P U N;X
L Z O I U M G C | Z U M I O C G;L
E V P O F Q Z N | F Z P Q V E O;N
P O I Q X K T G | X Q T O I K G;P
D A H W M L V T | D M W A T H L;V
D A E Y L U M S | S D M L Y A U;E
O E U D Y H R K | R O E K U Y D;H
A P Y V D U R N | P D V Y R U N;A
B C T F R K X U | K R T X B F C;U
E O D G Z T F U | E Z U O D T F;G
G Y L W M F X B | M L G Y X W B;F
B Y A U M T W K | K W B T U A M;Y
A N U C V T O E | N U O T A V E;C
Y B Q F S X T K | Q T S Y K B F;X
M H L V R A I B | L B M H V I R;A
E A X C I S L V | A S V C L I E;X
Y Z L E U S W P | Z W L S P Y U;E
V F P T J I Y Q | Y I J Q F V T;P
J D U R G I T X | U J G X R D I;T
V M Q J P R F N | F P R N J M V;Q
L X F S D U J T | J D S X T U L;F
Z F T W M L X Y | Z M X W Y F T;L
U X Z R D V B A | R X D B A Z U;V
J T N V F E I Y | Y F J T N V I;E
Q D L G T O N I | T Q G D O I N;L
Z Q X I U B E H | I Z E H Q B U;X
H S D Z T F X W | W H F X D Z S;T
S D X Z T M C J | T X Z M J C S;D
I D Z L E R X C | R Z X E C D L;I
U N P D O Y Z R | U Z N Y O D P;R
X J L N D G R H | N X D L J R H;G
K Y N I T M W B | T W I K Y N B;M
O H Z Q A P M W | Q O W M P Z A;H
Y H X K P J C O | H K O X J P Y;C
G A O J M W Z I | I A M G O Z W;J
C B N F I M V K | C M I N K B F;V
G Z F S I Q V X | V Z Q S G I F;X
L Z J Q C V A D | Q C Z V A L D;J
A D Z C W B U F | F U D A W Z B;C
W A I R D Y S T | D Y I S T R A;W
D S F Z W X P H | S D Z H W F X;P
U P F E S T I B | F U P E T S I;B
S B Z K O Y A C | K S B A Z C Y;O
S W F K Y M J O | W M S F J Y O;K
Y V K Q L S D G | S V Y D Q G L;K
Y P G V Z W T H | Y W Z P T V G;H
E A L F R T K D | R A T L E F K;D
O B U W I V J H | U O J W B H V;I
D L Y K T O X F | L Y T F X O K;D
B J P A L T I W | B I J T P A L;W
R A H W G K Z D | K G A W Z R H;D
C J K Z P Q D M | C Z K Q P D J;M
C B P U M Z W H | H Z C B W P M;U
V E F O C S U Y | F C U E Y V S;O
R F Z L P N Q D | Q N R D F P Z;L
B M R L X V C A | R L V B X A M;C
K W U M L D X O | W M K L D O U;X
V X C R O P K Z | P R O V C K X;Z
B C T Q E K I P | Q K I P E C B;T
E N D Y W B I Z | I W Z B E Y N;D
U L E I S Z W X | U I W S L E Z;X
I T N S W K Y V | K Y T W I N S;V
I X C Q N S Y P | C I Y P N S X;Q
J I D Q P E M C | E Q M J I D C;P
W A Y Q J C S U | W Y J S U Q A;C
N P Y U S E K L | E K P Y N U L;S
O K I Q R L F S | O R S K I L Q;F
N D Y J I O S E | J N O Y E I S;D
I R P Y K F D Z | Z Y I P D R F;K
A S G L U Y O E | Y E O A S U L;G
O S Q U K P F G | U P F S Q G K;O
P W A T C Q F E | F T P C A Q W;E
A J Q M Z I H W | J M Q W I A H;Z
O I M Q K E V S | E O Q S K I V;M
P T Z D R Y V H | Z Y R P V H D;T
M J A Q Y Z S X | Q A Y M J S X;Z
F X B H W T I J | T H F B X J I;W
O H E B J T C U | E T B J C U O;H
K O Z Y N U G Q | Y G O Z U Q N;K
R Z U T V G M I | G Z U T I M V;R
Q I M N F P T J | P J M T F I Q;N
V C E G B N O Q | E Q O N C G B;V
Y S W K H F N E | H F E Y S K N;W
E P O G B A H K | E H K O B A P;G
F K N J W G B P | J W B N G P K;F
K R J Q I Z B V | R Z Q J K B V;I
Y B C A V U S L | B V U Y S A C;L
I J P Y B T X O | J T B Y O I X;P
M S C V R D Y N | C R N Y D V M;S
W J V D A K O Q | A D V Q O W K;J
A C R P B J E M | M C A R E B J;P
Q B X S W T U K | U X Q S B T K;W
T S R L Q E D M | T E R Q M S L;D
V R D A T E F B | B F A E V R T;D
U S I M R G H F | M U S I R G H;F
Q P W U Y Z J F | Y Q J U W P Z;F
I C V X O T D S | C D S T I O X;V
S N G H L D W R | W D L R S G H;N
R D C Z I P M X | R X D Z C P M;I
D X Y S I T Z O | D Z I S X O T;Y
A L M G I U S Y | A L G Y S U M;I
K C N V U W M P | N K V U M C P;W
A J Q Y S G O E | E S J Q G O A;Y
S P O K T Y J X | P K Y J S T X;O
Y L A G T K X S | A S K L Y G X;T
U Q T H A Y N I | Y U I T H A N;Q
Y O A K F V T D | D F K A O Y V;T
L U A J K Z F V | A Z L V K F J;U
X T N O K S C G | G T C N K X O;S
T A K P G F N X | K N A X G T P;F
G J Y E O B U T | J B E T O Y U;G
O H J P Y Z U R | U P R Z Y O J;H
H E C X Z L O K | X L K O Z C H;E
B E C Q R T L Z | E B L T Q Z C;R
X N R K Q U W F | F K N Q U R X;W
G C Z B K Q O W | B Z G C O K Q;W
H A X L G B D Q | B D L G A H X;Q
X B R G U T E F | E T B F U X G;R
Y I M O D S K W | O I K W S M D;Y
Z L G X S B J I | Z X S G J B L;I
E U C P G T D J | T P C U J E D;G
P E B C Y D F V | B Y C F D E P;V
T N U V A L D Z | D T U V A Z N;L
A E S B J O T I | A E O I T S J;B
J A X N L V P U | L N V U X A P;J
S W F T H Q I V | V H F Q T S W;I
Y J W E S R L D | E J Y S W L D;R
H T B F I A E O | I A O T B F H;E
L N J D W Z P M | D L J Z M P W;N
O V F M N G B Q | G O V Q F B M;N
J Z F I K R Y O | F Z J O K I R;Y
N X S U A J O T | O S T A J U X;N
T L I H X P K B | P I B L X H K;T
Z Q T M B Y D G | B T G Z Y Q M;D
A J G Y D F E P | Y E A J G F D;P
U O B W P F S Z | B U F S W P Z;O
P X F M B I K O | X F P B O I K;M
K A P F O E C N | E N A F K O P;C
U A L W Y S H I | U W H I L A S;Y
Y X F Z M R L I | L X I F Y R Z;M
D K T X Z U B P | X P Z K U D B;T
N P H U E O B Q | H Q O N E P U;B
R Q B K F G M D | K R F Q G D M;B
N F B H L M Q R | B Q N L H F M;R
H Y E J G O B K | H B O E J Y K;G
T S W K C P X B | B C T W P K S;X
V X D Y A H W J | V J X A W D Y;H
V E T H X J G P | X H P E V G T;J
P Q C I S Z D G | G I C Z S P D;Q
D H K P Z O E L | H Z P D O E K;L
N H P X U V W A | A H V U W P X;N
W G E V K R S B | R B W S K E V;G
F M Z Y L X P T | F T L M Y P X;Z
U F J M P I W A | M U J W P F I;A
F W O K Z Y P A | A O P Y F W K;Z
Q X A B E W Z R | R Z W X B Q E;A
P Y C H M K F I | I Y H M C F K;P
T P Y R S N D K | T S P N D R Y;K
I H D B G Q E R | G R D E H I Q;B
T Y V O E C M R | T V O R Y M C;E
F Z S T Q W O N | Q Z N O T S W;F
U C Z W S F M X | X Z F C U S M;W
G V C X Q S N B | B Q S C N V G;X
C X L Y R F Q S | C S X R L Q Y;F
B G X E H U D R | R E H B D X U;G
F P X U R Z M Y | F U X Z P R M;Y
B Q F K I M S A | F S I B M Q A;K
O Z M N Y V J F | Z M O F Y N J;V
B I U M P X A E | A X U M E P I;B
D N S C J O L W | W O J N S L C;D
U W O J T S E R | T O W J R U E;S
I Z Q M G T F X | G Q M T Z X F;I
A R L G N T P F | G A R N T P L;F
C R Y G E W H T | W T H G R C E;Y
I R P T Y C S L | C S L P R T Y;I
W G F H P L N B | F G B W H P N;L
E U J I L H Q X | Q J H L U X E;I
O V Z I L H B P | O I Z L B H V;P
I O K F A J R T | K A T F J I R;O
M R V U D I B L | B L M V I R D;U
G V L S F D N O | V S L D F G N;O
M S W Z R Y B T | W S T Y Z R M;B
M Z K L O U H J | M U Z K J O L;H
W H S B U K G Y | S G Y B W U H;K
E I X Y B J Q P | P J Q Y X E B;I
E U L I Q W M N | I M U E Q W N;L
D N V F S L J M | L M J N S D F;V
T N J Z K W H M | W T K H N M Z;J
K Z P N R O E A | Z O P R E K N;A
Q S K D M X F Y | D X Y S K M F;Q
U G D B I Y L Q | G Y D B Q U I;L
V X F C J E O L | C X J L V O E;F
O Q D W X J G I | I X O W G Q J;D
C N W P R O G J | J W P R O N C;G
J L A O N Z Y V | L Y O V Z A J;N
J M R N T L K S | M T L K R J S;N
Y B T I Z J W X | Y T J X Z B I;W
R C A S I V P Q | Q I V C A S R;P
U D V L B Z F P | D F L B V Z U;P
G Q J V S N X R | V S G N R Q J;X
E X R Y H P D M | R X Y H P M D;E
E R U Y O W B V | Y R W O U E B;V
R U L O G D X A | R G A U X L D;O
S R Y M E G D J | S M R D E Y G;J
R M N U W Z G D | N U R M D Z W;G
I B K E T U N H | U H N E B K I;T
A S P M R Q H W | P W S M H Q A;R
O C X I B V D U | I D B U C V O;X
A Z X G F N V H | N V F G Z H A;X
E Z B A U L J S | B J A U Z S L;E
G N R J A M X C | A M C X G J R;N
Q Z N O E A D F | D E Z A Q F N;O
C D M T Y K N O | O C N T K D M;Y
O G W F L C S V | O F S C W G L;V
L Y Z O X C U D | X C U O Y L Z;D
Q P O J N W E Y | N Y J O Q P W;E
K G Y C O T D B | K O T G C Y B;D
F V Q A G X U C | G U A V F X Q;C
G O R K I W M J | M R K I O G W;J
Z B X S U G Q Y | Q X B S Y G U;Z
Z I S F J C O X | O F C S J I X;Z
D S V H N J Z E | H J Z S D N V;E
L I U T O R M B | R B U L I O T;M
U S A Q K D L X | Q K U L S D A;X
W H Q L U T X F | Q T H X W F U;L
X Y M B I A V E | B V I A E X M;Y
B O J G H I P N | O N J H I B G;P
F R L S I V Q A | Q L A S R F V;I
O H M Z N L A B | N Z M O L B H;A
S J B G X M P U | M P U B G S J;X
M Z T X F U G W | T X M W F Z G;U
I F Q V H U B X | Q U H B I X V;F
V O P Q J B L X | J O Q B P V L;X
P B K D H Z E T | B Z K D P E T;H
Y O D B E W R P | Y P R E O B D;W
I O X H E B F R | O B I F X H R;E
U M G X E I K F | M F I U X K G;E
F G M Q X R E V | R V X G E Q F;M
C A S O N D R J | O A C N S R D;J
W L A Z Y J G I | Y W J G Z L A;I
W T N H A L G Y | Y A L G H T N;W
Q X B W L K H M | M Q K L H X B;W
Z N Q P H A I E | A I N H Q P Z;E
Z L O U W V F E | L E F W O V U;Z
H Q V E G M S W | V H W G Q S M;E
Y I A B F G T N | T G B N I F Y;A
C Y D M O K J N | J Y O K M D N;C
B J O E L M P G | G B J L E O M;P
Y F D N M A E X | D Y E A N X F;M
D W P Z V M L C | P C W Z D V M;L
N F G H C T E X | T F G C N X H;E
Y U L K P F A D | D L U P Y K A;F
J D K U M W H Z | W M U Z H J D;K
M S C U B G A W | G U W C A M B;S
Z L D F B M I Y | D Y L I F B M;Z
U T V E G Q H B | G E V Q H B T;U
X T O J A W Z C | W X A Z J O T;C
P E F D Z M B V | Z B D P F M E;V
C X M I P V T O | C O T M X V P;I
F P V R W Q A D | D A Q V P W F;R
P V B S Q R M H | B H V R Q S P;M
P Q R D E K C Z | K P Z E R D Q;C
I F X P L N Z W | W N P L X Z I;F
A R X L Y F T E | T E Y F X A L;R
S H X T M N B F | H M T S F X B;N
C O E D N T P H | E O D T N P C;H
S B Y E W R N C | W E Y R N C S;B
S L P U I N T B | B N T U I L P;S
I V H T E G K O | H I E V O K G;T
C P W H R Y O L | W L R H Y P O;C
M Y V K F D E I | E D K Y I V F;M
U S R N Q G D E | U R S N E D Q;G
F B K M V T I X | X T K F M I V;B
C Z F M B V R D | F R M B V Z D;C
C H D Z I E N F | E H Z C F N I;D
N J L F B E Y Z | B J Z E Y L N;F
Y X M H L B O D | B D M H Y O L;X
L H R Z C G E N | Z C L N G E R;H
W G P Z F S H N | F Z P S N G W;H
I S P A Y C R B | Y P A S I B R;C
R F L G C O W Q | O G Q L F C R;W
F H Z B P E V Y | E F H Y Z P V;B
I X R S P C Q U | I S P Q X U C;R
N Z S K G M L D | Z S M N K G L;D
A K S C L F J R | L K A S F J C;R
O Q A T D K R M | M R D O Q A K;T
X M V T N P B F | N T B X P V F;M
I K B Z X U D E | I E K B U Z D;X
Y L J O V N R Q | J L Y R O N V;Q
C Z T D B U X I | X C I B U D Z;T
W Y H U S L E A | A W S Y H E L;U
L R F T S B E M | M F L R S B T;E
S R P W E A U Q | U E P R S Q A;W
B X Z Y F Q K D | Z D Q Y F K B;X
O X L D R A H I | A D H R X O L;I
C L W H N S J X | S W C H N X J;L
B N M A I Z R P | M R Z I B A P;N
D Z T H I E W R | Z E R I H T D;W
H T G N F E S P | E S F P H N T;G
W F G D P E J Z | Z J P G E W D;F
K E V Q W L O H | O H E W V L K;Q
Z Q F H A O N B | H Z Q F O B A;N
C D Z S V P O E | C V Z O P S D;E
B U Q Y X E J P | Q U B E Y P X;J
T V N K L Q J D | D J Q N L V T;K
C L H A G O V Y | G Y H V O A L;C
P M E C W U N V | M U V P C N W;E
R T M L O K E C | M T K R C L O;E
P G X A V T C Z | V Z A P X G T;C
Q P A E V Z M U | A E P Z Q V U;M
D H A I T B C W | W T C I D H A;B
Y V X G R B W H | V G W R B H Y;X
Z L W S Y V J E | W E S Z L J Y;V
T O A Y H D Q B | A D O Y Q B H;T
A W K Z G Y P C | Z Y W G C P K;A
I H K D G V Q N | D K H V G Q N;I
F S B O H M K G | G K M H S O B;F
U T A K B G Q I | T G A U K B Q;I
X D A V T P J Z | V Z J A T X D;P
H J Q M X A G N | Q N G X J A H;M
W U P O V S M Q | O V W M U S Q;P
M V A L X E J Z | X L J Z A M E;V
X Q O M E C G D | E M O G C Q D;X
K P T A F U W L | P U L F A W K;T
B R K U D J Y I | J I D B R U Y;K
N A Z U X M V P | V M N P X A U;Z
J Y L D Z G A U | Z L D Y U A G;J
F B P Z S C A Q | B S A P Q F Z;C
Z K D S O G R I | O G D R K I Z;S
N I J C D U H Z | D U J Z H C I;N
S Q P M L X C D | X S L P M C Q;D
T B R W Z Q P M | Z T W B Q R P;M
P W C L J Z Y E | J W E C Y P L;Z
I R T J G X A W | W A G J T R X;I
F X P C H S U Z | P C Z U H F S;X
M N F V L Z I B | F Z N M L B V;I
E B T W Y H P Z | Z P E B W T Y;H
U D E T K V B N | E U N B D T V;K
N Z P G S J Q A | J S N Q G A P;Z
L E Y X P W M V | V L M Y X W E;P
M W L A Y P G J | W M L Y J G P;A
O D K X Q I L B | K I B O Q D X;L
M O H G E U P S | E P O S U M G;H
T F K M I V B C | I V T K M F C;B
M I J S K F T L | M L F K S T J;I
R F V J X I S H | R H J S F I V;X
Z N R Q K F S W | F N W Q K Z R;S
I O R U P N J H | O U P I J H R;N
Z V U L N K X D | X L D N U Z K;V
A J C R I M H L | J R L M H I C;A
G Z R K A U X B | U A B Z X K G;R
M I K W Y X U H | K W Y U X M I;H
T X R C J M Q B | M T R X C J B;Q
U G S T D P C X | U S T P X C D;G
S V C M I J P Q | J I C M P Q V;S
M X A L T O D N | D M A N O L X;T
M D G E W R I K | D R I E K M W;G
B R W L N M F U | B R W L N M U;F
H J M F C U K S | H F K U M J C;S
E S G X F Y K U | S Y G X U E K;F
A U N H O I M T | H U O T N M A;I
A U S N J X H Q | X N U J H A S;Q
D Q Z B E T F I | E Z D B T I Q;F
H S Q A C U N Y | A H N C Q S Y;U
S X D I R E O Y | I R Y D S X E;O
M B C S O I K Q | S Q C I K O B;M
X K M O Y I G Q | K X Y I M G Q;O
U E K T H Z C Q | H Q C Z E K U;T
A K B U L H W S | A U L K W B S;H
O D E V L C Y I | E Y O I D L C;V
G W J V X E S L | L E V X S G W;J
P K T Y E Z I U | K I P Y U T Z;E
P W D R M U E O | O E M D U W P;R
V J E F T X O A | O V T E A J X;F
V Z M D U O I R | V I Z R U M O;D
J W Y L I U B X | I W Y U L J X;B
V N I R M K T U | M T N U V I K;R
A G T M F D B H | A H G T B F D;M
R N V H C W O Z | R V C H Z W N;O
M G U F S V B K | M V S F G U B;K
O P V S K J X C | K S X O C J P;V
F A E T J R S Y | S E J A R T Y;F
R O U M Y S C Q | Y R S M U C O;Q
G U R K P Z B F | B G P K U Z R;F
Z E R C B G O P | C O B G P Z R;E
Q U E D K G S T | T U G K Q D E;S
T P C Z L A X B | L A P C X Z B;T
E A F Y R V O U | E R A V O U Y;F
K Z T Y O D B S | D Z B T S K Y;O
O H Y W I L B F | F O W Y I B H;L
O U T R N I F Q | R Q O N F T U;I
T F Y G A H U K | H G T U K F Y;A
S H R Z U W I X | X S H U W Z I;R
H M A F N L B V | A M L V F N H;B
Q S K N R J C X | K J C R Q X S;N
Q G A F W Z X M | Q F G A X Z M;W
E M Y G W Q J O | J E Q M G O W;Y
X E J H B F V D | J X H E D B V;F
I D W A P C L U | U C A I L W P;D
K N F A D J U P | P N U F D J K;A
H J N U L R Z Q | N H J Q R L Z;U
Q U A H C X K G | A Q H X C K G;U
G J M X D V C W | X W M D G C J;V
G Y Z M T N U L | T G L N Y M U;Z
Q V D Y B T U E | V T Q E B D U;Y
F O H Z U X N Y | O X U H N Y Z;F
S F R U V I Q B | S R Q V I U B;F
V N Y C U M A F | C Y A V F U N;M
M E W C R J Y O | R E J Y M O W;C
E D Y L S N W H | H L E Y S W D;N
S F T J G D E I | I E G S T J D;F
D K C A S Z B Q | C Z A S B Q K;D
Y U Z D O B M F | F D B M U Y Z;O
G H W I T E V Y | I H G V Y W T;E
S A T K Q V U Z | K V U T A Z S;Q
F Z P Y T S M R | S P T Z M Y F;R
K B N D A I P Z | Z D I A K P N;B
F A R B U P E X | X P F A R U B;E
G X D N E P J Z | G Z J X E N D;P
K J W F C P N O | O F K C N P J;W
A S Y U W B O P | U B Y S P W A;O
P X Z D W Q T V | W Z V Q P X T;D
Z R D U L B V P | V R Z P U B D;L
G Y V F B A P Q | Y Q B A P G F;V
E V R S A P O F | O F A E S P V;R
E F S X T I H L | H F S X I E T;L
R X K B Z W J Y | B X R J K W Z;Y
H B K G N F T E | B E F H K T G;N
R C B D F L H X | L C D R B X F;H
Z V N T Y U S R | N Z Y R U T V;S
Z N P E Q R J X | P J Q Z E R X;N
Y C Z U A X V G | A Y Z U X G V;C
Q P U E C Y J G | P C U E Y J Q;G
S C X P U Y N F | S Y U P N C X;F
L I A M C D E O | O I M D C A E;L
W Q H A C K E S | Q E S K W H C;A
Z D V W I Q K M | M V Z W Q K D;I
Q Z L N U E Y V | Q Z V N Y E U;L
F E A R O Q M Y | M F A Y R O E;Q
E N G V F J O L | G N F J O E L;V
I E O V L W H J | E L V O H I J;W
X E Y Z V C R H | Y C V R X H E;Z
X Z G M N O K A | A O N G K Z M;X
K N W X V L B U | W B L U V X K;N
P W M G C L N J | W J L N C P M;G
Y H R T C E Q M | T M Y E R C Q;H
G Y N R E D Z F | Y R E Z D G F;N
E W P R G D S M | M P D W G E S;R
K N C Y T D E G | N G T C D E Y;K
A E K F X D Y I | A D K Y F I X;E
E B H Q M V J S | B V H J E S M;Q
R B I H O C V W | O I C R W V B;H
K C U Q A X S Y | S Y K Q C A X;U
K H Z T B U E O | E T B O H Z K;U
P U I X W V Z L | I X L V U Z P;W
I M S Q X T N W | Q T I W N S M;X
Q V J W X A Y M | Y W J X V Q A;M
Y A D F X M T P | F X T Y M A D;P
K B A Z U P I J | U A B Z K J I;P
C Z D N X V O K | O C V X Z K N;D
H N E G K V U O | E H G O V K N;U
N M R P T Y G I | N P M R T Y G;I
N L H Z Y P K D | Y H K L Z D P;N
N E C Y B J M G | B C J G N E Y;M
N J I O C B U X | I X J B C O N;U
Z H V A M E S J | H Z S A J E M;V
M D J W O S L I | W I J S M D O;L
V U F C D G Y H | C G D H U V F;Y
K O D N F U I W | I N D F K O U;W
V X R S G H F W | G X V W R S F;H
B R U K J C M I | M C R J K B U;I
V E X N Q U Z B | N Q B E U Z V;X
A J E M N W L D | A W L M D N E;J
V D F E I T O R | E R I O V T D;F
D M Z C T L E Q | M Z D E L C Q;T
P O K F U S V Q | F V Q P S U O;K
M P H J Q G W N | N M Q P J G W;H
Y L S T R O M G | S Y G O R M L;T
G I K V Z A X S | G S X V Z A K;I
S W E Y A R J O | S O A W J E R;Y
M K H V B W T Y | V M H T B Y K;W
G B F C X Q N Z | C Q Z F X N G;B
J T C K M X E P | K T J X P E C;M
X K B E Y H U W | B Y H U E W K;X
G W H Z D I J Q | Z G Q I J W D;H
J A N C L D R T | C A L R J N D;T
B X Y O T I N Q | Q X I Y B T N;O
A I G E J D P L | D L G A E P J;I
A I T W K Q M Z | I M A T Z W Q;K
B S U K N A M E | B S M A E N K;U
U K R O T W M L | T U W L O K M;R
E U J P A Q Y S | Y P A Q S E J;U
H B E K Y Q X A | K B H Y E Q X;A
O E D S P M W X | X S M P E W O;D
N F D C R O L P | N F L P C R D;O
D X P F W R K A | X W K F A P R;D
Z E M F G R D T | D E F Z M R G;T
I T E U L A C Y | L Y T I E C A;U
Y P J C O N L A | A Y J P O N C;L
J W G I A U T E | T J W U G A I;E
M T Y K B J D E | E K D Y B T M;J
D R Q B K J F E | D R B E K F Q;J
S Q F Z N G O E | Q G F E O S N;Z
H E S W P T G Y | W Y S P E H T;G
B U E A J Y O D | Y J A B U D O;E
T V U H Y J R E | Y H J R V E U;T
G M T B S H F V | M V T F S G B;H
F Q J A N V O W | J O F Q V W A;N
M W J O Q R A G | Q G M A J R W;O
F N R P Z S E D | D E R N F S Z;P
N T W A L E K G | N G A W T E K;L
D H L E K U J O | J U L D O K H;E
Z D R W H A K C | R A Z C H D W;K
C Y S L G X E V | X V S G Y E L;C
J F D P N G E C | D G J N P E F;C
X N S Z Y M F H | H N X S Y Z F;M
M J R X F A E G | G X M A J E F;R
U X B T A K J G | J A B X K T U;G
H E R B Z V N S | V N S E H R Z;B
K E O P A S V Z | V Z K E S A O;P
G K V P X L F D | F V X P D G L;K
V I J Y C K E B | K V J C I B Y;E
M Q Z Y K D B E | Q M D Z K Y E;B
L I B S V N X Q | S N X B L V Q;I
N R U B W X O Z | N W O U R X Z;B
L K P A Z E B U | B E L U K P A;Z
P T R B W V X L | L R V W B X P;T
M K Z O D Y T L | L Y M T D O Z;K
N J O B T S V D | J T S N B D O;V
Z O R V P Y I S | Y S Z O R V I;P
S D Q L T M A J | Q D M S J T L;A
K J U D I Y R T | R K U J Y I D;T
Q X R B E J L P | X B R E Q J P;L
U W M I G O L R | W G L U O R M;I
U M F J B L Z G | Z J M B U L G;F
O S Z A K M W Q | Z K M W O S A;Q
F Q J O X P W R | F W O R X P J;Q
G V T P I W Q H | P G Q T V W I;H
Z P L H E F I Y | Y E H L I Z F;P
G R X B M N W L | L M W G B X N;R
S G D R X T Q O | S D R Q O T X;G
Y N L O V K T U | U N Y L T K O;V
J Z T U R F M O | J T U Z O M R;F
I T A Q B J K L | L K T I J Q A;B
P L X Z O U E W | U L P O X Z W;E
P S Y Q K U X Z | U Q Z P X K S;Y
X J C V M Q F N | F Q N M V J X;C
V J D H Y Q M L | L D V Q J Y H;M
E D C B R L G H | B L H G R D E;C
U E R J S T B I | U S B R T I J;E
C S U R O J E N | N E S U R O C;J
L J F U Z M W H | H J F Z W U L;M
T L K Q X M V E | T M Q L K X V;E
U E J A K F O N | E A N U F J O;K
R Q J O A W N B | W J O A N R B;Q
X C M H A V N P | V M P A X N C;H
C B K G N L S Z | Z C G K B N L;S
Q G I N T S Y K | S K Y I G N T;Q
J C T D S W X L | D J X T W C L;S
W C I K D Z S B | C K Z B I W D;S
O J K M N S Y L | L K S J M Y O;N
E D C F V T H M | F D M T E H C;V
Z J W F A N B K | F A W J Z K B;N
H R B N I S U A | S B U A R H N;I
Z E J Y A L V T | Z A T L V J E;Y
F Z D Y S K A N | S A Z N F Y K;D
T F Q G W S H U | S Q H F G U T;W
Q C Y B Z U V M | Y M V U Q B Z;C
Y R I M F V O P | R P I Y O V F;M
X C Z O N K H J | Z C K J O N X;H
L F M O X Y P B | P O M X Y F B;L
S L E V O D Q M | L M Q D S E V;O
N J U Z O L H D | N U D Z H J O;L
B P R U J K G A | R J G U P K A;B
Y N D K W F L C | Y C D W L K N;F
R D F W V C O H | R W C H O F D;V
U G C F T V W K | U T F V K G W;C
B X E P F U L C | C P L U F B X;E
W U F Y J O M V | U W F M O V Y;J
L O H W U P Y R | H L Y U W O R;P
F D L M S X Q K | M Q K S L X D;F
V A W U R X Z F | F V R X U Z A;W
T E D B U N V M | D B U T E M N;V
P I H K B G U J | U J K G H B P;I
I R D J N O F T | T O N J I D R;F
Q G H I E T U A | U A T H G Q E;I
B A U K E G C I | B E U A G K C;I
W R B K P X E Q | R P X W E Q K;B
H Z A T S R C Q | T R A H C Q Z;S
S Z Q B K T J X | B X T J Z Q K;S
S Y Z W D V Q M | Y W S M D Q Z;V
I H L G D E V T | I T G H V E D;L
Y Z S M T L B J | M J Y S T L B;Z
P R Z Y U D Q W | U Q Z D Y W P;R
P L F C R K A X | P X F L K R C;A
P W R G C U H B | B R C P U G H;W
I V W D O Y M P | P V I M W O Y;D
B H L X F Y Q O | O L H B F Q Y;X
M R O F L C B Q | B M C O L Q F;R
S R T D V N J I | J N I S D V T;R
Y L B C I E Q Z | E Z Q L B Y I;C
V H M I G X A P | A P X I G M V;H
N U A O Z V I L | L V I Z U A O;N
K D E P A N O S | P E O D N A K;S
T Z H Q B C S D | T Z D S B Q C;H
T C F Q H D N O | Q T F N H C D;O
F M Q N G Y T O | T Y Q G N M F;O
X Y F K O S G D | O X F K D S G;Y
P W V Z F O Q E | O Z F P W V E;Q
W F Z C R S H L | Z F S H L W C;R
P M B H Y V J G | P H M J G V B;Y
P K E Q V Y J L | Y J E Q K V L;P
X S L Q B O V E | O V Q X B S L;E
V D S K O H X L | D S K L O V H;X
B J D T F V H L | V F L D J T H;B
M Z U J E T N D | M J E Z U D T;N
Z W C Q N B T R | Z T N B W Q R;C
Y A U Z L M C N | C Y N U M Z A;L
D E F R I M X Z | R E X I Z M D;F
V B C S Q J Z A | Q V S J A C B;Z
V K W S T E X F | F T V E X S W;K
G A Q L P W U Y | Y W P G Q U A;L
C J X K S N U M | J M N X K U C;S
V K H R L X F B | K V R X L B F;H
G Q Y V C H S R | G C V S Q H Y;R
D A F N L K H W | K N W H A D F;L
A O F D R S B W | F A W O D S B;R
V C T U W H Z K | H V T W U C K;Z
E U A L G P O Z | A E G P L U O;Z
S J T N H G V Z | S Z H G V J N;T
J Z P Y I U S W | S Y J W P Z U;I
G R W Z J T H X | H X J W T G Z;R
E C G X N Y U P | G Y N E P C X;U
X L P G J N O W | G N X J L O W;P
A S O H W N Q L | L A H N W S O;Q
A E L R C N V H | A C R H N L E;V
L A K U R S T F | U S L K F R A;T
V C K P D G U R | P C V G U K R;D
Q I H B S R M V | V B S H R M I;Q
T A D W Y Q O E | W O D T Q E Y;A
T K N J W I E M | I E W J N K T;M
J X Z K W H S C | H Z J X K S C;W
S O I U D K Y X | O S K U X D I;Y
S V P Z N G Q R | S R Z G V N P;Q
H E Z K L T P S | H L E S P Z K;T
O S M F P G T I | F S G P I T O;M
T O F U L J N I | J O L U T I N;F
V S R P N H I G | N G P S R I H;V
S X I B Z P Q Y | S Y I P X B Q;Z
I E D K W O H V | O V E H D K I;W
K C X G T P A V | X A T V P C G;K
Y X O A F B S N | F B N A O S X;Y
C V A J E I N T | T C A J I E N;V
M P Y N O K R L | K P M N O Y L;R
T P O Q E M K X | K O Q P T E X;M
K X Y D Z C Q N | N K Z X C Y D;Q
R Y K N M D O C | N C K M Y O R;D
L Z N E H J D O | E H Z O D L N;J
L E U J O G B Z | J U E L B Z G;O
B N I L F S E M | I M L F E N S;B
K W U Q L T V I | L Q V K T W I;U
M J B Z A Q H O | Q A O B H M J;Z
O I V G U H E C | H G O I E U C;V
X B C H N M Q G | H C N X G M Q;B
B Z L G N P E U | B E G P L N U;Z
O Y K I N G Z C | I N G Z C Y K;O
W N E C M B J R | N M R W C B J;E
O S B R X H P L | O L H B S R P;X
P Z E Q M R J Y | P Z R E Y J M;Q
Q Z E U Y V O C | Z Y C V U E Q;O
E R Y P J Z M O | R M O E P Z Y;J
V H Q Z F U R K | Z K R V F Q U;H
P V X D M T H R | T D H P R V X;M
C R T N L S G U | T L C N R G S;U
S H Y P Q D R Z | H S Z R D P Y;Q
B O E A S Q N W | Q A W B N O S;E
Y T K C O F Z W | C Y T F W O Z;K
O M Z X G D B S | X S O B D G M;Z
G W J H I U C V | C I J H V G U;W
B M U I E R W P | R I U W B E M;P
Q G S R J M K Y | R G K J Q Y M;S
K C E Q A R M B | B C R M E Q K;A
K Z X N L R F A | L F N X A K R;Z
Q N A F B J P S | P J S A B Q N;F
U V H S G J P Z | P Z J U S V H;G
J R X N E U V O | E U J X V R N;O
X K N C F P T D | X K C D T F N;P
H P S R A I V J | V P A J I R S;H
I S T D Y F W G | D F Y S T W G;I
O R W K X C P J | X O R K P C J;W
U G Z L T X E W | X T W E G L Z;U
B W L M S P A Y | W L Y B A M P;S
I R K T G V H S | K V R I S G T;H
R Z J I L V S T | V I Z J T S L;R
X B N O K I V W | V W O K I B N;X
Y J C D N X H F | X J Y C D H N;F
N S V Q D H R B | R S N B V H D;Q
O V M H K T Z N | K N Z V O M H;T
U X N G R S K L | K S L R U N X;G
O E N X D Z J T | N O D Z J X T;E
J W C F E U K R | F W E U J K C;R
K J S W X G P R | J X P K W R G;S
Z D G X M R Y A | M A X R Z G Y;D
F I T V B Z K R | V F I T Z R B;K
B E X J I Z Y K | K J X B E I Y;Z
U C S E A Y J I | I J A U S E Y;C
V A X F I W G R | I A R X G W F;V
E I X H K A G M | M G H A K I X;E
Q M G H T S X I | H T M G Q X I;S
Y I M K J C F S | C F I S M K J;Y
A D F E B K Q Y | E F Y K Q D B;A
C U H A P I N V | C N V H A U I;P
K E L R P U I O | E O P I L R U;K
T B N U Y F S R | B Y U T R S N;F
Y W B H D E M U | E W B H M Y D;U
A K C V G D U N | G D U V C A N;K
M A R S Q Z N K | Q M R Z N A S;K
B Y D H J O W N | J W Y D O N B;H
E R V P Q O U L | O U L V E R P;Q
D R W X M S E C | X S R D E M C;W
O G P Y N B A R | Y R A B N G O;P
H F U P B G N Y | F Y H B U G N;P
G C D F T S I P | I D F G S C P;T
I W Q V D O X S | X S O Q V W I;D
Z X O F S A E Q | E Z O X F S A;Q
H M X G D O E V | E G V H M O X;D
H T J Y E V P N | N P T E H V J;Y
S Y C N J O E V | J V E S C O Y;N
S Y L I X K D N | I N S K D X Y;L
E C A T F S R J | R E T A C S F;J
B Z O I C X L G | X B L Z C I G;O
L Z V F C Q G J | G L J Q F Z C;V
T O H J X Y W A | O T Y X W H A;J
U H Z B A Y Q V | A H Q U Y V B;Z
M S J C V F A G | F V M J C S A;G
J P Z S I X E K | P Z E X S J K;I
C X R T P V F D | D X F T C P R;V
Z N S D I Q X E | D I E X S Z Q;N
W P R Z I H V Y | I W Z Y R P H;V
P S G M R O N F | O F G N S M R;P
T B C U N S D L | L U C B T D N;S
C D I Y A X P Z | A X I D Y P Z;C
B H D G W S M J | G W S D B M H;J
N P C J E M O X | N E J O M P C;X
Y R X L M G P F | R X P M F G L;Y
C W R B Q T L P | L B T W R C P;Q
B L C Y E N V M | C V Y B L N M;E
J Y O R Z G A E | A J G E Y O R;Z
J Q H V G F U M | G J Q V F U M;H
X N O W S Y D C | C S X D N O Y;W
T X K W U S N E | E X S K T W N;U
P N I M H Z X E | Z P I M X H N;E
V T L X F H W U | W L H X F V U;T
U G X N R T W A | R T A U W N G;X
O Z P J B S X U | P O X J S U Z;B
M V T A S W N L | W N L S A T V;M
J C V L Z D Y W | C W J D V L Y;Z
C B O S Z X L Y | X O B Z C Y L;S
H W O F T Q G S | S Q W F T H O;G
A Y S B K R I G | A K R I B Y G;S
Q O I J T E R F | I O Q R J F E;T
O T C A I R F J | C I F J O R T;A
M J T A X Q G L | T A Q L M J G;X
L Z V M K R G H | Z L M G K H V;R
N K Q A Y I U X | K A I N U Y X;Q
E P A S Z R Y J | E S R Y P J Z;A
R Z W T E M G J | Z R E G M W J;T
S C L O Y X J M | C M L O J S X;Y
D B C T P S I H | I C D H B S P;T
S D T I H C A Z | T D I H A C S;Z
U X P Y Q G B J | X J G Y Q P B;U
J W V K P F I Q | Q W P K J F I;V
Y F G V R O X W | V G O W Y F R;X
I F N V K G W O | I V W F G K O;N
H N L A P G R X | X H A R G P N;L
W P K D G B Z T | G B T W Z P D;K
P M V O S D G B | M B P G S O D;V
E G W C D O V U | E U W G C D V;O
H S V M C G F N | G V C F H S M;N
S B P O H R Z F | B S Z H P O R;F
J U D G X S R E | U G X S E R J;D
R Y J K E G U C | Y C J R E G U;K
K N E X V B I M | I E B V N M K;X
R C V T K W U N | N R V K C W U;T
G U F A Q M Y H | A G F Y H M U;Q
I Z Q J G S Y U | Q Z Y I S J U;G
G N A S M T U P | P M A S G N T;U
Z I D V F U T N | Z V T U D F I;N
G V I J N K W B | B J K V W G N;I
M G L H J F A C | M G J C L F A;H
L C S V B K H D | H S C L V D K;B
R J F G Y A X B | F G R X Y B J;A
I X V L O Y C R | R L C O V I Y;X
N R C M X Z F D | C X Z M F R D;N
I M S E Z D T K | S K T E M Z I;D
P I Q S Z H N E | N I S Q Z E P;H
E W O V A Q C X | Q E V W C O A;X
L Y O W S N H B | Y L N B S H W;O
G Y A Z D S F P | Y A G Z F D S;P
H E K Y R T P J | K T P R E H J;Y
A F L R Y Q O Z | Y L F Z R Q A;O
A B G U H N X O | B O N A U G H;X
D B A O L U N R | O U N B D L R;A
L G H N X M O Z | Z M L G N O H;X
B X T J O A L Y | T B L Y J A X;O
X R S L E Q N A | S X E N Q L A;R
E L U C B Z Q I | B E U Q Z C I;L
X A I B L D K U | A X K L I D U;B
D P N V F W M T | T F P V N M D;W
N D C J M U Y O | U N J Y C M O;D
J Y L V K R T Z | J V K L Y R Z;T
I W B V F L A S | W I A V F S L;B
J A I B R D C N | B N R A C D I;J
E R T U G V Z J | U T J Z V G E;R
Y E T C D A Q B | T E C Q D Y A;B
U R Q Y I M N F | Y Q M I N R F;U
J O H W E U M X | H X J W E U O;M
K I A Z C B X P | C Z P B X I K;A
U W B J X N V C | U V C W N B X;J
K L H Y V S G F | Y F L H V K G;S
P O N H Q I S D | D P N Q H I O;S
A F I R T X V P | T F R I V A X;P
P M K X S A Q J | X J M K Q S A;P
F M I O B W V H | I O F W M B H;V
N Q T B F L O X | B N O X L F T;Q
B F A M I O S G | A G O F M S B;I
Z H M Y J L A K | J Z L M K H Y;A
N L D B I S A Q | A I S B N Q L;D
T N I R A F C K | A I K C N R T;F
Q B I L F O T W | Q F I O L W B;T
B S G H I Q C A | S C A I H B Q;G
F H Q M U K E L | M K L U E H Q;F
X T H E U M C R | T E C X H M R;U
R V N U D G K W | W U D G R N K;V
R I N Y Q H A U | U N Q R H A Y;I
H S O R U B M K | R H B O U M K;S
X Z V B S W I D | D B I W Z S V;X
C Z Q A B L S Y | Q B L A S Z Y;C
K J H F Y B C V | B H F Y V K J;C
S L F C Q E V T | C Q V S T E F;L
I Z O K D Q E Y | Q I E D Z O Y;K
B H A R Y M D U | A B H Y M U D;R
X B E F M U R P | E B F X P R U;M
K V Q N J Z M B | V K N M Z J Q;B
Z H J B O W F C | J Z F C O W H;B
X G C W Y F V D | G F C D V X W;Y
Q Z B F I R E D | F E Z D Q R I;B
V P L C Q S G J | V P S C J Q G;L
C W U V I J F K | U C V F K J W;I
P A E S H W Y U | W Y U H P S E;A
V P C O G X H Q | C H O P G X V;Q
L P K M Z Y F V | K F L M P Z Y;V
K M P O G Y U Q | Q U P G O M Y;K
Y D Q B W H L R | Y Q B R H D W;L
A J W R L Y Z P | R W Y P L J A;Z
R J G K V I N E | K J G V N I R;E
D Y V S X F H E | D F H Y X S V;E
B Y W O N C J H | H N B O C W J;Y
W V G I J R P L | L J I P V G W;R
Y S Q W N P C K | K P C Q W S Y;N
P A N V D H C Y | C H A P N Y V;D
Y Z N T C H P K | K P C Z T Y N;H
T H V Z G J Q X | Q V J T H Z X;G
F C E T Q K W M | M Q K C T F W;E
W A X B J D S P | A J S W D X P;B
W M Z K S G H O | K O S M H Z G;W
T S J O X G E D | O E D G T S X;J
A O D C V G W U | V G D W O U C;A
K A V M X J F G | X M K G J A V;F
N J P Q G A Y O | N Q Y O P J A;G
Q X P Y M N Z I | Q M X Z P I N;Y
M X L R O J U D | D M X L O R U;J
U H L A V J B F | L B F H V U A;J
H J S C A F W M | F M C S H J W;A
O J V N M W Z F | M F V J O W Z;N
W L N K E F Z X | L K F E X N Z;W
V T O A G F X U | O A X U F G V;T
K B J I L D A T | T K J I B A D;L
M N T P R O Q K | R M N T O P K;Q
E W S Y R N L P | N R L W S P E;Y
S Q H K N M C V | C S H K V N Q;M
Q H W X T J G U | G J U W X T Q;H
C I Q L G K H N | I Q G K N C L;H
I E D R P X J C | P C D X I R E;J
D O M V E C U L | O C M V D U L;E
F R H T Y N S K | F Y R H K S N;T
O X E L Z P F D | O X E D P Z L;F
D X Y N M J U P | Y D M X P J U;N
Y S J X H R D V | V J Y H R S X;D
X D P Y C J R M | C M Y P D J X;R
U R G V S X W Y | X W S V R U Y;G
S W A R H I J F | J R W S H F I;A
D W T A L S X Y | T A W L S Y X;D
Q K M P A J Y H | Q Y H J A P K;M
F A J I M W S H | I F A J H M W;S
H A U Y J G Z S | H G J Y S A Z;U
N Z P X O U M I | X I Z M O U N;P
B Y O H A P S R | O A S P H Y R;B
X E B U D G W S | S E G U X W D;B
R S B U Q L W H | L W U B S H Q;R
M E Y L V I X J | X M J I L Y V;E
G Q A T P C B E | Q B G P A C E;T
K Q Y A E C B F | Q A Y E K F B;C
Y U F P Q M C R | Q C Y R M U P;F
A H F V N B Z P | H V P F B Z N;A
C I G T M O F E | I E T O F C G;M
C R D I L Y Q E | D E I Q L R Y;C
P Y X I K S T Z | P Y T S K Z I;X
H P I U J T F Q | T J I Q U H P;F
U C N G F D A L | U C G D N L F;A
Q B I Y L J U A | Q J Y B L U A;I
O J Z H T W Q R | Q H Z J W O R;T
S D A W X Y O R | S W R A O D Y;X
R S G J L Q F P | G Q R P L S F;J
R D E Q Z B H K | R K Z D H E Q;B
Y D J A G U P B | A Y D G P B J;U
E X M J Z A V S | A M S J Z E V;X
S J A W O L D R | L J D R O S A;W
A T X O J P L I | O A X L P I T;J
O A M K S F N J | O S J K F N M;A
Q B F M O P T X | O P Q F B X M;T
K J C A U S V W | V A U W C K J;S
T L K M R F G J | F J T R K M L;G
U W V F Q G R O | W G Q R F O U;V
L Y A D O X F I | F D X O L I A;Y
K P Q A O N U T | T O K A Q N P;U
V W Z M S F G D | W F Z G V S D;M
N V O W L K Y F | F Y W N V K O;L
F S U D B Q X K | X D F S B U K;Q
U Z L G D X H S | L S U X G Z D;H
F Z C I H V Y L | V F L Z Y H I;C
R Z Y W V N M F | V Z Y W R M N;F
X N D G I O A L | O L I D G N A;X
R N W S K Z D V | W R V K N Z S;D
G I V Z Q H K T | V G Z Q T I K;H
R S O X Y K F D | D Y X F R S K;O
P S M Y T J F B | F B M P S J Y;T
M C K U L H O E | E O L M H U K;C
E V O Z Q R P C | E Q Z P R O C;V
C T O M L P F W | F M O L P T C;W
H I S D C T W J | J H T S C I D;W
D T L Y X W B N | B T N X D L Y;W
T J L A K P Y W | L Y T J P W A;K
Q W P C I M R G | C R M I P W Q;G
I H A S U P E Y | H I E A P S U;Y
D B I E R Z O G | O G R D I Z B;E
D N U O A W C G | W C D U A O G;N
D F N W Z R O L | L W N Z O R D;F
W G K D N M T J | M N D W T G K;J
L G N J Y M T I | L N T I G Y M;J
A P D B T H J L | D B A T P J H;L
K B N V J E S A | A S B K E N V;J
X P R G V C W A | A W P V C G R;X
R C I T D P F U | F P I T R U D;C
X I V R U N D G | N I V X G D U;R
D F N M C E R I | M C F N R I E;D
J A T I O U S V | V A I J O T U;S
T M R I D P A L | T D A I L P M;R
E Y K O U B L J | L B E U Y J K;O
M D W A T J Z K | M W Z A J T D;K
Y C S V F E Z J | J E F Z Y V C;S
P W J Z A L I M | L M W P Z J I;A
C B H E F Q P V | E F B Q C V P;H
Q P Z D Y M V L | V Q M L D Z P;Y
I W H J Y P U K | P J K Y U I W;H
X B K U L R O H | U K H X B R O;L
J P V Z F G A D | P J A Z F G V;D
D H E T Z Q V M | M D Q T Z V H;E
R D E U M X H K | K M D R X E H;U
W H S N F V T C | H S N V W T C;F
L X Y M Q H W V | X H V L Q W Y;M
E N U Z C G I M | M G E I U N C;Z
O Y U T M Z I R | O U M Y Z I R;T
K W C I S N P M | M W S K N C P;I
A C Z I L Y H K | L I K Y H Z C;A
B C S R Y O J P | Y B O P R C J;S
X V Q A Y U G N | G U Q V X N A;Y
T W J P K O R H | O T W H K J P;R
F H N C G I Y D | F C I D N G Y;H
A R G W I Y S T | T I G Y R S A;W
S X G F V A U P | P S G X A V F;U
G R Q H D V J T | D J Q V G T H;R
Z Q T I W D N U | I U D Q W Z N;T
J O F B V G N A | N B O G V F J;A
P X F J H W C Z | P C F Z X J W;H
L B I X O Q T H | X B L Q T I H;O
V R A Q B H L I | H L Q A B V R;I
Y T S V I B R F | I Y S B R T F;V
W H I G N C D K | N C W K D I G;H
D L E G X I F R | I D L E F G R;X
L T U Y X D F Z | F X Z U Y T D;L
C A G V F X L U | C A F G X V U;L
B Z I H X R E W | B Z X R E W H;I
J Y P V A B H F | J P B H Y A F;V
L V H U R Q I J | Q L V U R H I;J
G N K W P Z L U | Z P N U L G W;K
U V I P C R S O | C R O V I U S;P
G E Y V J T A P | P G T Y E J A;V
J T W O B Q D S | J T W B D S O;Q
U P J B L F T H | P T H U J F L;B
K T O M E J P W | T J P W M K O;E
J C S G L U W T | C U J G T S L;W
Y E B Z C L R W | L Z W C R Y B;E
M Q B H G K X C | Q C M B K H X;G
A B L O Y H T Q | H A T Q L Y B;O
Y E W C Q A N R | Y C N Q A W R;E
U H M J Y K G I | K H G Y U J M;I
L C Z E V T P S | L V C S Z E P;T
V J G O Q E M D | Q D G E V M O;J
J P Z I L W T K | K J L W Z I P;T
E X K L V T P J | J X E P T V K;L
R G K V H P B D | H B R K D V P;G
W Z N E T M O K | E K M N W T Z;O
T A L E O M K Y | M E Y A K T O;L
A H O Q P Z K B | O H P Q B Z K;A
X S T R U O L H | T U X H L O S;R
P B F T G J W I | I W G F B J T;P
R M D J Z L A N | N J D Z A L R;M
K H P D G I O Z | H I G D K O P;Z
E O U D G I T V | O E D U V T I;G
T H I O N L Y V | V O I L N T Y;H
B U Y R J C D V | V D R Y C U B;J
O M T K V D I X | K I M V T O D;X
X T Q P H U O C | C P H X U T O;Q
M H R O G Y D C | C G R M H D O;Y
U T Q B S N J Y | U T Y N Q B J;S
N U Y P A Q D X | A Y N Q P U X;D
V N Z Y S E P A | Y S A E N Z P;V
Y X M G B O V Z | Y X V B G M Z;O
O S K Y C M J I | I K Y C O M S;J
P A L G H T Q Y | G H P Y T L Q;A
O J B V H L D Y | D L H Y B O V;J
Z T E Q J L V I | I T Q Z J L V;E
N K U G J S P D | N S J U G P D;K
H U T A F J E Z | J Z A T E U F;H
L N E T M U V B | N T V L M U B;E
W X Z C Y G P A | P Z X G Y W A;C
X D G A K W T Q | K T A G Q W D;X
G M S J K Z O T | Z M O T G S J;K
R Z P B C I U T | I U C T R P Z;B
R C N P J U M I | C J I U M P N;R
I T W F H U P V | H F U P I T W;V
T U J M E Q Z S | Q U Z E M J S;T
N W Y A X O R U | Y X O N A U W;R
K Y Q R O N L V | L V R K N Q O;Y
E V U H Q P M Y | U H E Y Q P V;M
X C P S U L R A | L R U C S X P;A
I L R O D A Y S | O S L I D Y A;R
H X D V L G P I | V I G D H P L;X
R P S T J C A D | J P A R T D C;S
J G B F E P T Q | G B E J F T Q;P
E K L H G S J M | E K M S L G J;H
W S E B P A Z F | W P F A S E B;Z
G H J T R M V D | M V G D R J T;H
U S R B Z M A G | U M Z B S R G;A
U K H T V E A D | A U K D T E H;V
W C J P Z Q K N | J W C Q K N P;Z
H V F Y B E D A | E F B Y A D H;V
P N Y F W R A S | Y A N R W F S;P
Q T Z U D R M P | D Q T Z M R P;U
M D E N R I G X | X G N E I M R;D
N E P U V F S D | E U F D N P V;S
D O F Z K T P U | T F Z P K D U;O
O X U J C Y Q E | U O C E Y J X;Q
M S V Z T A X W | T W A V Z S M;X
I D H R U Q E K | U I E D K H R;Q
D F O P B C S G | D P B F S O C;G
G J E H R D M A | M E G J A H R;D
Q V P W K T N R | T W Q P V N K;R
B P U D K C S Q | U C S B K Q P;D
L Z K H R I C T | I R C Z L H T;K
K F U S G H I D | U G S H D F K;I
S L R W F X E T | S W F T R E L;X
P X Z K E I D Q | P Q E K D I Z;X
D M O V Y J L A | O M Y J L A V;D
I W X Q T S D O | X I D S Q W T;O
B U A D Y C T J | J T A U Y B C;D
Q C A S D P J U | A Q S J C D P;U
O I K V A R P U | I V O A K R P;U
F Q G Z L S R I | Z Q G R L F S;I
F H S I V C A K | F A S K I H C;V
J A I O H U D Q | U H O A I J Q;D
W O Q P D X E M | W X E M O D Q;P
O E C F Q K B R | B O C Q F R E;K
B R F S J P H Z | J H F P B R S;Z
N M H Z U K G W | U M G Z K W N;H
H O U G C I B P | H B I P C U G;O
S X E K C L R F | R L E K F X S;C
D M O K Y T R J | Y T J R O K D;M
T U Q E X I Y O | O T X Y U I Q;E
T P Q X L J O Z | Q Z J P T O L;X
E Q L C B I W M | Q E L B M I W;C
Q V C D N U L M | V C N D M U Q;L
T V A O I B K U | A B U K V T O;I
J S L G C U Z K | L G U S Z J C;K
C I V G B U T K | K T V C G B I;U
V S N Z U G C D | C S G V N D U;Z
K Z P B D Q Y L | D L K P Q Z B;Y
X I S D F J Q K | D X I F K S Q;J
K S D X Z U L G | G S Z X D K U;L
E M L D Q V F A | V Q F D L M E;A
S T H Y O F A G | A O Y F G S H;T
Y V L W N C H E | V E W H L N Y;C
W X V A L D P G | D X W A P G L;V
W H Z T K S O Q | Z T W O H S K;Q
T J E G R O V A | A V R G E O J;T
R M V P J Y D A | P A Y D J M R;V
V G O Q H S P C | V P S Q H O G;C
X U T N W F L S | F T S U X W N;L
C S A M J T O D | A M J S O T D;C
Y M G Q L T X P | T G M X P Y L;Q
S R K M J W E Y | K M S E R W Y;J
J Q U C S Z F W | Z F C S W J U;Q
S F V M J L Q I | L I S V M F Q;J
J Q M Z P C V W | V P Z J W M Q;C
I W A Y E L V P | A V L I W E Y;P
F O K S T H J E | F K J T O S H;E
I S N H B R V A | I N H V R B S;A
V G B F D Z C U | C V G Z F B D;U
B S G I H T R X | I X G T S B H;R
H Z L A P J G O | A H L G J P Z;O
J M T Y P G Q E | J Y P M E Q G;T
U K B Q X Z E I | Z K E B Q I U;X
D K A B J G Q C | G D Q J K B A;C
J I D Y C Q N A | Y N D J C I A;Q
Q R S X T A L W | S R L X T A Q;W
C P K O S X B E | C B S X P O E;K
N J K L R F M B | F N J M B R K;L
Z F I G P X Y L | G F L P Z Y X;I
I U C D T K W Y | W K T I Y U D;C
C G P X L K S J | K L X G C S J;P
T I N A J C Z Q | A T I J Z Q C;N
U F J A M P K R | U A P K F M J;R
H X K R V F J L | F X H J R V K;L
W F S B T U V H | V B W H F U S;T
F S W E V X J G | W F G E V S J;X
Y T B J E G Z Q | B Q Z Y T J E;G
H D B Z P F R M | F M P H D B Z;R
E G K Q S M I H | H I K G M E Q;S
I R S G C Q O D | Q D G I S R O;C
I D S W X K Y J | S K W X J Y D;I
J M R G A B F N | F B M G A J N;R
G L D O R C U Z | D O U L G C Z;R
N L O G W E B C | E O C L B G W;N
U F Q V O N H L | F O H N L U V;Q
N L S V G P J U | L V J P U S G;N
R O X W U S E I | E X R U O S W;I
O B W H Y G D F | H Y G B O D F;W
B A D O G Y P W | O G Y P W B D;A
J G L Q T I D H | I D T Q J G H;L
I J O R V P K G | J R V I O K G;P
V P W D I B Y S | W V S P I Y D;B
K P N L Q F H Z | P H Q K Z L F;N
V P M H R L C D | P C V H M R L;D
L S O K P Y D W | D Y S K P O L;W
T Z U W I O F A | A U W Z F I T;O
K E D L S R I Y | S L E R D Y K;I
K H B R V P O W | B R P W K O V;H
U V G J Z D I X | D J X G V U Z;I
L G Q N O B D R | N R B D G O Q;L
Z U K N T W P E | E K W Z N U P;T
Q T O J I C L R | R J L Q T C I;O
F L N M A V I Q | N L I F Q V A;M
C W F P G S D Z | D P G W Z F S;C
E M V Y S G N I | S N V M E I Y;G
Z W J U H V E G | Z G J U V H W;E
E P V O M J L A | J E L V M A O;P
Z O P L I N Q R | N O Z R P I L;Q
T C L W H F G X | T W C X L F H;G
U Q R X W G V J | X J U V R W Q;G
E Y T C F V Q M | M C E Y V Q F;T
W Y M L E S K A | K Y A S W L M;E
N E T O K U G M | T E K M O U N;G
J R P A V G I H | R J A P G V H;I
I P N V G S K Y | S I K P Y N V;G
G F U Z R K V O | F Z V G K U O;R
H Z C D G N E X | E Z G N D X H;C
P T M C I G V Q | C G Q P T V M;I
R F K C W X G P | W P C R X F G;K
Y B W Q K D O H | D K W H O B Q;Y
C T L B N D V Q | B V D L N T C;Q
C O T B H F Z G | G B F Z T H O;C
H K C B V D N P | H V N B D K P;C
U Q P K D V L F | Q P U K D F V;L
J G Y A W K C I | C G A J Y K W;I
U N I C X W K O | C O K U N I X;W
V U W I C Y K R | C R V I Y U W;K
X T Y G L D E V | Y L G T V E X;D
M S I F U V J D | J V U I F S M;D
Q G O T R W A F | Q F W G A R O;T
Y E O G A X Z C | O G C Z A X Y;E
T K P I L U J G | L K U I G T J;P
K W O C G F T H | K O C W H T F;G
R T V F E M A Z | Z F A R V E M;T
C W K I A T M P | K W I T C P M;A
B X U M L E I O | B L X I E M O;U
J E S L A U X W | A W E S X U L;J
Q X V F M B P Y | M Q F Y V P B;X
C M I H E V B L | I C M E V H B;L
Q M V E B C R G | C M Q E G B R;V
S F D P X L Z U | L X U P D S F;Z
Y E K B L J P W | W P K Y B J L;E
R N U D A J S F | S U D F J R A;N
Z U L F S M Q X | X M L U Z S F;Q
B F Q C W X I K | K B X W F C I;Q
U K Y Q Z R L N | L Q R K N Z Y;U
D S A T U P Z L | S A D P L U Z;T
K L Q I V A R B | V R A I K B L;Q
I A V K Q M D R | K R Q D M I A;V
K T X J S C A Q | Q A S X T C K;J
X L O R Z Y U A | A L Y Z U R X;O
N K R F L X E Z | N F R X K Z L;E
U M Z T H S Q N | S H N U Q T Z;M
T P E S J C H Z | T H C Z E P S;J
F P W T O I R M | T W M I R O P;F
B J D A Q V F U | V F Q U D A B;J
Z B O F N W M I | W I F O N B Z;M
E K V M P Z F G | Z P F K V M E;G
R D K P A X Q G | R A Q K P G X;D
B J L N H R A O | O N A L R B J;H
K M I F E L Y Z | L E Y F M Z I;K
T E J P N R Q D | P J E Q T D N;R
P G H U L N K R | N H U G R K L;P
C I E L P B O N | E O N P C L I;B
F N L B G Q X I | N X Q B G F L;I
H Q S W Z T K L | K T H Q L S W;Z
S X J F Y U W D | W F S D X J Y;U
V Z H F Y I T X | Y H I V Z T X;F
N O Q I Y G E H | I O Q G E N H;Y
U B G T X I A K | I X B A G K U;T
P X Z R L U M Y | P Y R X U M L;Z
L G T Z A R P J | G A R L J Z T;P
S W R L X A Z K | W Z S X R A K;L
H X W Q I U O S | X S Q W U H O;I
N L S E G R Q K | L K G S E Q R;N
G W N L H B J C | B W L N G H J;C
G O V M F C E P | C F M O P G V;E
E Y N A H I Q W | W Q I N H A Y;E
Y G U L W X P N | W X U Y G P N;L
D F S T H B M V | D H B V F T M;S
P W R C Z D O B | R C B Z W P O;D
E Z P L A B Q K | A E L Z P B K;Q
D W Q A V S K G | D A W K V Q S;G
C B T K R O X S | T K O X R B C;S
V P C T A W Q E | T Q V W C A E;P
D Q E H N G X O | H E D Q N O X;G
S W P R Q E T X | R E Q W T P X;S
T S L I R P D O | O D R L P I S;T
P O H S Z V Y N | Z S P O Y V N;H
T E X Q W C S I | Q E X I W C T;S
P H V W Z S J X | H W Z P V X J;S
P U V I Q A K Y | A V I Q U Y K;P
W F V X R Z H A | R W V H Z X A;F
S O Z V P H F A | V O F A Z S H;P
M S K C N L J Q | S C K N Q L M;J
V A U L T M Y R | L Y U M V A T;R
N H O K G Y M U | G O K Y U H N;M
O D M E S Z J K | K E J S O M Z;D
X Q H D C R P J | X J P Q C R D;H
Y W O J H A C P | C A J H P Y O;W
F X M C T D U B | F T X B D U C;M
V N Y C J O G L | J G N V Y O L;C
V J W Q C P E R | C V E R Q J W;P
M F G U H K R S | U G S M F K H;R
F K H D O X L U | H F O U D K X;L
A E T D S P X G | X D E P G S A;T
E U H O I Z W Y | I Z H W E Y U;O
Q S O B C H L I | H C B I O L S;Q
M L Q I H E W Z | Z Q L W M H I;E
T B H Y I N V A | V I T B H Y N;A
Y R O M N C D G | D Y G M C R O;N
Q M X H Y S I N | Y S M I N X Q;H
S Y E Q M Z O C | Y S O M C Z Q;E
X T A S H M B E | A T M X H B S;E
H X E D M R N O | O M R X E H N;D
T V I U Y O W J | O J U W Y T V;I
A E V B X L T K | E T V A B L X;K
W I Q N M H E G | Q E H G M I W;N
R F O P J C I K | K J C P I R O;F
O N U S W A G C | O S W A G N C;U
H Z G Q A T X L | Z H A Q X L G;T
P Q B F H U E S | H P U B Q E S;F
F T S A U W M K | T U W S A K M;F
K H A T D P N S | A H N T K S D;P
C Y M D Z S O H | O H C S M Y D;Z
Q K S B L U G C | K Q G B U C L;S
A D E H B Y C R | A R E H Y D B;C
M N W R A K E I | W R E N I K M;A
A M U B Q W L T | M W A B Q L U;T
W S K C B X Q H | Q S H B W X K;C
I T S Q Y E N D | D T I E N Q Y;S
S H E Z U P V L | S E P V H U Z;L
P S Q Z C V U H | V U S Q P H Z;C
A I S O K E T P | K S T O P E I;A
I B K M Y U F P | U Y M I F K B;P
V W L I E P A Q | Q E W P V L A;I
Z G B S D J P F | G B Z D J F P;S
Z O D R Q I B E | R E I Q Z B D;O
O F Z G R J V Q | J R F Q Z O G;V
A E Y B Q I U F | I F Y E U A B;Q
L A U V T H E N | U E H N L T V;A
X L P S N G J E | N X S P L J G;E
M N Y X B R Q P | M P N X Y Q R;B
L R X G F C P E | X G E P F L C;R
T Z B V P C L H | B Z V T L P H;C
I A H C E W X M | M E I W C X H;A
Y I E N X G Z M | N E X Y G M I;Z
M O X W K N I Q | I K X Q M W O;N
X P H U C Q K N | Q H C K X U P;N
K H T S I G B F | F I B H G S T;K
T G Y Z O C D J | C T J G Z O Y;D
W L E Y C P D T | E C T L D P Y;W
X L Q P F G Z B | P Z Q B F X L;G
Z P L M I E V J | J M E V I Z P;L
E Y J L C A D T | L Y J E A C D;T
S K H R A V T G | R K S H G V A;T
N M E Z O V F W | Z F N E O M W;V
X G M D R F H W | H W F R G X D;M
T W H C S F J X | J S T H C W X;F
W Z N H O M I U | Z I O U H M N;W
Q O P Y C I B H | P Y I H B Q C;O
O T M Q L W P G | Q O M T W G P;L
O D C M P N G W | D G W P C M O;N
P I Q T A F Z V | Q T A V I F P;Z
H C B O I P E T | C E B O H I P;T
B C Y S W H X M | H M X B W Y S;C
Z T A X G U S F | T S A G Z U F;X
V D T E U W X L | T L D W E U X;V
I H G E P Z Q C | E Z C H P Q G;I
P X W F Z M D J | P D Z J X M F;W
M V S P E I O A | V S M O A I P;E
W S V Z M B R E | V W B Z M S E;R
L V B M S N J F | N J B S V M F;L
S V L P O N D T | P S T D O L N;V
T W F O R N V A | W A F N O V T;R
K M F Q Z N D C | D K M N Z F C;Q
W M C R I Y U X | M X Y I W U R;C
A K F C S W B Z | Z S A B F C K;W
H C Z V B U N X | N C V B X U Z;H
D J P X Q S U F | X U Q J S F P;D
H W F P Q Y X V | V H F Q X Y P;W
Y F Q N K J M S | J S K F N Q Y;M
Q M Z I A D U K | D U I M Q K Z;A
X R P F W L U D | X L W D R P F;U
T I E U Q N L H | L I N Q H T U;E
M S Y U C P X W | W X C S M P Y;U
E W Z A C R V U | E C Z V R W U;A
V P R Q Z O N A | O R Q Z V N P;A
O R P M A V L K | P V L A M K O;R
L A D S M N Z P | S N P Z A M L;D
R O Y E X G K F | G O E K R F X;Y
W N Q V K H F S | W K Q V S H N;F
T Y Q M P W C D | Q P M C W Y D;T
N K X F Z M U W | W Z N M F U K;X
H A Q W D M F C | C W M Q F H D;A
V M F H N C X P | C N M F X V H;P
K C V N E L P W | V E K P W C L;N
U Q H S W N X I | N X S U H I W;Q
D M F Q Y J T V | Y T D M F Q J;V
M Q G B V D K S | V B K Q S D M;G
Y Z R J T X A N | X J R T Y Z N;A
W L N X Y R O G | O L Y R W G N;X
H M U V F Q D P | P Q F U M V D;H
K M P R Z S Y Q | Z P M K R S Y;Q
V B I X K Q Z N | B K X N Z V I;Q
H G M K N T J B | K B G T H N J;M
U T K O L I C N | T K U L C N O;I
W K X S E D F Y | Y S W K D E X;F
Q K O H T N A I | I Q N T K A O;H
W F I E P S L Z | P L F E Z W I;S
K Z M P Y T D G | Y P M T G K Z;D
G I V M U K F R | V K G M U F R;I
T O R V U F B I | V R B T U I O;F
X L G O R Y H C | L C X H O R Y;G
T J B V M O Y G | G J O V M B T;Y
Z J N H E Q U S | N J E H Z S Q;U
F K H Q T L O R | R T K H Q F O;L
J O D C K G Y N | D N K O J Y C;G
F P W U D Y G A | W D Y U F G P;A
D W T R Y M X C | T M X Y W C R;D
Y G M T K R J L | T K M J G R L;Y
V C S U F B I D | B S D I V C F;U
G X K Y R M J C | Y J M G K X C;R
N C A D O U Y I | I Y D U N O C;A
Y X Q G C D Z B | Y D Q B G Z X;C
F J Q W K B E T | F K J T E W B;Q
L U R V T G F H | H L G R T F U;V
D M A H L J R Q | Q R A J L H M;D
A T N G W Q K C | N C W A T G K;Q
F D G S B Q I K | K F I D S Q G;B
N Y C R O Q D J | O N C Y Q D R;J
H L O W E N R Z | W L E H O Z R;N
F I X K T L M E | I F E X K L M;T
W Q T N P J S M | Q P J W N T M;S
R I Q M Z H T S | M T S Q I R H;Z
M T V P B K H C | T P H M C K B;V
R B V K S F J G | G B V J S F R;K
K B G M L S C I | L M C S I K B;G
G J U R W T M H | J G M R T U H;W
A O S P M J C X | C J O X P M A;S
T P B V U G N M | M B U G V P N;T
Q Z I V K F J O | Q I O F J Z V;K
Q Z G O S B N U | U B S Q O G N;Z
F A C D R K G U | K R D F A G U;C
I D Q F C K J Z | K C Z I Q F J;D
G D X N Y F T U | F X D Y G T U;N
J T U Q L Y N E | J Q N T E U Y;L
P R S B U M J I | J M B R S P I;U
I Y O W X N Z M | Y M X O I W N;Z
V I W H M S K U | K V H S W U I;M
M W L B I G X T | X B L T I G M;W
K V G N E H B X | X H E V G K B;N
H P E R D Y F I | F Y D P R I H;E
I E H W Z P C Q | I H W C Q E Z;P
A N V Z H Q P U | U N Q Z H A P;V
W Z O E M V J D | J V E W Z D O;M
S I G P B A W Q | G B S A I W P;Q
E L P H Q Z Y O | L E H O P Z Y;Q
H N J Y M S X P | X Y P J H M S;N
G O U E K Q S Y | O U E Y Q K G;S
J B Y A R L M X | R Y M X L A J;B
Y V X H K U O D | D X Y V O K U;H
F K D Z T A N E | E A T D F Z K;N
I Z H F G S Q E | G Z Q F H I S;E
Z X Y R U V B G | V U R X Y B G;Z
G K X F C P Q Y | X F Q P Y G C;K
K W D N R M G I | I K N M W D R;G
Q C F M J B L E | M J F L C B E;Q
G P A B J W D V | G B P J W D A;V
J G O P T H A M | J H A O G M P;T
J A P X C F K G | F A J G X C K;P
J P O Z Y K M A | J Z P A K M Y;O
D P S U F E I K | S I U F K E D;P
K Z E G O M F N | G E K N F M Z;O
Y W P I B N J Q | Q B J W P Y I;N
A T K L J Q Y M | Q Y A K L T J;M
F A B G K J L R | G A F R B L J;K
Q F Y V R K I C | Q K R I C V F;Y
Q D I U J O C W | D J U O Q W I;C
Z B P T Q M D C | T D P C B Z M;Q
Z A U C L E M B | U E A B Z M C;L
J H T U S C Q F | Q U J C F T S;H
B R P J Y C A D | Y D J P B A C;R
B U O V K I L X | B U O K L X V;I
A U T X L M B G | U A T G M B X;L
K D B W V E T P | V E D W B P K;T
O A B R Y U W E | U A Y O W B E;R
O V S Q I A K T | O S Q A V K I;T
S A T B X Q Z J | J Z B A X T S;Q
B D I T W F N V | W T D B I N F;V
C H S Y K B D L | K L B S C D Y;H
E O A W T J H G | G E J A W O T;H
B S J Y Z N G I | N S B Z J Y I;G
H Y K F N J V Z | N H F J Y Z V;K
Z M O A V X K W | M V A X W K O;Z
L W U T X E O B | E L O U W X B;T
J N X K R E G Y | E G J K X R Y;N
E Y Q Z G B U A | U E Z A Y B G;Q
D Z T Y C U H K | K U H D Z C Y;T
W S B U K E P Y | Y S K P W U E;B
Q A R O E M W N | E A M O Q W N;R
F O W V P R L T | L F W T R O P;V
D Q A G N T U W | Q W U G N T A;D
G M T F B K D J | G K M F B T D;J
A I B O J T U D | J A D O I T B;U
V U Q E A Y P X | Q V A U E P Y;X
D H M B O T C A | H D O B T M C;A
J P Y T Q I U C | Y J I U Q P T;C
X L T R S O N C | R S O X N T L;C
O F S Y K W U V | F Y K O S W U;V
V E J L K B P A | P L A V J B E;K
J A U I D M K X | D K X M J I U;A
O C I B W M Q G | O W C Q G M B;I
V F Y J C Q W T | F T C Y J W Q;V
C M D T F I U G | M D F G I U C;T
R Q O A F U L M | R L M A Q O U;F
T H N L Y J Q K | L J Q K N H T;Y
Q V L P O R M U | Q R M L V O U;P
J P A U R C Y I | C R A Y J I U;P
I O F S D B E V | D S B E O F I;V
Z D C Y N U E K | U Y C K N D E;Z
U R T X W K I F | R W K I T F X;U
K X R W B G T N | K G W R N B T;X
F V X L T N U W | X F T W U L N;V
H E R Y A Z T F | F H Z Y A T R;E
J S R I O P E G | O P E I G J S;R
R N H Z B A Q O | N Z Q H A B O;R
S I W U C M L P | P U I L C S M;W
W U C N B Y D T | W C N T U D B;Y
R J S U Q C P F | R U C Q J F P;S
X M F E N G B I | I F G E X B N;M
I B J L S X G R | G X J S B I L;R
W M V B J Z F H | Z F W V B H J;M
H C V W K I G L | W C H I V G K;L
T D O P Q F R L | D Q R T F O P;L
F K U O Z H X J | J X K O H F U;Z
T N E L O A G I | A I T L E O G;N
N B H X G M Y I | N Y X I M H B;G
X Y E O Z D H M | D H M Z Y O E;X
M F C R N V P O | N C F P M O V;R
Q V P B N U F A | F Q V P N B U;A
V D P R N A G J | V N R D A G J;P
M A W T J Z H X | X A J M Z W T;H
F M Z Y I L C X | C X I L Z F Y;M
R N M P A V W G | P A W N M R G;V
R Y M I E N X P | E X R P M N Y;I
A P V E X Q Y I | A P Q X I E V;Y
H T S W J B Y A | J Y H A T B W;S
F U I B N C T K | C I N T F K B;U
P Z X I O H U G | I U H Z P O G;X
Y E G D S A H R | R D A G Y E S;H
C V Y F D R K N | K Y C D R F V;N
O B V D U X G W | D V X G B W U;O
M Z G T S I J H | J T I H G Z M;S
K R Y J C L N M | J L Y C K M N;R
I C X M W Y V L | M V Y C X I W;L
Z J X H B D I V | D J V X I Z B;H
O H U L Q W T J | O J U W H L Q;T
J X E U K R B C | R B X C J E U;K
A L Z R Q T P G | A R Z P L Q T;G
U R J S D P Z Q | J R P D Z U Q;S
L R O T F C Q M | O Q M L C R T;F
W S H T D N I V | S H T D N I V;W
R M O V A N J I | O N V J A R I;M
Z N H A R S I E | I S N H A Z R;E
O V A Z U H T K | U V H Z A T O;K
Y A D R M Z G F | R A M G F D Z;Y
C U X K G T A N | A K X N G T C;U
B F M G S D E H | M H F D S G E;B
P R J L M T D I | R L J D T M P;I
M K A Z Y R N I | N Z M A K R Y;I
F K L Z R Q V W | F K L Q V Z R;W
F U J I H R D Z | F J U R Z D H;I
Q E M B W A I Y | E M Y W I Q B;A
P H W K J G C O | H O K G C P W;J
Q B Y M T N K E | E K M Y N B T;Q
P B Q V M G K T | G V T P K M B;Q
F P E G J H B V | F G B V J E P;H
R L P Q S I T A | L T I S Q A P;R
J L P F D B U X | X J P U B L F;D
Z G T B A W S I | T I G B Z W S;A
G A O S B Q Y U | S A Q U G Y B;O
W P U G N O V R | W N R U G O P;V
U J G B A Q D H | H B D A J Q G;U
O L V B F C E X | L X O F B V E;C
F X W S Q L D P | F Q D S X P W;L
I G R H K O V P | G H O I K V P;R
P O E Z N Q Y U | Z E Q P O Y U;N
U L S D N Y J V | N L D Y S U J;V
Q Z M R S E W V | R M S V Q E Z;W
H X B T Q N E R | E B X T R Q H;N
R K A Z M D J B | R D J A B K M;Z
O D A G P H K R | O H K A R D G;P
X U M R C E I Z | E I X C Z R M;U
X L F K N Z H E | E H X L K Z N;F
J B Z D Y M O N | B M N Z O D Y;J
O I V G B M T U | T O V U I B G;M
Z G I X L N C T | Z L G X T N I;C
I C M D K F L X | M D X L F K C;I
V I B F T X G E | F X B T I V E;G
Q W A R O C Z V | R Q A O C W V;Z
C G E R L W O M | G M R L C O E;W
W X V H C L Z E | E L W H Z X V;C
G A L T F X M S | X S G M L T A;F
D M W Z J G E I | I E D Z M G J;W
S E H B N O Y I | N S H B O I Y;E
H G I Q R U M W | G W I Q U H M;R
W O P D M C N T | M O N P D T W;C
Q H C A K R J T | J T H C R K Q;A
S Y N G C I W D | S N Y D G W C;I
K U T V Y F E L | T L U F K Y E;V
H G U V N M J L | L V M N U J G;H
A W O F R G M P | F W P O G A M;R
B O M L S K F W | O W L B M S F;K
E W Q O K C V J | Q K W C O J V;E
B R M S N U Z P | P B R N M U S;Z
I V E U Y K A S | Y I A E S V U;K
H A G N U K Z J | Z N K A H J U;G
N T J W F Z O L | F W N O L Z T;J
M S O V Y N D X | D S V M Y N X;O
J B P M T H E Y | T P J Y H B M;E
A C D G R E Q S | E Q A R S D G;C
E C X M P N I H | N E I P H X C;M
R E Y Q J U F P | E P Q F R Y J;U
Q L I P W A Z D | D Q A I Z P W;L
U T X S D O R P | U R D T S O P;X
Z T F W M J R U | R T J W F U Z;M
U F Z M X B V H | V Z F H M B X;U
S W F I G T D N | D G F S I W N;T
H G S M B N W T | G W M T H B N;S
Z L C Q X S U H | H C S U Z X L;Q
F J D G X M O U | O G F J D U X;M
X P N K Y T G Q | G X P T N Q Y;K
W F M R P L H S | L H R W S P F;M
E V X A L U Y O | L E Y X V A U;O
K T P Y A C H X | T A Y C H P K;X
E H Y A I N J S | A E Y N H J S;I
F U E O I B Y P | E I F P Y B O;U
D A L V R J O C | O L V A D J C;R
Z O G V S C T M | G M T C V S O;Z
F D V N H W J K | H K J F W V D;N
A B Z X O D C N | O A D X C Z B;N
G T I F N X Y O | Y N F T G O I;X
M O P A H D Q S | P D H S A O Q;M
K W E Z R J H D | W E H Z J R K;D
K B P E L S Z W | W S B Z E L K;P
G O B S K R I V | G V S I O B K;R
N U L V E X C W | U X V L E W N;C
N R A Y B M T W | N M A R Y B T;W
T M R X F D I P | T I R D F P X;M
A E D B K I O P | B O E K I A D;P
Z F Y O M B J D | Y O F B J Z D;M
R O E W L V T G | W E R O T L V;G
X M G K T P Y C | T G Y C K M X;P
K A Q X I V Z M | K V A M I X Z;Q
K R T I U S Q M | U K M R S T Q;I
F H I Y A O M N | I N F O Y H M;A
O G T V K Z H R | G Z V H K O R;T
Q N B I T A R U | T R Q A B U I;N
V H K I Q B A U | I Q V U H K A;B
G L E M D J R N | N D G R J L M;E
M F C U L Y A N | Y F L C N A M;U
W V R Q U A J L | J U L R V W Q;A
N Q V Y Z B X T | V N B Y Q T X;Z
B J T K Z X A D | T J B X A Z K;D
O N K E U H Y B | N E K Y B H U;O
W L K X O C Y M | K M L W X O C;Y
O C V X H Z G K | H G V K X Z C;O
R A V B O K H W | V H B W A O K;R
F A R E M S I G | I E M G A R F;S
U J T Z C M V P | P T U V Z C J;M
Q T X A P C Z U | A P X T U C Z;Q
J U D T R E Y G | G T U J R Y D;E
O T U R W B H Q | U W R Q B T H;O
P N F E D K W J | E K J P D F W;N
G Y S D J I O C | D J C S G O I;Y
Y E T V P G C W | P Y E T C G W;V
N M L I X U S Z | I N M Z U X L;S
Z K J G Q H B E | E H Q B K Z G;J
E M W H L U I A | M L W A H I U;E
O G C F V B Z E | Z B V E G O C;F
B T Y C Z Q W J | Z J B Y T Q W;C
K Q F A Z Y D R | Q R K D A Y Z;F
S C J T V K Y X | T J C Y V X S;K
F D W O M H N J | J F M N O W H;D
N V J D Z M G I | V Z D N J M G;I
A W C L X S M T | M L A X S T W;C
D Z C F I S H T | I T S F Z D C;H
C X M P U O E R | M C P E R O U;X
R W U K G Q V Y | G Q V W U R Y;K
F G L Y A Z O I | Z A Y O F L G;I
V I P Y Q N T Z | N V P T Y I Z;Q
E Z H N K S C M | N C S M K H Z;E
A V G K T J I W | T A J G K V I;W
N Y H R Z I E D | Y H N R D I Z;E
X S M J P I C B | S C I P M X B;J
Q Y Z L B V I P | L I V B P Q Z;Y
X C F B T P V L | C L P V T X F;B
L E D C V T M N | V C L D M N T;E
R T K M W V D U | R T V K U M W;D
P J Y L U S X I | J Y X I P L U;S
W P D K E F V S | W D S K V P F;E
N C H W U Y Q S | U N W Y Q C H;S
P F K U Z N S D | F K Z P D N S;U
R N P D Z C A W | D N A W R P Z;C
S O V D N G Z J | D O V G J Z S;N
O L K S A C N M | A C O N M S K;L
Q F R Y D U N L | F D N U L Q Y;R
O F J U A E S G | J G U S O E A;F
S L P A R C G B | R L S P C G B;A
S A H M D O V E | M E D H O S V;A
C P S O Z K U J | Z K O U C J P;S
N L F J M Y Q B | F L B N Q Y J;M
K H L G O T C V | G O L H T C V;K
M R P L A I Z X | R I L A X M Z;P
J P M G F Z Q Y | J F Q P M Y Z;G
K U B L M C E Q | K U E M Q L C;B
F D W N I Y A B | N A I W Y D B;F
M G H C S U N K | C U H K S N G;M
V S C Z G M D U | U D Z G C M V;S
C G K J X Y Q H | X Q H Y J K C;G
J X B K U R S H | R S X U H J B;K
V P G S C E H L | V L S P E H C;G
Y O S J R E D I | I Y S J O D E;R
C K M T G V J E | G V C T K J M;E
C T O N P H M L | H L C N M O T;P
N V D O Q F W I | I Q N D W O F;V
K V G L Q B S M | K S B Q G L M;V
B Q N K O L W V | B L V Q W K O;N
J O P Z T G S U | U O P T J Z S;G
D X W H B O F E | W H B D F E O;X
Z R H T M O L I | Z L T H O M I;R
F W Y E D K P Z | Y W P F D Z K;E
I U M A V L R F | M L F A V U I;R
V P C R B Q Z D | V B Z R D Q P;C
L U O J D R S E | R E O D S J U;L
X D A T W S N M | X T W S M N D;A
L E P N K C H A | L A C K E H N;P
X Q T K S U C W | X K S C U Q W;T
A H Z J E P M O | P H A Z J M E;O
A S O B V J E H | S O E A V H J;B
N H X J L O E W | E X W N L H J;O
K H Q D J L R U | K U L H R J Q;D
L X T B F P H A | T P L A X B F;H
E V N S B L H F | E B V S F N H;L
Y U L C T R B N | N B L T U R C;Y
I Y Z O G Q H B | H O Y Q I G B;Z
D V S Z T E J L | E Z J V D S L;T
I P W G X K U Q | X G I Q K P W;U
D T U Z G B R F | D B T F U R G;Z
J L I R V T Q N | Q J L I R V N;T
F Y Z S R T U B | U S Y Z B T F;R
E R M Q T Z P D | D E R Q M P T;Z
K J P O D U V X | O K D J X U P;V
R T Z U G D F E | T F D G Z R E;U
Z P M V Y B A F | V Z Y B A F P;M
T L Y D H O F K | K F Y O L T H;D
B U Q E N S P G | G Q P S U E B;N
M L W P E T J F | W F E T M J P;L
Z B V E M K L I | I Z B V M E K;L
X G V W R U S Z | V G Z R X W S;U
W M E O C Y P Q | P E Y M O W C;Q
W Q K J R G S M | S J K Q W M G;R
Y O E J S B M H | S B Y J M O H;E
S B M C K D V Z | Z K S D C V B;M
O P N L Q T C H | O C H Q N L P;T
N W S L M Z B K | K L Z N B M W;S
Y F S X M Z H P | F X H M Y P S;Z
F S L I Z C J D | J S F I L Z C;D
K X B N O A J M | K M J N X O B;A
E F L P C Q V Z | F C V E Q L P;Z
N M F Q L B G A | Q G F B A L N;M
V R G T U E Q O | G T E O V U R;Q
S Z H K P Q G Y | Y G K S P H Z;Q
H Z I N Y X J O | H J X Z N O Y;I
D B C G Q S P N | B C D S G N Q;P
F C B U S G X H | U C H G S F B;X
H F B Z I Q T G | Q B G H T F Z;I
A J P D I K M N | P K M J N I D;A
W X V F G H Z L | X Z L G V H W;F
X E F P C Q U K | P X F U E K C;Q
X N P F Z U O I | X P N U O F I;Z
F E X N O R Q H | E F R O Q H N;X
Z G U D O P C J | P U Z D J O C;G
T I E J W K D Z | T Z I J E K W;D
W O N B F P K H | W B N P K F H;O
W C B Q R X G Y | Y X G R C B Q;W
S K T F H N A C | S A K T N H C;F
T N B C Y H W I | I N H C Y B T;W
X C N O W S E B | S C N X E O W;B
R N S B D O J Q | R Q N S J D B;O
N H Y A F B D R | A D H F R N B;Y
P A X Z K B V Q | X Z Q V K A P;B
P N H O F L V C | F P O L C N V;H
U T Q S D X Z R | D U R S T Q Z;X
X S R W L E I J | X W L S J E I;R
A W G B U M X H | M A U B X H G;W
T F X Y L Q W E | E Y L Q W T F;X
Y Z W S E N O D | D N Y O Z W E;S
C X G R P U Q I | Q X P I G U R;C
J P T U C D S Q | D Q P U T J S;C
M Z P O K A N D | O A M Z N D P;K
G L Z C Y I P K | P I L C K Y G;Z
Y Q P E R K S H | H R K P S Q E;Y
X W F I H U O A | U A F I X O W;H
N I K O G V H J | O I G J V H K;N
Z H X S D P R U | H X P R D U S;Z
D X T M H N L J | J N H T M D X;L
D W Q K Y R T B | D Y Q B K R W;T
A Z C F G I R B | G F B C Z R I;A
N S Q K U O E X | K U S O X E Q;N
B N O V Y F I K | N F I K Y V O;B
U Z D A L H G V | G A L U H D Z;V
O Z K J X B A Y | J O B Z K X Y;A
V D O K F U M L | M D F K U O V;L
I L Y N P F K B | K B Y P L I N;F
T N S H Y I V K | H I N T Y K S;V
V K S L D T N Z | N S Z K V D T;L
I U V H D L S A | D I H S L V U;A
N V T K A X M F | M A X F V N T;K
L U D T W M C S | T S W M D C U;L
E A R Z H N G S | G E A S H Z N;R
V E M X L R T N | V M T N X L E;R
K R P Q W I T U | T W I Q K R U;P
W G T I P Z N V | V N Z I G T P;W
B J Y S Q F I T | T B I F J S Q;Y
G D F T S N Q Z | Q G F Z N S T;D
O C K T I J A B | I K A C O B J;T
Z G W R L H B V | L G R B H W Z;V
W S J R E K Z B | B J R K E W S;Z
