J Q Z I R N L B K | N L B I R Q J K;Z
T S W F G K I D E | I E D T F G S K;W
G S V A C P B I O | P V A B C S G I;O
D P I W M B X O N | M O P X N B D I;W
P F R A Y B C H J | J F B Y R P A C;H
J H P Y C D N F Q | C J D F Q N P H;Y
C G U N S Q D Z A | Z S N C U Q G A;D
G Y A X D C U T N | D G U A N X C Y;T
B T I R W E U Z V | U B Z I W T E V;R
C L Y W M B A V K | K A M B Y W L V;C
K Y T S H E A L W | Y S L H W K T A;E
R Q H I X D L M S | I Q M D R H L X;S
B X L H Z O U P V | O L V P H Z B U;X
A D S J X R L Y W | R A Y X D W J L;S
U S C V T L G F H | C S U G H T F V;L
H J N W E D L P X | P J E X W H D N;L
R I C J U D Y K G | J I Y U R G C K;D
A F Q E M J X K H | X M H F A E Q K;J
B Q H J G X I Y W | X B Q G Y H I W;J
K X A J T Y S Z P | A X Y K Z J S T;P
H G I N T U R K V | U T V K I H N G;R
Y E Q J O M K R C | Q O C E M J Y K;R
E Q W V R D H K A | V A E W H D K R;Q
Z H E K P Y R T S | E Z K Y P R T S;H
E U A X Z D O N R | E U N D X R Z O;A
W G J C V Y O X H | O J C X W Y V G;H
G K I V M U S E Q | V S U G Q K E I;M
B A O M H E S G J | O M E J G S H A;B
Z U N V G H R I K | R H N V Z G U I;K
O N R T A E X F W | F A E W N T X R;O
K V H L R B O F E | R H O K F L B V;E
Y Q U I V J Z O H | Z U V O Q I H Y;J
B Q J R W L N M S | W R N S J M B Q;L
O B D U C A K Q E | B Q A U D E O C;K
O H Y F Q Z J M S | J F Q Z M O H Y;S
J Q V C P N T Y M | Y V T C Q P J M;N
S F B C R Q K O I | B C S F R Q I O;K
E Z T F I W Q O L | L I E Q F W T O;Z
R K H B J P G W L | P J W K B G H R;L
U P X I C G A K Y | K I U G A C P Y;X
E O J V L U H G S | H V J G E L U S;O
A X P Z L O G Y C | Z X G O A L P C;Y
Z N E H O A W B F | F H B Z O A W E;N
Z P L M O N B E F | M O Z F E B N P;L
A B Y Q X S E H C | X E A Y H S B Q;C
A O S W C X T I Z | C I X T Z S W O;A
G A L F C K U N W | L A N K F U C W;G
G S H M R K B L P | G R P K L M B H;S
J T M W Q H K N S | K H W J M N Q T;S
O U I V P B K E H | P B V E O I U K;H
R T F N M L H U I | M H T R F N I U;L
Z P E C U J M B W | Z E P B M J C W;U
O I S B H J M T L | S T L M I J B H;O
D B Z Q N R I V W | B I Q Z W V D N;R
W Z J Y H S B C Q | Q Z C B W Y S J;H
R Q C G L W Z N K | Z L N Q C R W G;K
X Q M I J E T U Z | T I Z X U J E Q;M
K N P V E L T I Z | K E N Z I T V P;L
T P E W J K O M H | P J W O E T H M;K
O P X M R Z F Y B | M F P Z B R X Y;O
U D C J H A X V S | J A D C S H U X;V
E K C W O G J A D | E K C D O A J W;G
L R D Y K P G M Z | D L M Y P K Z R;G
K F G C A U B E M | B F M U A G K C;E
I U N F V P E G R | G P V E F R U I;N
R U B A G I T V O | O G U V I R A B;T
Z I M C V N P Y U | P Z C Y N I U M;V
Z R C L H X S J V | L H J V X C Z R;S
P O E T D B G I K | T P G B E K I O;D
M G I D U P W J Y | D U I G P M J W;Y
I L M P B D Y G R | M D P B L Y I R;G
C F H L J O E U P | F O L P H J U E;C
S T O N V F L R U | S F V L T N R O;U
A J D O W U M V L | U M A V D W O L;J
W D F M O K R Y P | D M P O F R Y W;K
S A E C W I Q U R | E C W R A Q U I;S
X Z L P G E O B S | P E L Z G S X B;O
G H T Y X E W J F | W E F G J X Y H;T
W Z H X P N K F A | H K Z N F X A P;W
U Z F Q T C K L J | Q J C T U Z K L;F
K U Y C Q E F P O | P E O K U C Y Q;F
I K N V H X D Y F | X V H N F I K D;Y
E G C L Q Y I T B | Q I C T E B Y L;G
T X L M R W Q U F | X F Q R T W M U;L
Q R M Y K W N B I | W N K R B Y M I;Q
O C Q R F U S V L | L C O R U V Q F;S
Q K P L T E S D X | L Q P D E T S X;K
B M P S D J X V Y | B S Y X M D V J;P
R S D E X F J N W | F J R E X D W S;N
M E U C K D S N X | E M C U X N S K;D
V C G M P A K Z E | G P K A Z V M C;E
Z T A L F P C R W | Z P W L A R C T;F
T R J V H D N K S | V T S H K D N J;R
Q E V O Z M I P S | P Z E S M Q O V;I
P R U X W O V B M | W O M V R X U B;P
Z P M W S E T D J | E D S P Z M T J;W
X I S H O U J C P | O I X U P S J C;H
R B Q C A K S U G | C G A R S Q B K;U
R I Y A W L U S O | R I U W L O A Y;S
I S D N L X P W G | S W L G I N X P;D
F L Q M Y R V K W | W F Q V L M K R;Y
L W U M K I Z A B | U K W B A Z L M;I
R H F O I J N A T | O F T A H I R J;N
T E C O A M F D J | M D E T J C F O;A
X Q L G U C P N Y | Q X C U L G N P;Y
X H P Y D V G O W | P D Y V H O X G;W
L U M B H S F C N | B N H S U M C L;F
T B L E O P K A G | A P L T G O K B;E
T B X U H I E Z G | G B X Z T U E H;I
F I G X Z W J P E | J X Z E F I P G;W
Q W X I P N S U M | M U Q W S N P I;X
H W T X J P U A Q | X P T J U W Q H;A
N S L X M H E Q J | Q N L H S M E J;X
N A Q X O I D H S | O Q H S N X I A;D
Q B J N Z W U I G | W B U G I J Z Q;N
B T J X Y O F S C | O B Y X S C F T;J
H P M F L A D V G | V F G M D A H L;P
S E M Z G A O K J | O M K A E J S Z;G
Q T W G C J F K A | G F J A W K C T;Q
J R X N M Z C I D | M C N I D J Z R;X
A Y D E W S V N H | S D V W E A Y N;H
A S H Q K U T E J | T E Q H K J S A;U
P O J M C G X F R | F J R X P G O M;C
A D K Q X U W B M | A W K D X Q M B;U
X B Y S K E O W D | Y K W X S D O B;E
P C L K R Q S Y A | S Q R Y L C P A;K
C N V X I L O M Y | V Y I L O N M C;X
L F D I M H E Q V | I L D M V H E F;Q
Z W O B U X E Q C | E Q U X C Z B W;O
G Y P V D O A S K | O G K V S P A D;Y
S L J H W N V E I | L I W H S V E N;J
Q N E Y L W X F O | F Q Y W L N E O;X
M B K T U L S E D | S U E D T K L M;B
O A S B J H I U Y | I J H O U S B Y;A
L H Q Z W G M R K | H Z K W M R L G;Q
J E W B G A H O K | B A H E O K J G;W
C L T B S X F W N | X W L C F N S T;B
K A H D S O Z B N | N O D H Z K B S;A
H K O L I J P X M | P O L K I X J M;H
X G I F R M J A U | A R F M I X U J;G
R S L V M E T J N | T V S M J N R E;L
H Y X Z D T K R M | K Z R M X T D H;Y
A H T I V N G O U | I A U G N V H T;O
C L Z I N O U Y A | L I N U O C Y Z;A
M P X U T J K S R | K S R U P X M T;J
I X T S N L P O R | R T I P X N O L;S
G W V D E Y S L R | D Y S V R E G W;L
H C W J U G F D A | C A J W G D H F;U
T D A P L C M B J | B A J T P D M L;C
F Q M K W L I Y S | M L F K W Q Y I;S
C L Y A N O S I G | Y O C G N I A L;S
J I V M F K H P X | K F X V I H M J;P
O Z B J S A H U K | H S O A Z B U J;K
C H R M O W I B G | C B M H R G I O;W
G M A Q S Z N P O | S A Z M O Q G P;N
U J O R C P S M Q | R S O C M J Q P;U
Z W I Q H R B C D | C D R H B Q I Z;W
C N W Q X L B O F | Q C F B X O W L;N
D C T N E W Y V Z | W E N C T D Y Z;V
P R F Q K C D J U | Q F J C D U P R;K
D X C P S H G T B | B X G S T P D C;H
G P I Z J Y Q V W | Z Q P G I J Y V;W
D C S E R B I H L | B S I H E D R L;C
Z W C P J S Y B V | C Y Z B P S V J;W
V U P F R O L N D | F O R V N D P L;U
D O S E F B K Q U | O B S D K Q F E;U
X V T E L W H S R | S L T W E X V R;H
J D P U Z B T N I | D P B U N Z I T;J
N R S O F B Y U X | N S Y B X R U O;F
F E O M Q W H V U | E H V M W F Q O;U
I K M Q H D X S N | N K D I H X M S;Q
H Z C D A Y Q L V | L H D A Y Z C V;Q
T B L D Q S K Z G | L Z Q T S K D G;B
Q D L Z T M A N Y | Z D N Y M T Q L;A
A H J P X S E W Q | E W S H Q X A P;J
Q H Z E Y X U W T | X U T Z E H W Y;Q
U L D C Z M J P K | J P L M K D C Z;U
G R F S A C J E D | S A E R D F C G;J
C K W N Z O L P S | S C N P L K Z W;O
C K A R M I S N H | N S R I C K A H;M
V D B U C S O Y M | C M Y B U S O D;V
R M T B J Q O C P | P B C M J R T Q;O
K I V S Z P M A O | I V Z P K A M S;O
S X T B K I L U H | X U S L T H I K;B
Y J Q A W K F E O | J E F W A K O Y;Q
U W S Y F C V O D | V D U Y W S O C;F
N M T L K Q E G A | K L Q A M T G E;N
I Z S J T C R O A | R C A T O Z I J;S
E S B Z R P F A D | E R P Z A D F S;B
I L S A W Z M D K | W S M I L A K D;Z
N W D M F O H Q R | D F O W Q N R H;M
Z Q V E I X Y A T | X Z I Y V E A Q;T
P T D C M W E Z O | C P M W T O Z D;E
S C V A R I Q W J | V S A W C I R Q;J
D L Y C F E W U B | B D E U C F Y W;L
A Y F S Q K J N O | F Y J K N O Q S;A
Q D J A K B S Z O | K J A O Q B S D;Z
Y D E T S X L V N | E D X T L S V Y;N
I K P D J Q W F G | J F P K I D G W;Q
M F U X K N B Y L | N M F K B Y X L;U
R O L U Z E W A H | L U R W O H Z A;E
B V C W Z A L Y E | C Y A L Z V E B;W
K V S H R I Y E N | S I Y H N V E K;R
Y W D M X U I O N | N W D Y O M X U;I
R L J V E O H W N | H E W O L J N R;V
R M H Q S J Z K U | M Q K Z R S H U;J
Q F O E G M S C K | O G C E S Q M K;F
G Z T M P R K D U | Z U M P D R K T;G
T D I N Q G R M B | Q T B N G R D M;I
U N H T O Q D G K | N O K G D T H Q;U
L A B C Y T K Q S | A L K C S T B Y;Q
G R D T Y H Z P B | Y B R G D Z P T;H
A L N Q X C R Z W | Z L N X Q C W R;A
D A U N V T X J L | X T V N D U A J;L
L M O N H K W E S | M N K W H L E O;S
G D S Y U Z V X J | G J D S U Y V Z;X
G A T M Y I V F S | Y I S A F G T M;V
J Z L G K N B A X | A X B K N J Z L;G
G E D L K C J X W | X L J G E C D W;K
J Y H B D V T I O | B Y I D J V T H;O
C X Q A D K R G Y | G X A Q K R C D;Y
F J Z E B A K L N | B F Z J E L K A;N
Q U M H V E K W N | H E N Q M U V W;K
D I C M L T Z P Y | I T M D C P Z Y;L
W B L Z J A T K R | W R T K B A J L;Z
P Q J S X F V C B | C F X B S J Q P;V
O D X Z E T Y S N | N Z E D X T S Y;O
R O C V Z P D T U | V C Z O R T U P;D
Y W P S H I D V L | H P V W Y I L S;D
O G R I E T M K H | K I G O H R E T;M
Z V Y L U X E P S | S E L X Y Z V U;P
E Q M T G J Z R V | G Z V M E T J Q;R
T U O B E A H G I | B O U E I H G A;T
X O N U W A D T S | S W A D U N X O;T
R Y M W D U E B N | E U N Y R W D B;M
B L D I X Q H F M | I H B Q M D L F;X
S L N J Q Z G B X | Q B J L Z S N G;X
T A C P L V H U O | C A P V H L O T;U
R E C K X V B Y F | B R C F Y K X E;V
N U L J C W Q E P | U P J C Q W E N;L
U Q O E W A G F L | L O W U E A F G;Q
H X M B L O F C G | B O C X M H F L;G
E T S X P O M H F | E H F P S O M T;X
B W T S E G V D Y | G T E W Y S B D;V
P L F I R Z O X K | P I X F R Z L O;K
E D N J Y T M K R | M E J N K T Y D;R
R C H A F U T S W | F H S A R T C U;W
Q S A V R O U F B | O A R S F U Q V;B
R L P A Z Q F S B | R L A P B F Q S;Z
P C L X I J F T Q | F C P T J Q X L;I
N J Z T L U C D H | D Z J L T C H N;U
K O H L U I A F W | I K U L H F O W;A
J P O E A Y X M Z | P X Y E A M Z O;J
V P S X B Q N U G | N P Q B S X U G;V
W H S K X N Z Y G | X N H Y S W G K;Z
D Q N U W A P T X | A T P U Q W X D;N
Q W U N M G F R H | G F M Q U N R H;W
V N L R T W D B X | W V T N X D R L;B
G T H C Z D B I F | C Z D T H B F G;I
W Q E V P L G R Z | E V G W L P Q R;Z
X Q Z L P U G K B | Z P K L Q U G B;X
F S U D Z A B Y J | A Z Y D S U B F;J
E F G P L H Y T Z | Z G H Y E T L P;F
F W X Y D R V A M | W F A D X R V M;Y
T Z X Y D N W F V | W F Y V Z D X N;T
U G A Y F O C R V | R F G U V C A O;Y
E Y T Z O H N F A | F E Y A N O H Z;T
U W S V J G D L A | W J D U G A L S;V
A C S U I R W T E | E C S T A I W R;U
A M X L E G K C Q | A E X K M C L G;Q
D W F T R H A Q X | X Q F A T D W H;R
X L U W K D J Z Q | U Q W Z L D J X;K
Q F D E Z Y T N K | Y E N K D Q F Z;T
Y L X J P Q F T R | P T F L R Y J X;Q
H K C F P X A D W | W P X C H D F K;A
G K C R H O P D Y | D Y R P K O H G;C
C S P H Y Z G L F | C Y L S G H F P;Z
U L T F C K D H O | L O H K F T C D;U
D U C Q M S P Z I | S U I C Q P M Z;D
I K P B E Y U J Z | E B J I K Y U P;Z
I B Z U L D N K P | Z U P N K L B I;D
B A I D C N R U O | O R N C D A B I;U
J F R H Z U V Q L | H R Q L U V J Z;F
M F S Q D Y G B H | G S F M B H Y D;Q
A W L M I G H U Q | Q M L U I H A W;G
A W F G X H B L T | W G T X A L F B;H
P M X L K C A I F | M I L F K X C A;P
S E Q T U X O B D | D S E B T U X O;Q
C R E I D G K V H | I K V E G H R D;C
K R A S G O H Z C | O A G S C H Z K;R
Z D S B A N Y T P | D Z A B N S P T;Y
N O C L I T B R J | N C O T I J L B;R
F N P V M Y W O A | N W V Y O F M P;A
W L P K V N J U T | K T V U P L W J;N
E U W L A J O I B | E B L A J U I W;O
Q M S H L W Z O A | L O S W A M Z Q;H
X V U G D I B Z P | V P I X U B Z D;G
P R V T S I Q J Z | J I P R S Q Z T;V
Z I G A X O Q H Y | O Y Z I X Q H A;G
H A N J R K E U I | H R E N I U A J;K
A Z W F Y P R H E | R W P Z Y F E A;H
L Y K O U G Q I M | Q Y M O G L I U;K
H C Y G V F Q P Z | Q Z F Y C V P H;G
C I V W L X J Y U | I Y W L C X V J;U
V H K N Z I B P W | I Z P H N B K V;W
L B I A S Z F M U | L B Z F A U I M;S
A Y W R Q T N C J | A T N Y W Q C J;R
H I C D J P Z N F | D I C Z F N P H;J
E U K V B D P H C | K V U D B H C E;P
J D B G K W S P X | D P G B J K W S;X
R Y M E X J H L F | F Y X L R H M E;J
L M Q Z H K A V R | Q R A H Z M L K;V
W C X U H J L Z B | B J L Z W H U C;X
C Z G N W E X B M | Z C W X G M N E;B
R W O V N L U T H | H L T W N V O R;U
S O I N Y D E T A | I T O D S Y A E;N
Q I A W O M L C B | O B I L C M A Q;W
T S A K Q D N I X | D Q K S I T N A;X
L P M Q U S B W Z | B Q P M L Z W S;U
W G I A N R L U S | A N L I G S R W;U
U F Q J Y N K A R | U F R A N J Q Y;K
A L R Y M J X B I | B L M I R A X J;Y
I X T L A W R V M | R A M X L T V W;I
V K W E X F B C S | K B W C S V E F;X
G R B T O X I D J | R J X I G D O B;T
Y B J O N C R M X | B R N M O Y X C;J
A T R D N L Y K S | Y K R A T S N D;L
G U H X R C O K W | C G U H K R W X;O
R S U T E B N K F | K T E S R B N U;F
K P E L R T N S F | L R T P E F S N;K
W M V B A Q T Z E | W A Q B V M T E;Z
Y D P I X Z S R M | P Y I R M D S Z;X
M D U G H Y S V Z | D V S Z M U Y H;G
T I R L O X S G J | J T X L G I R S;O
X A E W Q F G T Z | A G X Z E F Q W;T
K Y S I G E A M Z | Y G I K A Z E M;S
Z X J D U C O R M | D R X U Z O M J;C
U L J M T O X B A | X O B A U T L J;M
I T G B Y S E D U | I U G E S D T B;Y
L W T G M P Q V H | P H G T W L V Q;M
I P M B X V D O L | M P D V I O B L;X
T Q D I R U Y Z C | I R Z Q D Y C U;T
R X L D O Z M W P | W R P M X Z D O;L
N O B G F X Y Q S | O B N F G Y X S;Q
Z H R I Q C V E L | V H C E L R Q Z;I
I E J K U T X N P | J K N E P T U I;X
R T B L Q P U S G | G S Q L T P B R;U
W O Z V K N L R F | W Z O R K N F L;V
S I F G L A B Z Y | I B F A G Y S L;Z
R K E Z L P G A W | W Z K A P E R G;L
Q T O N F S D J W | F W Q N J T O S;D
F A K J T D W C R | K C J A D W F T;R
R X T S P Q G M I | X I G Q T S M P;R
L N C P K V A O Z | N V K P Z A O L;C
S L I X P A Y T H | X I T Y P S A H;L
S J G A B I M N F | J G S F N I M B;A
C S O M F L I P T | T F C P L O M S;I
O E A S M Y W J Q | A E O Y Q J M S;W
B S V W U R F H T | T H S U V B R F;W
D I W A V J Q S U | J U Q A V S W I;D
K Q O P D W S R E | S R W O P D E K;Q
X I B S N T K V A | V X B S A N T I;K
C V J E L B K O H | J L C O V K E H;B
D V N Z I O M P W | Z M V I N D P O;W
B Y R I E O Q M N | O Q B E R N Y I;M
X R N J O Z A E K | K E X O A J Z N;R
T D H Z S Y F J G | Z H G J D T S F;Y
L U K C F N J Q Y | N J C U Y K L Q;F
F U N V M K Y P I | M I Y N K P U F;V
E J P X I D N M Z | X P N M D I J E;Z
H N U O J M T S C | N M C S O T H J;U
K J B P Z Q M X G | Z X B Q J P G M;K
E T Q J O U B K Y | K Q O E Y T B U;J
D R O C K J N E M | C M K R N E D J;O
R S D H L B Y X V | X H B D Y R L V;S
Q U F D M E P X L | F M L E D Q U X;P
S G Z W Q T O I N | G S O I W T Q N;Z
I W B N Q S G X E | G W E B X I S N;Q
J O V Z W L P M K | K P V Z L J M W;O
J E F U N M Z G C | G J M F U Z N C;E
U K Y L O W S Q D | D L U S W O Y Q;K
N F T L V M G H Z | G N T M V H Z F;L
D A F T Q M E X B | M T Q F X A D B;E
W X C R J A Z V B | A C B V Z J X R;W
C O L M F Q B S Y | L C M F Q B S O;Y
D N O T B R V E W | R O D W N T E B;V
Y X F O I J V P Z | J I V Y F Z P X;O
E A G M X L U J C | A U L X G M C J;E
M D O B Y I C P R | Y P D I R B C O;M
Q H I Z F E V J P | H J P I Z E V F;Q
I C G B V X W Q K | Q X I B G K V C;W
Z J B L M F N U Y | N U M J Y L B F;Z
X A W B L E F N G | A B X E N L G F;W
M E K U H C W O P | K O C W M H E U;P
J S Q R K O B P L | P S R J L O K Q;B
Y V K M D Z F G X | V Z G M K D Y X;F
R K O D I B U H X | O B R K H I U X;D
C X R D P B T K F | C F K D R X T B;P
L Z G P S V Q R H | L R H Z Q P V S;G
O I B H Q U V F D | B O D F Q U H V;I
I U N Y E Z T J W | U T I E Z W Y N;J
K S O V Y Z B G R | O Y S G Z K V B;R
M Y U N I S Z P R | N M Z S Y R I U;P
L Z W I P J D O Y | J W Z Y I O P D;L
W E C S H O M R X | R C S E O M W X;H
T R M X N Q L Y P | Y P L N Q T M X;R
E P V G H F B R N | F R P V N E B H;G
E D C K X H S U I | S C X K U E I H;D
Z Y B N J U T V W | J V Y W Z T B U;N
P Z Y U R O Q B D | U Y Z O P Q R D;B
F C Y X I Q A T G | Q C G I A F Y X;T
X O Q L F V M P W | P X W L M Q F V;O
B G U Z C I L N H | H G C I B Z U N;L
E Y G D S F O W L | S W Y E L D O F;G
T B R P H K F C Y | K B P F Y C H T;R
X A H B M P S K R | H B X S K R A M;P
X D M Z J N A L K | Z M A K L D X N;J
G J D S E T F I W | W T F D S G J I;E
R J H K S U G L C | C U H S L J G K;R
N R P K F Q W Z H | W N Q R K P Z H;F
B F E Q U C W S Y | U F B W Y S C Q;E
V F Q N A U D P W | P D U N V A W F;Q
X M F L G B Q W R | W M R Q F B G X;L
X G N L S E H T A | N H S T G E L X;A
T J I L Y C E F Q | C I Y Q L T F E;J
O P Z K B Y D C W | B Z C O P W K D;Y
W J S D H V P B A | W D B A V J P H;S
X V E D B U J Y M | X B J Y U E D M;V
S J T X V R A G C | A J R G T V S C;X
P J E S I V Q L A | S I E L A Q P J;V
F L G X U D Z J R | J G R D F Z X L;U
M A I X N H P Z Q | Z M H P Q A X I;N
V G S J B R Y E N | R E V Y S N J B;G
P F C V E N Z Q S | C Z E V S N F Q;P
J G H Z A V O I P | G V H A Z P J I;O
W Q C I Z J B L P | L I J C W P B Z;Q
M T Y J G S V D H | S D J M H T Y V;G
D Z E C V J P M H | V C E P J M D Z;H
X O U J Q Y M D L | J Q M X U L D O;Y
O K W S E C A U X | W K O E S C U A;X
O I G T K H R A F | R G F T H K O A;I
H R P Q Y I J S Z | I R Y J S P Z Q;H
V P N H W K S M X | K N M V W P H S;X
S V I E C J R D P | J R E C V I S D;P
R W V B Y D F N S | R Y F B D S N W;V
M L T N B E A Q Y | N Y T Q B E M A;L
Q J N D C V P S Z | S P V C Q Z J N;D
C M X O D V T K N | C X D N K M T O;V
L K G N T B W I S | B T N W I K L S;G
A Y Z W R C O M S | O W Z Y S C A M;R
X D J Z G O P E T | G D T O P E Z J;X
L X Y O T Q N Z P | L N X Z Y T P O;Q
M G H C X O E B D | G B O C D X H M;E
A P X J K S I N R | R S J I K X N P;A
J Z W S A C U H O | A J O W U C H S;Z
I L B O D F E K Y | Y K L O I D F E;B
R C X S O J M D T | T D O R C J M S;X
B Z I N T G H K P | P B K N T Z G I;H
A S V W E B G U F | V B E A S U G W;F
Y D L H T B X E C | Y H E D T X B L;C
V P K C M G Y S F | S K V P C M G F;Y
R J Y H D G I V A | R D H Y J I G V;A
S A R V C P J W U | R C U P V J W S;A
T M Z S H K Y C N | Z Y N C S H M T;K
I Z R X M K G F V | F K X G I M V Z;R
J U D A R S F V W | W J A F S U V D;R
U C X O G Z N T P | X O C T U G P Z;N
T B Y R C K S N V | S C T N R V B Y;K
R M J Q D H O G S | J H R G D M S Q;O
N E K L S Y A G I | K E A S G L N Y;I
T B A M Q U Y R P | P B Y A U R M Q;T
G V O W Z R K I J | V I J W Z G O R;K
Y E V G C S B L F | B V C Y S F L E;G
U I E K W B J A T | E T J K U I W B;A
K D E W Z A Y J S | W A D E Z S J Y;K
V Y H X Q F M R P | V Q X Y P H R F;M
Q Z E T S O F B W | S B T E Q F O Z;W
R J I T Q U W G Z | T I W U Q J R Z;G
L K W A Z Y H S T | Z L S H Y A T W;K
L M G A V I E O R | L R V I M O A G;E
R Y U I M P J O V | P U J M V O R I;Y
A C Y W X T J O R | X C J W R Y A T;O
E C G O J K Y M V | J Y K O E M G V;C
L W N F V J Z H D | N V H Z W F J L;D
Y H W E M L D Q N | M Y D E N Q L H;W
I H S C U W D Q N | U S H C N Q W I;D
C W B I E U A G J | C E I W U A J B;G
P E D Y C H X N V | D V H N P E C X;Y
G N L F C I P D T | P L C G D N F I;T
X L R W K J D T V | V R L T D J W K;X
G Z S N B R K H P | N P S H R Z G K;B
K J Y D Z Q U P G | J Z K U Q D G Y;P
V K U H Q C A B M | K Q C A M U V B;H
Z I D Y N W H B K | I Y D W K Z H N;B
V T N M H P E D X | H V P T X E M N;D
O I S X F P V A D | I A S X D V F P;O
X E W O K Y M A H | Y E H O M X K A;W
D I V P S Y M J K | M J Y K P D I S;V
Y Z S D T Q U F B | T Z Q S Y D B U;F
S A J Z I R N E G | I A R J N Z E S;G
K I O T H A R L P | I O A P L H K R;T
H Q B I C G P K W | C H G P I W K B;Q
H G J U Q E A L D | L E D G H U J A;Q
B C P T D Q U L A | T B C A P Q U L;D
Q E O Z G C Y T U | G Q Y E Z C U O;T
H A I O J F V N E | A H N E I V J F;O
A S Z R V D I X E | R X Z I S E A D;V
G Z A Q S I Y E O | Y G I S Z E O Q;A
Q H O Y B U A G P | B G A Y P Q U O;H
R C E K X N I W M | K N W I E X C M;R
O M E F N J U H Y | E F M H Y U N J;O
F C G Y L T D Z P | G F D T P Y C Z;L
Y X W R S T I U F | T S R I X U Y F;W
R K X Q B M J T Y | Q T J Y M X K R;B
G L U Q X J R V E | Q L J X R U V E;G
N G S C R A O F K | K O A G S C R N;F
O N J C I G D S A | N C O A J I G S;D
C N M F A V Y W B | C F V A N Y B M;W
C O D X I Z S R P | O I C X S P Z D;R
V H Q U R X E G S | X E R U Q S G V;H
W F A C H K P R I | P I K W F C H A;R
R O D Y K Q J E M | D J R O Y Q M K;E
R V Y A P S N H G | N V R S Y P H A;G
U E Z M R Y L X V | R X E V Y U Z M;L
Z O L M G Y J B C | B Y J L G M C Z;O
Y O A B W V E J P | J O P W E B Y V;A
G C U A D K E T O | D C U O T K G A;E
G C U R Y A L V Z | U Z A G Y V R L;C
V M O X G B Z P E | M P V X O E Z G;B
O L D Q H Y A K F | D A Q O K F H Y;L
D E V P B S W O F | O V E B S F P D;W
Q P B F V A S I K | P K I B A Q F V;S
A B P T L E Z H S | S E P Z H B A L;T
X M G A J F D N Z | D A F G N M J Z;X
T X A R N H S Y W | A W N S R X T Y;H
Y A D V I X P Z S | I X S A Y Z V D;P
M J S T D X H Y A | M S J D X Y A H;T
T D R W X K E I J | W J K I X D T E;R
D X O M G S A N J | O D J X A M G S;N
M T W U I B R S A | T R B U M S I A;W
I C U Q Y X H W J | Y U H Q X W I J;C
Y O I V F G P N H | Y N V G F O I P;H
K V G S M W D B N | S B K M W V N D;G
W T R A M G C Q Z | Q Z R G M C A T;W
J K N L H T O D P | T N K H D J P L;O
I D L U V J F S Q | J Q D I S L U F;V
Q H N O J G F E Y | H Y O Q F J G E;N
D W Z G P I N B F | P F I W G B Z N;D
D Q R L T F K B H | K Q B H R D L F;T
H F P I X L D O A | A I P H X O L F;D
B E R D W K P F T | E T P D R B K F;W
M G D N Y U T K C | M N Y K U C G D;T
P N Y I M S G D V | D Y V M P N S G;I
T O U Q C W P S H | P W S O U C H T;Q
M U T D G N K L E | D T M G E L K N;U
I F B C T G P Q X | X B Q F C P T G;I
W S Q J N U Z D P | W Q U S Z J D N;P
Y H P Z X I W Q D | W Q D X Y Z I P;H
C L S N X Z G I D | X Z C G L S D I;N
U C W S I G L E F | L E F G U W I C;S
X L Z C K I A G Q | A X C I K Q Z L;G
K F Q T R I A L B | A F Q K B R T L;I
I Q K Z B C Y N T | N Y B C I K Q Z;T
S X J P O K Q G L | K Q L X P S O J;G
M L H A N E Y T O | H Y L E O T M A;N
Y Q M X N P K J A | P Q M N J A Y K;X
S V Z F B L I J Y | B J L Z Y V F S;I
T A Y I Z M S X G | X A Z Y I M T G;S
T D I F K R B C L | B T K F I L D R;C
S D M G U R J A K | U K J G R M S A;D
L Z W P J H T A R | P R L Z T H J A;W
W L K B V T O J F | T W B L O V F K;J
C O W N S B K Z F | K B O F S C N Z;W
Z Q H L C G B W P | H Z L P Q W C B;G
S T G X V Q U Y F | Q G F S U T V Y;X
S Z D A V L P I O | O I Z A S V L D;P
Z B X U F Y S G O | F Y O X Z S G B;U
S K L I D V N G T | G S V L D I K T;N
R B Y P I A X S Z | X B S A Y P Z R;I
H J L Y Q S E K W | Q Y E W S H J L;K
N C J E M S Q Y K | Q Y M C N J S K;E
I M F O G W Q B P | O Q B F P G W M;I
D U M C T G Q K P | C U Q P K T D G;M
L Z M K F B V A W | F M L V K A B W;Z
X G E N U S Z R P | X Z G S P U R E;N
L M K F D Z G R U | K L U Z G R F M;D
U G O X Z P B Y J | X U B J O P Y G;Z
K W A G Y F V J B | F J Y A G V B K;W
O M K S W G E H Y | G Y W S O E M H;K
U W I Q V B H Z P | H Q Z P I V W B;U
P N A O D T S X F | A X D P S O N T;F
G U A F W Z O B P | G A B P U F Z O;W
S W O J R P M Y Z | Y M J O P S Z W;R
L M X G Y T S A D | M L A G S X D Y;T
M C Q J S N R W Z | R J W Z M Q C N;S
P Y A V C B O Z U | C V Z U P A O Y;B
F Q L Y J A X R I | L R Q J Y F A X;I
K W P S I C B U A | W C B U I A K S;P
Q U G E R O X J F | F U J E Q X R O;G
P I N O M G B X H | P M G O N H X I;B
H A K O T P C V U | C P H V T O A U;K
T Y W F O X U S J | F U J O X Y T W;S
C P O L U V K I J | I K L C U J P O;V
U G A W Q O F J E | A J Q G W U O E;F
H B C O T L J K D | T C K D H O L J;B
G V Z R B A O Y K | O Y K G V Z R A;B
K R F I M T Z W X | K I F R Z M T X;W
U S Q Y G W P V J | J G V W S Q Y U;P
H M C I N P Y B S | H Y C B M I P N;S
B Z F R V E M Q U | R Z E F B U M Q;V
B C E D Q Y K O P | Y E O C D K B Q;P
I O M X P Q G Y U | G Q X O U P Y I;M
Q G N D F X Z I L | Z F N Q D I L G;X
Q D U S Y I T E W | U I W Q D T S Y;E
A W R D K L P U Q | U L Q P W R K D;A
X F C O L E I A D | I X L F A E O D;C
Z H U C A G D B M | H D B C M Z U G;A
E Z C T B R X F P | C B R P F T E Z;X
O M Y T X Q B D N | Y N Q B T M O D;X
O V D Z G E J W P | Z W P E D J G O;V
G Q D K L A H N F | H A D N Q G K L;F
U Q H P V R B C A | H P C B U R V A;Q
V A Y T M D N E F | M Y V T D N F E;A
Z M W S R G L C V | C M L G R V Z W;S
N P F Q Y O I W H | P W I F Y N H Q;O
U S X A C W R H L | S X L R H C U W;A
J Y B Z D A T W I | Y B D Z W T A J;I
R W X A G D S J O | S X A O D R G J;W
L F X Q N T M A G | F N T M G Q X L;A
C Q D R I B T H V | T H R Q I D B C;V
E L C I M R W S V | W C V L I M R S;E
U M D A T C X Q R | C U Q M A T D R;X
K D R Z S O L C W | R O S W L Z D K;C
B X H M W E C P K | K M C X E B W H;P
P B X M H Y J D Z | M Y J X D Z B H;P
U M Y G X J H C W | G X J W M C Y H;U
N T E G D Q A K B | T E A B K Q G D;N
J G V O R Z P C X | P O V C J Z R G;X
N O I Q B A V K S | S V B A N K O Q;I
H E I V K X F Q Y | Q I X E V H Y K;F
J Q T W B O F U L | O F L B J Q U T;W
K I T Z H A Y R G | K Y T I R A H G;Z
V I P M X T R Y J | T Y V X P R I M;J
Q R G D J P X I U | I X R G D Q J P;U
Y X N C M U W A T | W X N T M A U C;Y
U P S Y G O A J B | U O Y J P S G A;B
R H A N J F C B G | N H J G F R C A;B
J L S G Q W N D I | N W Q D S L I G;J
J Q O S I B H N X | O H I B S X Q J;N
O C E P X V M A Y | P M E X O Y C V;A
X U V F A P D M W | U V W D P A M X;F
M H X U Y D F I G | G X M H I U Y F;D
S C K P J F D T H | H K D C F S P J;T
J S R N D O Q T F | Q T N O S R J D;F
E N G D Y B S U K | D G Y N E S U B;K
H F T N P I E M J | M I N H J F T P;E
Y A S O P H E L M | S A H L Y E O P;M
Z K J V D B Y E A | B K J V A D E Z;Y
G D Y H X N W U I | U N X D H Y G I;W
K J O G V N L M P | J P N G M O V K;L
A E F Q T R S K O | S T Q O R A E K;F
V J C M X U O G Y | U G M V C Y X J;O
I C P G S X F D V | I X V D F S G C;P
I R L S F Y K W N | L I Y R N S W K;F
T M P K V N H Q J | K P J Q N M V T;H
S D Y B V G F W U | G S W D B U V Y;F
X H Z G Y O K W T | W Z K G O T H X;Y
J Z I Y C B K W H | H J Z K B C I Y;W
Q D F P N X V T S | D Q F S T V P N;X
M G H Z J X S F E | S H M Z X G E J;F
V R O A D P U F E | R E D V F P U O;A
Y E J D S P Q G O | E G O Q J D Y S;P
M Q C T E I N B Z | N Q I C T B E M;Z
F T L P N E B I K | I K N B E F P L;T
I F B R D J E T V | E I R D J V T B;F
K G N Q Y B T X Z | Q Y X G K N T B;Z
I Z S V W E O Y Q | W Q Y S I O Z E;V
J B S Y M V D U G | B V M G D S J U;Y
X A R E M J Q H Z | Q X A E Z R M J;H
M X F T S W H B Y | S Y M B T W F H;X
F O R Z H C U W S | U W S C H Z R O;F
G E R J X S Q C A | A C G R Q X S E;J
S X G Z Q E V J Y | X Y G Q V E S Z;J
J B D O N U I P M | I M O B J N D U;P
T R D G Q Z X A C | X A D C R G Z T;Q
J M E B Z V L K W | W M K V B Z L J;E
O X K A Y I D T Q | Y D I O Q X A T;K
G R N L J S H Y C | C L Y N G H S R;J
L M H A I Y O D B | B L H M O I A D;Y
D H C Q N O U P V | C Q V H N O P D;U
L N B I O F E U Z | I Z B E F N O L;U
A E O H F N U Z G | F N Z H O A E G;U
Q L T G J K U Y A | G K J Q U T Y L;A
U T C E N K O M H | H E U C T K O N;M
S D Y R H B J Q X | D J Q X Y H B S;R
N U S H E F Z D C | E D N F C Z U H;S
R S U K C P X G I | U X I K R G S C;P
I W O J X E U M A | J I O W A M E U;X
F T Z L E X K I R | R I L F E X T K;Z
G Y D K Z U L Q P | K Q P Z G U D L;Y
H M Y F A J S R E | F M J Y R H S A;E
K V U Q I G A O E | U I Q V E G A K;O
N Z E G Y F T V P | Z N Y V G E P T;F
C R K X W S T Q J | R X Q J W T C S;K
R P H E Q U I V L | E U P L I V R Q;H
R C Y E O T S A V | E T A C O V Y R;S
X Y Q V U W I Z H | Z Y X W V U Q H;I
J L K N H Z V A D | V A K H L D J Z;N
C J U B D Q X S A | C B D J U Q X A;S
E J I A L Q M X F | X L J M I F A Q;E
V J A C E P L S F | L P S E F C V J;A
W G I K Z O X M E | I X Z M G W O E;K
L I V A R K X F M | M L F R V K X I;A
V A E X U I M W G | X U G W V I M E;A
Z G Q O M H E F U | Q G Z F E M H U;O
P D U Q X H Y M C | D H P Y U Q M C;X
Q G P M Y I N U J | P U N M G J Y I;Q
N C R E S Y G V H | V C Y H G S R E;N
K R O D T E L M F | L K F M O E R T;D
U G D J I S A P X | G D I U J X P A;S
A D U L W R M V S | W U A V D L M S;R
K R S X G M C I A | X M R K G I S C;A
H B L O T D R E W | T L E R D B H W;O
R D S M C W U F I | U M R W D S C F;I
O Y F S V E Z L C | L E Z Y C S V O;F
I M W X Y R K L C | K I X C R W Y L;M
N L I J A G C U R | U C I A J N R G;L
A X P F N T R L Q | L N Q T P F A X;R
A X E K D I U V G | G D V I U A E K;X
E U A R Z S M Y K | Y S K A U E Z M;R
A C S I H B K Z F | I H C K A S Z F;B
M H G O X S Y Q T | X M O Y G T H Q;S
P H L B E O Z X F | E O X P L B F Z;H
R H L G Z U A D X | H X G Z R L A U;D
C Z E O K U V J G | C J O E V G K Z;U
D Y P B E G F K V | Y P B G F K D E;V
E P W F T D L I Z | P L E I Z F W T;D
K D A P L Y T M B | T K B L M P A D;Y
A P I K M H G Y Z | Z M K P I A Y G;H
Q C M K I B P X Z | I B Z P Q M K X;C
R V C W L O J Z M | Z M O W L J C V;R
B Z K F G E S P D | P E G S K Z B D;F
F D S Y X Z K U H | D K Z F H X U S;Y
K Z W R M V C I O | K W Z O C I R M;V
V C R B J I A X L | L C V A B I X R;J
J M G V R N H U X | H U N V R M X J;G
F V Q P T C D I M | F V M D I P Q C;T
L M Q R X V H K I | Q H I X R L M K;V
H Z Q E J R Y M W | J Y H M Z W R E;Q
M W G Q R D Y V T | V R M D Q Y W G;T
U P D Z W G Q X T | W P D Q T X G Z;U
Z O F U G E T Y Q | Y E F G O T U Q;Z
A K F Z I X W H Y | Y K I W H F X Z;A
J Y E G L W Q F U | E W J G L Q F Y;U
I U K Q D T H M Y | Y U I D T M H K;Q
T U H F R S I Y M | I R U F S M T Y;H
S K T P J D O G U | J T S P O U D K;G
C V S P K Y O Z A | K O Y S V P C Z;A
F H P W X J R V U | U V F X W J P H;R
O C E J K Y B L W | C Y J B L K O W;E
S I Y U M H F Z X | U M F Z S I H Y;X
Z W X F K O A S B | W O X K S A Z B;F
T D X V U S H W Z | V Z T U W X S H;D
S G H U Z F L D J | H G L F U D S Z;J
N T U W S F C B P | B S N P T W F U;C
F I C T G Y A Z P | P C G Y F A Z T;I
M J P V G Q N B S | Q M B G S P J N;V
O S Q M U N A H B | A B Q S U N M H;O
F G J P V Q C W R | Q R V G C P F W;J
R Z I V K F G B U | R I K V F U B G;Z
V A K L T H Z R B | B A T H R L Z V;K
T Z U O I V M Q Y | M Q I Z U T Y V;O
L R N P O G Q W J | O R W N Q J L P;G
E R M U V S B K I | K U S I V E B R;M
H C U V W K Y R X | K C R Y W V U H;X
G B P F J V O T L | P B T J O V F G;L
S D W L N I H M F | F W D N S L H I;M
L O M T E J G N D | M O E G J D L T;N
D S J L X R H B M | S R D B X H M J;L
Z R Q F O D L A T | L A R F D T Q O;Z
N S K V L P J Z E | Z J N S V P E K;L
I D X Q B R U N V | X Q N B V R D U;I
D K V L P W X M Z | D W P K Z M L X;V
T M C L F I V W E | M I C F L V T W;E
W N P X B Q L U Y | Q L W Y U N X P;B
D Y E N U J H T W | U W Y J N H E T;D
L Z Q R N A O Y G | O L Y R N Z Q A;G
F T X B O Z U L I | Z O I L B X U F;T
Q Z Y H M K W V F | H K Q Z F M V Y;W
Y C E I W S M U D | S U Y D M C W I;E
J N M I T R P V F | M P I N T V R J;F
F G Z E K J W V H | F J G K H E Z V;W
H E A O Q W N F S | O H S N E F A Q;W
Z Y P F A K J M N | F N K Z J Y P A;M
S V F M Y O G B K | O V F M S K Y B;G
Y G U H Z V B D R | Z U B G V Y R H;D
H D P O E F U K C | H D C O E F K P;U
Y Q T M V N L P I | P V L N I M T Q;Y
V W I A T J C O Q | O Q V W A T C I;J
Z V I F Y T E B M | F Y T V Z M E B;I
J Y V B F P W A U | V F A P Y U J W;B
T X C O M W G Y D | T D M G Y X O W;C
P J D C L N H Y U | C N U H J D P Y;L
I W H K T Y R F V | K Y T W I H F R;V
K S B Z F J E W O | O F J B K Z E S;W
T V U J A C G H D | D T H J G C V U;A
P S O X B Y A U T | T B S Y X A O P;U
E D I S X U Q K G | X U K Q I D S E;G
N O H D I Q R Z Y | H Y O D R Z Q N;I
X F H C E R D A O | X H R F C E A O;D
P A U S R W E C G | U G S P W C E R;A
J Q V S D I B R H | H B D Q V J R I;S
W U N F B E R K Z | N W B F U Z K R;E
C J H F Q K L D R | H J K D C Q F R;L
D O V F K A B R L | B D F L V O R A;K
C T S V M O Q P N | N P Q V O T S C;M
W A R S U L Q Y H | L H Y Q R A W U;S
V E R Y I U Z T X | V E I X T R Y U;Z
J M X I P A U T F | U J A I M F X T;P
D F Z B E J Q N H | B D J F Q N Z H;E
J Z P U B D Y I O | O P Y B J Z D I;U
S E B U O J Q T F | F S E T O B U Q;J
P E B I H N J V O | I P J B N E H V;O
O A Q X Y E V J G | X E Q J G O A Y;V
S Q A P Y G M V J | Y G V M Q S P A;J
B Z T K S I P D N | B N T P I S Z K;D
P J K O T R X L U | R U K J L X P T;O
W B D A Q U J T S | T Q W B U S D A;J
W Z A P Y J T G K | Z W Y T A P K J;G
A Y K W M J N C B | C M K N W Y J B;A
R L A D B C Q O G | O L A G R C B Q;D
R S W A I O J C V | I O C S W J R V;A
X Y V P O K B Q U | U V X B Y P O K;Q
K T H U E Q I F C | C K H Q E U F I;T
R U C M K A J X Y | U Y C K X J M R;A
L A Z Y G M I J P | P A J Z L Y G I;M
V S T P U W N A X | A T U P W X V S;N
V B S Q U T J F O | U O V T Q S B F;J
W C I Z L B Y S H | W Y I C L B S Z;H
F L H X Y N E U T | L T U Y N X E F;H
Z I H M Y J G P U | J Z M I P G U H;Y
S G L A P C N F E | L F C S N E G P;A
J N V L M D E W G | E V J D N L M W;G
L A U Z O K P T D | L U Z O T P K A;D
R Q Z N E X C U S | C X U N R Q S Z;E
B C X O I E Z W K | K X W I Z E B C;O
Q L X H K E Y A G | Y E G L K A H X;Q
N W G H M D T S B | M D S H W N G B;T
M K B Y C G F Z P | Y Z B G M F C K;P
X I S V N E H T Y | I S Y T X V N H;E
P T G F L S N J B | S J G L T N P B;F
Z E D S T P F U I | S T E F P I Z D;U
W I M Z Q R N X K | M K Z Q I R X W;N
O Z A P N I V B Y | O Z A N I P B V;Y
J P S G M K B I O | O K P J B S I G;M
B I H Y X O E S W | I Y X B W S O E;H
G I U S H N M E O | G I O M H U N S;E
D X E A H I L G Y | E L A Y D X G I;H
V U K S R Z X T D | T Z K X U S V R;D
D P K N U B F Y E | K E F D N U Y B;P
V P B R O C Z Q L | C P R Z Q V O L;B
G M W F B D N L O | L N G F B M O D;W
T V D L J R P G W | W V D J T L R G;P
X U G S I R Y E A | R A S I X G E U;Y
P G B N K W Q U J | K N G J W Q B P;U
K T P X A N Z E Q | P K N T X A Q Z;E
C I X L W B D K M | L W C X I B M K;D
R B A J T K S G F | S B F A T G K J;R
L Z B H M U G F A | U A M F B L H G;Z
T C F K S Z A J D | J F C A Z S K T;D
T C G R N Y B O X | N C G O T Y X B;R
R P C J I Z D E N | D C P J I E N Z;R
W U Q K H B Z R S | R S H U Z K B W;Q
I T H R U W K B G | U K I R H W G T;B
J K M N Z T S B V | K B Z M T S J V;N
I W N Z Q O P U J | W I O N P Z Q J;U
K X C S U E H M I | E C S U I H M X;K
P U L K T C I Z N | T N Z P C K L I;U
Z Q W C M O P T D | W Q P O M T Z C;D
I Y K Z G E F X P | K I Z E G X P Y;F
J M Y T E B R W U | B M W T J Y R E;U
K Z V D S Q M C O | Z C Q K V S D O;M
D Y X Q E A C L S | S Y E D L X A C;Q
U X V R B D S W P | D W P X B V U S;R
W V G K H Z F U O | F V U W Z G K O;H
W O U A P G N V K | W V A O G K U N;P
R E H X P Y N A T | P A Y R E T X N;H
L D V B R O Z K W | L V O B R D W Z;K
F K W O T X Y P I | K T O X Y I F P;W
L K O Q S N B J D | N S L K D Q O J;B
F A D H Q R G U Y | Y F U Q G H R D;A
D Z E T W A G I K | A D T E I G K W;Z
P T M S W H Y B N | P H T M W Y S N;B
X T N K L D S Z F | D N L T X F S K;Z
Z M F S I P K L G | K P S L M F Z I;G
N L Z Q U D O T J | Z Q D U T L O N;J
C H D V Q Y U A Z | Q A H U D C Z Y;V
H R Z U X T G P E | T U Z G X P R H;E
A X R H K S Y Q U | Q R S K U A H X;Y
M W A U C Q H G V | A M H G V C U Q;W
C P S Q W R X F G | C X G R S F Q P;W
C O B R X H M S F | R S M C X H O F;B
S L A D N K H T V | S A D N K H V T;L
M N B E C V X D A | N D V E B X C A;M
M F H X P S D E O | H M X P S F E D;O
B X W Z N E L V M | X B Z L V W E M;N
P X Y G T S N V K | V X P Y K T S N;G
C N G E Q L Y M Z | Q C N L M Y G Z;E
M C L E Y T S O W | M C Y W T O E L;S
R A L P J I H M O | J L M H P O R A;I
C P T S W M K I Z | I K W C Z P S M;T
X R Q G H K C T O | C G Q X R O H T;K
E U L I Z D Y A J | Y E A U Z L D J;I
N M C S H T D B V | N H B D S V T M;C
J G N K I V T B Y | K N V J I T Y B;G
D K J F Y V P B I | Y V D J F B I P;K
P F A Z W J G X D | F Z W X P D J G;A
R E L B A Y I N Q | L E Q N B A Y I;R
K E B F N Y A D L | D F L Y A E N B;K
M W S H I K A Q Z | Z W K S M I A Q;H
Q T C H J S O D N | O N J C H T S Q;D
Z K S R N A O P D | N Z A P D K R O;S
O C W Y N E Q A Z | O Y C W E A Z N;Q
I F R Y P E H O D | F O Y I D P H E;R
L N R X V Z D A H | H Z D X L N V A;R
I R Q F H V Z L C | Z F R V H I Q C;L
S T D C V U N K Y | V S C D T U Y N;K
G F K B U L I V P | L I B G K P U F;V
P N Y B V X Q F K | K P V Q Y X B N;F
E U P V K M J B S | V B E P U K M S;J
R S I C B D X A N | A S I C B D R X;N
E F H N Y V W Q D | D H W N V F Q Y;E
L F H D A J P K Z | J P A K L F H Z;D
G Q Y I C B O L J | I Y J L B Q C G;O
D G I B C R N S Y | N R I G D Y C S;B
Q E L T Z W A P F | W P T L Z A F Q;E
H M Y O F Z G J V | G V F M Z H J Y;O
O X S T G Z F W U | S G O Z U T X F;W
N I U K M V G D Z | I G D V K Z M U;N
M S L I P N D O B | O S P N L B I D;M
I M K P Z H O R N | I P Z O K M R H;N
W L U I D G P N X | N U W G D L I P;X
C D X K G Y R A W | K C Y X W D R G;A
F A T L Z P J B S | F P Z J B L S A;T
O W I T U E F Q Y | F Y W T I O U E;Q
G I F K M D U X J | J D F G U K M X;I
R L Z C O S I M X | L Z M O S X R C;I
J K T N V Y S R F | V R N F T K J S;Y
B L T D U P J K M | B U T P D J M L;K
G H D U P Y O Q K | U Q Y K H D P G;O
Q C Z H W V U K G | C W Z V H K U G;Q
X J L F R U S I C | F J I R U C S X;L
S G A H X U F W Q | H W S A G Q X F;U
U I S O Y Q C K F | I Y F S Q U O K;C
U M V Y Z Q H N T | N H U Z V M Q Y;T
Z X A O C N V I K | V O Z I K C X A;N
A G Y Q B M R I F | I R G Q Y A M F;B
A P Y X D M R W E | R P W D X A Y E;M
K J L D F U E P X | J L K X F U D P;E
Q L S R C A M Y X | Y Q S R A M X L;C
P R F X I V Y L S | P Y X V I F L S;R
A M D X Y F K V L | V D A Y F M K L;X
D Q V K W E U B C | D E C W K Q U V;B
U Y Q W A C M S P | Q C A W M U Y P;S
D S O Z T U R H F | R H Z U F O D S;T
C V D R G E B J L | L G V R C J D B;E
Y N X D J I W T A | X D W Y I J A N;T
S P R J O T U K X | O K P R T U X J;S
A P C M N U G K H | A G K N C P M H;U
L T K C Y B W R F | L R F Y C K W B;T
W M H F O K L U T | M H L U F K O W;T
C F D K N X I P U | C N F P U I X K;D
U O S X Z V C N R | X S C O R N Z U;V
F W K X I D C M J | J F W M C K I D;X
W B Z I O L E G T | L O Z E B G I T;W
J G P M O D A R E | O A J M G D P R;E
R L K Y Z O I E S | S R K Y E Z O L;I
Q C Y S U R I H X | Q X Y C I U R H;S
A B N H I Y X E M | Y A H I X E B N;M
E T B Y H U N K Q | T H N K B E Y Q;U
R G I X J C H O B | B H G X R O J I;C
Q W J B Y R E F C | B F Y Q R E J C;W
Z B S M F Q D W U | S Z B Q U M W F;D
S E N Q V Y J X O | X Y J S N E O Q;V
J X W G D A C S T | W G J D X A C T;S
B M N W C S P T J | J C W T N B S M;P
S A U Q V O Y N D | V Y D O S A N Q;U
Z Q O C U L Y P E | L Y Q U O E P Z;C
H C W N Z X K B I | B N C I X K H Z;W
F O D Z I X R V U | V F U D O Z R X;I
P D I V G J W O S | O D S W G J P V;I
Q P W B E G F D C | D Q W C B F G P;E
L E M D U Q N I P | Q D E N P M L U;I
S L N U B Q Y P F | L P Q F Y N U B;S
B T Y Z N J P W L | Y T L W J N Z P;B
D J T X U B K M R | J X R T U M D K;B
R F N L E P H V I | H V E I R N L P;F
N F X Z T R A M E | X F Z N R E M A;T
L S H Z M B Y R G | Z S Y R B M G L;H
R D G S K C H Q Y | Q D C S H Y G R;K
J V I O C Q T H F | I Q O T J C V F;H
A U V B Q F O Z G | U A Q O G V B Z;F
I B X C Y E V S A | A Y S I B C V E;X
A U J G K V R C I | C U V A K G J I;R
Z W V H F P Y T L | L T Y Z V P H W;F
U N F K I O X P M | F U I O N M K P;X
L G I S Z Y O K M | S L K Y O Z I M;G
S N O P H Z G U T | H N P O Z S G T;U
P Z V Q I R K S E | K R P V E I Q Z;S
D P S R H W Y A N | A W S H N Y R D;P
F P Z J B K M D V | B M P V K D F J;Z
Q A G L R Z X K P | R Z G P K Q A X;L
V P F L Q W J O I | W V Q O L I J F;P
N Z W I O B K L J | B W L K N O Z I;J
L S Y J T D H G I | D J G Y S T H L;I
K D M L Q E C S O | O S L C E Q K D;M
M Z U H A Y W R Q | Q M U W A Z R H;Y
M A V H P B Z C L | H M A P Z V L C;B
H O Q T Z B C Y S | C Y O Z T H S B;Q
L N K X W J E R P | L E K P X N J R;W
W N U M G L E B O | G M B E W L O U;N
S Y E A J Q R K G | Q G S A E R K Y;J
K G X Q N B T E S | X E T G Q B N S;K
S E P N L Z W M U | W L P N Z U E M;S
P M I Q X L A G D | L I D G X M Q A;P
R Q U V T H B D F | V R Q D H U B F;T
C W F K D S Z R E | R F Z W C K S E;D
F U S X I P O G E | E I P G X S U F;O
H C D Z K A S M J | D C H J S Z M K;A
C L R G K I N W U | U I C L G N R W;K
R O V L H K E T J | L H E R K T V J;O
C X O K Z S M L D | L S C O Z D M X;K
M V U S O Y L J Q | U J O S Q V M L;Y
B P R G E N X J Q | J P E R Q B N X;G
Z U L M O E I V R | O L U M V E Z R;I
W V K M D E J Q A | J E W K M Q D A;V
V K S J G F R M E | S J G V K R M F;E
V Z X W N Y R K G | K W V R Y Z G X;N
H G V I Z W B Q S | S G Z W B Q I V;H
A H I E X B M J R | M I J A E H R B;X
B U E G V A D F K | V B F E U K D G;A
C Z J W T Q U A H | C H A U J T Z Q;W
V S Q I H N Z L T | V L H N Q T Z I;S
G A I H Z Q E O L | G H E I Q A Z L;O
C A V F E Z W L J | J V Z F A W E L;C
M N R V C G D J E | V G D E J M N R;C
W Y P R D E H Z M | Y P E H M D Z R;W
U W L A S D N Z E | U E N A D L W S;Z
J G C U I V F B S | C J F B I U G S;V
L B T H O F P J M | F L B M P J O T;H
Z Q A H P W X R K | H X R A Z Q K P;W
I L F U D Y X P O | D P X U I F Y O;L
I Z S R V L W G E | E G S W Z V L R;I
P M W D S R Z I N | N I S Z D R W P;M
E Y F A K O S H P | O H S A E F K P;Y
C D S L E X B M A | B A X M S D C L;E
K T U P F Y W O V | W F T K U O P V;Y
X Q H F P R S K L | Q K F L H X R S;P
N K M S J A T X L | N J L S T A M X;K
U L A V W C S R D | U L W C S D R V;A
O U H E W V S L K | H W V U L K S E;O
Y Q L G M K H B I | G B Y H Q I M L;K
T G A B N Q V Z X | Z G T B Q V A X;N
O D W J B X L T Y | Y J X L W T B O;D
Q Y F T D Z R L A | T D F R Q Z A Y;L
Y F W T I O N A C | F O T I A W N C;Y
U T R H J A I M B | H R T J A M B U;I
H C Y G X D O F B | O X F D Y B G C;H
K J M X Z I A U D | Z U I K X A D M;J
T I C A M Q B O W | C M B O W A I Q;T
I W C T O F Z L M | Z F M C T O W L;I
Q M T J A X H O S | T H M J S O Q A;X
G B D Y Z M E A V | V G B D A M Y E;Z
X O I V N P L R S | N V R O S I P X;L
U K P O D A Q F W | O A D K P F Q U;W
C F W U Y S L O K | O F C L K S U W;Y
D L I N W U T P Q | D W L U I Q P N;T
N J A O Q M F S T | O M N T S F J Q;A
V G K P S Z N Q W | Q S N Z G P V K;W
Z K H T J G E B W | Z J W B K T H G;E
S N I Z K L P C W | K P L W Z C N S;I
H Q C Y R N Z X K | N R X Y K Q C Z;H
U W P R F Q V E I | R Q F I E P U V;W
H G N V T L K W A | V W G L K H T N;A
Z A W H I O B M E | O H B A I Z W M;E
U F Q O S C V A H | A V Q F U O S C;H
G V M J D E F H T | T J F E D H V M;G
Q L W M K E J Y C | L K W E Q C M J;Y
K I E N V C D X A | E N X A D I C K;V
E V D K Q O N U F | E D Q F V N K O;U
D G Y B F K E O A | D E A Y K F G O;B
V Y N L P O G I M | V Y P L M I G O;N
K J M B E Y R U O | M U J K B Y O E;R
A C S F J P T X O | O X P C F T S J;A
X D E G V L K J T | G J V X T K L D;E
B N W R M G V Q Z | W M Q R B N G Z;V
E W S U Y Q M G I | W U E Y G I Q M;S
A P X R L T C Z D | X A C D R T P Z;L
K G W L V U S A I | K L U G A W I V;S
Y N J B P K S W I | I J Y S B K N P;W
J O Z U Y D I X R | I Y X O R U Z J;D
Y D B G P F C S X | S B Y X D C G F;P
J K H C G B O W L | B G W L H J O K;C
W S X P G A Y J I | I P Y W X G S A;J
X K Y S Z R D V T | Z R T Y X K S V;D
K G V Z H N E L S | N S H Z L E G V;K
R T X M Q P E B Y | B X Y T Q E P R;M
Z R B O E S A U F | B F O R U E S A;Z
M P N Z H A D F Y | H Z D M P N F A;Y
C T I M V L K Y S | S V L T Y K I C;M
L S Y I H E D G Z | I S G Y H Z L D;E
Z P O J H R B A U | O U H R J A B P;Z
N O A F W I R K C | W N O K F C R A;I
U Z I A M O W Q X | X A M I W U Z Q;O
M X Q O B C L S F | M X C F O Q S B;L
E B R U J K X Y S | B X E K R U Y S;J
H L Z W O M R P V | O Z P L W M R H;V
T K N D Q G B R J | R D T J G B Q N;K
P B G S F K R H O | S O K G P H B R;F
K V Q C H E N L B | B Q C K H V N L;E
I U R Z P T D W C | I T C P R Z W U;D
D U F G Q J N T P | J T F N G D Q U;P
D U G X F L T P Z | D L Z F U P X G;T
H R N W Q Z C V A | Q V N C W R A Z;H
B G Q A F K Z H D | D Q B H A Z G F;K
Z T I R H W D Q J | Z W J R Q T H I;D
Z N B K A H F W E | F Z N K B W E H;A
I H T F J P N E V | I P H N V T F E;J
C H Q A S F W U X | S C A Q X U H W;F
V J A W H D P R L | W L V A D J R H;P
Y F E H N T Q L G | N E L T Q Y G H;F
F T E U R Y X V A | Y F U E V R A T;X
T O P Y J M B X K | T O J K B Y X M;P
T S B H W M K O D | H O B M S D K T;W
Z E U H Y S L R N | L E U H S N Z Y;R
B R W Q J D U K T | U T K W B D Q J;R
C V W J P S H L Q | C V P S J L W H;Q
A P U Y V T Q F H | P F U A V H T Y;Q
K L Z R S U O B A | R B A S L K Z U;O
Q J X N M P A U D | D P U N Q M X A;J
U D I X N C L P M | C N L P U M X D;I
W M E L H G I C Y | M W I C G H E L;Y
D Y A S G N C K O | G S C D K A O N;Y
C N G S T I Y Q X | I C G Y Q T X S;N
P M S G X A U K O | X U A S G P M O;K
Q T S I B D Z C Y | B S Q C D I Z Y;T
P H K U D N G F X | H P F D N X G U;K
W N T G Q B R J O | N O G R J W Q T;B
A V S Y N B M I D | A V I D Y N M B;S
I C Z X M W A R L | W C M X A I L R;Z
N Z X Q U G P H S | H X U N S Q P G;Z
P H I Z G A L N C | N P L Z A H I C;G
D M I P Y X O J N | N M J O D I X Y;P
L J F X W D B Q U | B U W F X Q L D;J
L N M Z W P F V T | V N L Z T P M F;W
X C H M R K G V B | G B H M R C X V;K
P Y B F U J D T V | D B P F T V J U;Y
E D M Y N P X O K | O P D E N K M Y;X
U Z A C B T Q D V | Z Q V C D B A T;U
L V B X E P M Z W | X B Z E V W M L;P
T D B X C N G J F | J X C D N G T B;F
J G R C V A H K P | J C V K R P A H;G
D K A V O P I Q X | D V P A Q X K O;I
L O U K A P F T J | U P K O T L J A;F
G X V O B D K T Y | D T G B O K Y V;X
G J U B C L V X D | C B X G V L D J;U
I W J N A D H V Z | W D H V A I N Z;J
Z G B V T E P U Y | U G Z E Y P V T;B
Q O K L J G C U Y | G J K Y C U O Q;L
H K V G P D C O Y | V P D K G Y C H;O
L Q N E I V S B R | L V B Q I S N R;E
H L Q J X Z O P S | S O Z J X P H L;Q
V W K D Q B G P Y | P Y K V Q B G W;D
I L C Z W E U T J | J E I C T U W Z;L
I G W U S H J E L | G J I E H L U W;S
W U B P G Z M N T | Z P U N B T W G;M
U O K H W B F Z T | T O K W H B F Z;U
Q U F M T J P K O | O U K M T P F J;Q
O H X P E K Z U V | P X E U Z V O H;K
H G E V D T L S B | T G B S V L H E;D
V P G E U I C N F | P I N G V C F E;U
Z K V J D T C U I | I T Z K J D V C;U
V U E Z M C F X A | C V E Z F X A U;M
B G C U F P H N T | U G F B T H N C;P
K H O F U J T I W | I F J T U W H O;K
R C O V E Q U S B | U B C S Q V E R;O
T F R E N W I B P | I W E F P R N B;T
F W C A V J O Q T | C V A J Q F W T;O
I H F E K Z G O W | I W K Z G E F H;O
A Y C R B V W M T | W A M V R Y C T;B
G J T E N M Q D I | E T N G J I Q M;D
W U C Y G Z O A P | O Y Z P A C G W;U
H R U D T A X Q O | X H A U Q O T R;D
X Z U Y R F E W T | R W E X T U F Y;Z
L C F Z Q N E G M | L Z E G F C M Q;N
M A H O F R X G J | F J R X G A M H;O
K U H L W D Y V Z | V H Z K U D L Y;W
U X O E T K W S Z | U T E K X O Z S;W
L R W N C J G H A | R N L C J A G H;W
V F Z J K N R A Q | J R F Q K A V N;Z
P I J Z M G C O L | G L J I P M O Z;C
X S P A Q K W Y Z | X A K S W Q P Z;Y
F H L Y T Z U R A | U Z L T R F A Y;H
F H J Z W M I N A | Z J M W H N A I;F
B E S M W K G I Z | Z K G I M S E B;W
A T K N V H X B D | T K D H A B N V;X
Q C X P N W Y L A | X L Q P C N A W;Y
K U G N M Y Z L X | K U G Z M X Y L;N
X N Q S M V P C T | P C V X S T N M;Q
G R A W L N H F S | G L W F S A R H;N
V Q D K R Z U M T | T K U Z M R D Q;V
K S G C X V I W R | C W X V G R K S;I
K Z F M P U N B Q | U K B F M P N Z;Q
X L F R D I Z W B | Z R W F I L D B;X
T I O R N Z E Q H | R N Z H T I Q O;E
D G P F V N T C W | T G N P D W V C;F
V L G Q E C R H X | G L E Q R H X C;V
J O R I L K T H B | O T L I J K B H;R
Z M J Q L K O A Y | O Z K Q Y M J L;A
E U A T W Q P G B | Q P B T U W E A;G
D H Z I X N E J S | N Z X E S J D I;H
G P D R T H F U I | G I H T F U P D;R
D Y H S A R M G V | R H M G S Y A D;V
M K O A U C N B X | N K U A X M B O;C
E N H D A U Y R T | Y R E U N H D A;T
R D V N A L M F O | O D L F V R M A;N
E U D Y Q Z T I B | U B I Z D Y E Q;T
Y A Z X E O B L P | X B Z O A P E Y;L
Q G K M A P H T W | G A Q P M K T W;H
Y I Z O E U Q A R | E U Q A I O Y Z;R
Y V P T E C K Z L | V T K Z L Y E C;P
V P B W K C R X M | P B X R K M C W;V
X Q V S R Z Y I D | Y R V D I S Z X;Q
C D J W A R U E Q | E Q A R D W U J;C
C S T Z W P F Y G | Y T P Z S F G W;C
B Y U K A N R F J | N U R K A Y B F;J
L Y T U E R Z A D | Z E L Y R T U A;D
Y Z G B A V K P X | Z B P G A X K Y;V
T C N W K Y X Q A | C A T K N Q Y W;X
W V K U J X E R C | K R J X C W E U;V
T Y O H G A P V K | H A V K O Y T P;G
S W F O Z P R Y A | P Y O Z R A W S;F
O E X T W L B Q K | Q O W L T X B E;K
G Y A C S D W R M | G S W C Y R M D;A
X Y J F B H L G W | F W X Y B L J G;H
C Z Q L T P M E U | Q L C P M Z T U;E
B A Y K H W R E T | H K B T Y A E R;W
X G A Y W J E B U | B J W E A G U Y;X
J W Z Y M C F V A | Y W J A C V Z F;M
A E T O Y B X D C | A Y D O E X T B;C
X N T G L J P Q O | X O J T P Q L N;G
C A L E J D W F K | J L C D K W F E;A
T X O U Y G M Z I | Y G T Z U I M X;O
N K D W H X Q B R | X N D H Q K R B;W
X K B Y S T D U P | U S P Y B K X T;D
M V X I D O S J Y | D I J S M Y O X;V
Y A X V N I K Q C | Y A K V I X Q C;N
N W Y S J T O P M | Y M N O P S J W;T
X G J B P N H A U | G H P B X U A N;J
Q E J N L Z F R D | N L D Q Z F E J;R
F Z V W P K L N G | N F L V Z W K G;P
C A K T F U D X W | C T W K U D A X;F
M R E U D Z B L C | B L C R Z M E D;U
Y N A R Q W I S T | A T N W S Q R Y;I
A K S T B G Q O H | H A Q K T G S B;O
Q D E W X B H I Z | I X Z D B Q W E;H
K L Y D A Q P S Z | Q D P Y K Z L A;S
N A G Z D W Y Q M | M G Z N W Y A Q;D
T Y O J Z R D F I | I Z D R O F Y J;T
Z G C O A J V X I | X C G I A J O Z;V
Q H I L D K G S X | K I L D G H Q X;S
C K Y P A M L I X | L P K A Y I X M;C
C Q G D V A W S T | D G S T Q V C W;A
T O D H A F S W X | T H A O S W D X;F
L Z F V P I G B O | G V I B Z F L P;O
L X I Q V J Y O D | V D L O X Y Q I;J
C D B X F O R L E | F E L R C O X B;D
U Z D H K A Y G O | Z O A G D H K U;Y
R D M A W Z T S V | R A T V S W D Z;M
L F Y B E A O P X | Y L B E X O P A;F
O Z T V Q R Y X G | G R Q V T O X Z;Y
N T E Z Q L U B J | N T E U L B Q Z;J
Q E L X A J V N S | V X J N L S Q E;A
F V B Q A Z U X E | E A Z F V U Q X;B
P O G V Y L D U A | D U G O Y L A P;V
V N O T Z K F E A | N V T F O E A K;Z
W S Z P A O J K Q | O S A Z W P Q K;J
G Z W J B V O R K | Z K V W O J G R;B
J E U T N P Z C B | J C T Z N P U E;B
C H O D R M E U B | U C D E R B M O;H
B W K P U I F R D | F D W I K U B P;R
C S Z I Q T A F X | I Q C T X S A F;Z
T C R O H E K Q Z | Z O K E T R H C;Q
S M G C L J E U I | L U S G J I C M;E
G V K U W A S R E | U G K E R S A W;V
L G E W K N D I M | L K N G D I M E;W
U P E Y Q C S J L | J C U E Q P S L;Y
G U I Q Y C A V N | G A I V Y U C Q;N
S Z A R P C T M L | P A R T M S L Z;C
B A W C R O J Q Y | Q A C Y J O B R;W
N W M B Q L Y I E | W N B L Y Q E M;I
J C L R I W G F K | W G C L I F R K;J
O A D N I F H P T | A T O I P N D F;H
D G P V N Y R O C | P C G N O V R D;Y
Y M P B W A C Q X | Q C P Y B X A W;M
G S Z L V E Q I T | S V Q L E Z I T;G
I A R Q H U N L K | H L Q R U N A K;I
A D V J K H L R P | L A P R J V D H;K
V W J E H A R T Q | W J Q R T V A H;E
F B Z Q U C P J V | V B U P C F Q J;Z
Y F Q N T V H R O | O H R N V Y F T;Q
M J B L G E Q A P | G J Q M L E P B;A
D S F G J U A M K | F A U D G K M J;S
F J U W T D G Q A | U Q D F W T J A;G
M H O J L Q Z F I | Q Z I O J M F L;H
S J T W D O M Y A | A M S Y J D W O;T
F K G B V W L D T | L K B W F D G V;T
P K I H T B V D J | P K V D I H B T;J
F M T I B N Y O L | B O I M N T Y F;L
F K P R T B C H E | K H T E B C F R;P
L D F T W Y B Q S | L D Y F S Q W T;B
M K U Z I A E T W | W U K T M I E A;Z
N F H W R V J S Y | V W H N Y F S J;R
U G P N I D R X V | P V R X N I U D;G
R C K G Z W X P E | R X P W C G K E;Z
U H O P A G Y E Z | H P Z Y O A G E;U
N V H E P J L A T | V T L N A P J H;E
B J D Q U C H F T | D C J F U B H Q;T
A I E N H Y U G P | A E G H I N P U;Y
Y X N F M R T L S | M F R N T X L S;Y
N D F L V Z C W I | D W I C L Z V F;N
T I P K F O Q H L | I O L K P H F T;Q
B W O N E T J I M | B E W O J T N I;M
O N C V X Z I T S | T Z C I N S V X;O
N R K I E J X P H | E H P I K R X N;J
O W R G B V A F C | G C O W A R F B;V
V T S Q Z U E F W | T V E U Z F Q W;S
T K W S B H M V O | H B K W V T O S;M
A E Q N L F Z J T | J Q F L E Z N T;A
U R N Z B Y H O V | H N R Z Y V O B;U
S I P H B T O Z M | Z P B I H S O M;T
D M K F C P V G T | G V C P K F T D;M
D M Z H U V G L O | O V U D L G H M;Z
X D L I C Q R P E | L C P Q I X R D;E
P H N Q C A U V X | Q V X C A U H N;P
R H S M V F C U K | M K S U H R F V;C
U O T D S E H Z B | Z U B S O D T H;E
W A T C J D L Y E | D J C W Y L T A;E
S P X N Q G B C J | G C P J N S B Q;X
G M J C X B E N K | J E B N X K M C;G
Z P S R I U A T D | I Z S U P R D T;A
O N W K C A X I G | K O W A C N G I;X
E A K H M C U S P | S P E A H C M K;U
L B S F T Z H R I | S R B H I F L T;Z
W G C L T B R Z M | L M G Z R B W C;T
E O R W M H V G U | R G M W H O U V;E
R U C S J D Q L N | N R U Q J L D S;C
E C M N S B P O K | C O B S M K P N;E
C X W D L O J V M | L D V W X O C M;J
A F G W E J T Y Q | Y W Q T E J A G;F
M O E J N B T X G | B O E M G J X N;T
K U V T B F H G L | H V K L F U B T;G
S O U Q E T Y N W | N T Q U W O S E;Y
M R S J H T V A U | V A S J T U H M;R
Y F I E D Q G V J | V J I F G E Y D;Q
F B K Y O C U A J | U B J Y F K A O;C
Y H U Z R D Q S N | R Y Z N U Q H S;D
V Q E G H K F O Y | Y H E O G V K Q;F
B S N K C Y E Q D | E N K Q S B C Y;D
C W D Q T H Z G S | Q G T Z W C D S;H
V W M S X E H P Z | X S H Z P W E V;M
E D M O Q G P A H | D O E M Q A G P;H
A L Z M U K P W Q | Z A W P K Q M U;L
Q N C E U A X Y J | U J Y E X C N Q;A
T L U K X S H Y M | K Y S H T L U X;M
A V L N E R C G K | A L E G V R C K;N
E Y B X M O H G I | B E I X O M H G;Y
O N U Q W B R E F | E W B R N O Q F;U
K P V Z E X W N M | P K Z V M N X E;W
P R B F V E A H O | H V A O F E R P;B
F N Y J L O U P V | L Y F P N J O U;V
U K O N S J Z B Q | N S O Z Q B J U;K
T D A C S Q Z K G | T D G C Z Q A K;S
V L J K I N H B Y | K I N L B Y H V;J
J C F Q U P K D N | D N P Q C J K F;U
E V Z D I G X P Y | G P Z Y E I X V;D
P R S Y D F W I X | R P D W F X Y S;I
P Z H X G U D J F | X D H G F Z P J;U
Q D T P Y W R J O | D R P Y W Q T O;J
S Y H C Q W I O V | W Q I H C Y S V;O
Q L Y D J C Z M A | Q A D C Z Y J M;L
H C Z A E R Q P N | R Q P C Z N A H;E
D T P R Q K J X E | Q X T P R K E J;D
R K E Q S D O V G | Q R K O V G S E;D
R F P D X Q V H E | P F V H Q E R X;D
P I M K D U Y F C | M Y U D F C K I;P
G A N H W O Q C T | T O H A C N Q G;W
A Y H V X N G M C | H X V Y A M N G;C
S P K C E F M U D | M K C S F P D U;E
C L J T U G P H B | G C U P T H B J;L
D G C T S I U V Y | S G C D T Y U V;I
G F V A Z O B Y P | B A P Y V F O G;Z
H L B Y A X W N T | L H T B A W Y X;N
X Z P A K Q W M E | Q P M A E K X W;Z
V E Z W J G U K B | E G V U Z K W B;J
W J P N G V T C R | W P R C V G N T;J
S U V K O D F J G | U S D O J F G V;K
K W E S M I O B F | I S K B W F M O;E
A V K U S C R Z L | Z A R L C K S U;V
V U Q M E I J Y T | T M Y U Q E V J;I
R O P X F Q Z V M | P Z X M R O Q V;F
R Q U A V N H W G | V H W A U G Q R;N
S T K A O V G F E | O G F S K E A V;T
I W N P L O C Q B | N O B Q P C W I;L
N U K L O V E J F | F L K E V J N O;U
X L U P E R C T D | T L P C U D R E;X
R X E A B Z O Q I | Q E A R Z O I X;B
H T K G M D Z I X | T G I K D M H X;Z
Q B L X T Z P R J | T X R Z L Q B P;J
H R V S E D Z O L | D E O H V S Z R;L
Z D W S E C A P Q | A W D Q E S Z C;P
T E G K P O U A N | T K N O E U G P;A
O Q V I G A E F P | E G P V I Q O F;A
C B J N V Y H Z P | P H J Z N C B Y;V
A F Q D B C X I N | X N C Q A I F D;B
S E J V Q X O U A | S Q A U X E J O;V
N Z L I G R Y H X | I Z Y H G R L N;X
G L O M J R I S W | L G W J M R O I;S
W M S I O V X C E | X E O I W V C M;S
X E T J W P B N F | J N T W F B E P;X
T H X W L Y R N U | W N Y T L R H X;U
V B R N I X C A Q | Q I X C A V N B;R
M J L S D F W I H | W D H J M I F S;L
D R S N P Y E C H | Y H R D C S P N;E
B Y D H Q J N E I | H I B Y E D Q N;J
W Y P F Z K M S D | D W M K Y S F P;Z
I V Q J X R P B S | V I P R X S B Q;J
X F Z U P J M C K | C X K P U M Z J;F
J Z L B N V F P G | L V G B F Z N J;P
P U Y V T F J X K | Y X F U V T P J;K
D B V F Q R L W T | L B W V D Q R F;T
E L T H I K Z U V | Z I E K T L V U;H
E A L N Z B Q C S | S Q N C L Z E B;A
E V K C W Q H B G | Q E C W H K G B;V
C Z E R H W F X B | B Z W X F E C R;H
S J Q Z P H B Y W | J Q Y S B H P Z;W
S C U E R O F W D | O D U W S C R F;E
W Z K X A D Q B G | G Q K A B X Z D;W
X D Y P L F C U H | C H U P X Y L D;F
E R C H I Z S B O | O S I H Z R E C;B
I K C G R M W H P | G M I K R H W C;P
E K C V H B L S P | L C P S K B E H;V
Q B R A C M O T Z | Q A C O B T Z R;M
Y I W M J V E A H | Y I V H E M J A;W
W P Q M T Y Z C F | P C Y W M Z T F;Q
M G R N K B J P X | R G K M P X J N;B
E I V F Y D S L K | L E F S I V Y K;D
H T X U Y O A V F | U T A H X Y O F;V
R T U F W J H I O | O U T F I H R W;J
G C U K Z B T O A | C B G A O Z T U;K
L I V Q U T M B Z | U Q I Z T V L M;B
Q C G W K X E H A | C E G K A H X W;Q
O G E U T X Y B P | E O P B Y X T G;U
S I G R V B Q C A | Q I B V S G A C;R
R Y N A Z B T X Q | A Q T Z B X Y R;N
R Z Y I U E M W Q | I E Q Z M U W R;Y
W L P C T K R D B | K L D W R T B P;C
C V Q H K W L O Z | L O Q W K H Z V;C
E I Z N K Y M P C | Y P C M E K N Z;I
Y A T E P M L X J | P M X J L Y A T;E
D K C W B I O J N | J I N W D K O B;C
M K W Q E U A B Z | B U Q M E W Z K;A
H P C B L Y S V A | H B P S V A L C;Y
Q T S V K C I D A | D T I Q S C K V;A
M G C U F Y R Z B | M G C B F U R Z;Y
C Y V F W G H S A | G Y A V W C S F;H
K H Q J I P W V G | H W K P G V J I;Q
L G X R W M Y P H | M Y X R G P W H;L
P K T M A H E Q X | K A X T E H P M;Q
X E Y L S N T F W | S F T L X E N W;Y
D M E Q I U W O F | D I F M O W U E;Q
Q W P N A C Z X S | S C W N P Z A X;Q
Z G I Y A R W X Q | Q W Z X I R G A;Y
Y U G T P M A Q D | Q D G A M P T Y;U
Y I S W J B C O N | Y O W N J B S C;I
Y K B H R P C U X | B C R X Y H K P;U
A M J N P Z S W I | Z W S M J P N A;I
C A Y N L Q V E M | C Y N E L A M Q;V
O X E G V B W M S | B W V M S G E X;O
A Z B D S O P N L | A Z O N B L P S;D
A W D Q R S X B F | Q D R W X B A F;S
B R G F O K C M H | K C F H B G O R;M
T N C F G I S L H | G H N S T F I L;C
G D N W F C T R V | G C F N W D V R;T
T R I K E N L U Z | U E K R L T Z N;I
R B W U X V F A Z | X B V U R W Z F;A
G F P T Z H O N B | Z B N O F P T H;G
U Y N W L H G S F | S G Y F U L W H;N
Q S J Z G W N P C | Q N S J Z W C P;G
Q J B Y W M H C T | H Y J Q T C W M;B
I H O C V Q E Y U | I C Q H U Y E V;O
G Y E A F V K X M | E Y A G F M K V;X
W P O L F E H K B | O W E L B H P F;K
G Q C I H L T Y O | Q I H G Y C O L;T
W M I S G U Z R N | W G I N R M S Z;U
S L Y C D Z V E F | F C V E L S Y D;Z
I F C J Q E O B H | Q I H E B C F J;O
A Q G K C U F H S | U K A H S C G Q;F
W F N X C A K U L | L U W K A F C X;N
A I G Z T Y D C V | T Z A V Y C D G;I
C O K U M R E X V | X M O K C V R U;E
G L M N Z T F W P | T W P L N Z G F;M
A S H P K E R N X | R A P H N K S E;X
L P Q D Y V B I J | I P J Y D Q V B;L
D G W U M V E T N | E U D G W T V N;M
U B J R D O G E L | J B L D E U R G;O
A Y I O M J H L P | Y O L M J I P A;H
P Y R W I U A T G | T R A I P U W G;Y
D C F G T J W Y N | Y N G F D W T J;C
S T P D C O X B Y | S T D Y X O P C;B
S P V B A M K Z L | L P V K M A Z S;B
A I R C H O J N F | A C J O F N R H;I
Y G Q C F M N E O | Q N O M E G Y C;F
T H X D I N Y W A | N W T D Y I H X;A
P Z M Y L U F N A | P A Y M F U L Z;N
F R O G N Q P T J | G F T P R J O Q;N
I Q F Z T B D W U | U B T I Q Z F W;D
Y R H L W Z F M I | H I Z M Y W L F;R
P O D B F R V E G | O F D B P V E G;R
C J F Z V N A H P | J H N Z P A F C;V
C L O B M X U S N | U N S C B L X O;M
U I G B Z V K X P | X Z G B I P K U;V
L J X H V O D Q P | Q O X P V D L J;H
M U O S E Y G F B | O M Y G F E S U;B
L B E H V U D Q X | H E L X U D V Q;B
F T Y H S P J R M | S Y M P J T F H;R
O T N B F E K M Y | B O N Y T F E K;M
P T X Z H Q R U K | P K U X T Z Q H;R
H E L I V R C K G | V I L H R G K E;C
H N F C S A G D W | C H F G N W S D;A
W S Q X C B O N M | O S B W N C Q M;X
T H B N Y U Z S R | H S Y R U T N Z;B
F L D N P T U R V | P N V R L D U F;T
S Q B X L Y M E T | Q Y E L B T S M;X
P F E T R X Q A C | X E Q P A T C R;F
I X D U T J A G H | I X A H T G U J;D
J H G O L V K Q P | V H G P O J K L;Q
Q S A X I T C H E | T S C E Q X H A;I
Z W I E R X U C Q | I E X U R Q Z W;C
H Z M J D W R L K | R L K Z D W H M;J
N U M G V D S X J | S M D N J G X U;V
N W T F U Y B X I | F B X N Y T W I;U
W U X B S C L V J | J U S B W V X L;C
A P X K L S W Q M | L K M Q A S X P;W
J O N H Q F M P Y | J P H O N M Y Q;F
R T C W B S O P U | P O W T S C B R;U
Z F Q M D P W K T | Q K M D T W P F;Z
R O Q G D T P S X | R O X Q P D T G;S
O N C W M R A B J | B N J A R O M C;W
K E O S C D A W N | N A S C O K E D;W
P J G T O E W S Q | S Q P E T G W J;O
N Z F Y G E W M O | G N W Z O E Y F;M
D U H T Z P K Y G | Y H Z K P U T D;G
M Y P G I E A V K | Y M I K A G E P;V
T O H V A D Y Z K | H T A V Z K Y O;D
M V L F C B D H E | V L M F C B D E;H
Y M U K E I H W A | E W K Y M H U A;I
X E Z V P N Q W R | V Q R W P N E X;Z
C F P S Y L I Z M | I P F Z Y M C L;S
Z X L C H B M T Q | L M C Q B X Z T;H
W P F X M Q Y N U | P U M N F Q Y X;W
I X H R G C Q F M | M X H C Q F R G;I
B G D A L K Z T P | Z K L D G P T B;A
A N V H C X W P U | C U H W X N V P;A
C Z K T V H P O Q | Z T P Q V H C K;O
W S V F H A E U I | V S W E U A I H;F
M F H B P N G R S | B H R P M F S N;G
L V J F D A Q P T | J F P V L A Q D;T
I E W B Q G T U P | Q B E U P G W T;I
X P Q B O A R N J | P J N R Q B X A;O
Q K M T S X W N H | X T N H W M K S;Q
K M L N U C I P G | C G M N K I L U;P
T F E Q N I O U V | V T F U Q N O E;I
Q H X C S D G E M | C Q H X M E G S;D
X H R W U Y J P G | Y G W H U P J X;R
V O L M Q C F T G | O Q C V L T F G;M
T Z O J Q P W I G | Q I J P G O T Z;W
L O V E G W F X H | G E F H X V O L;W
L W H F N B M I C | M F N L W B I H;C
M G T X Z I U Q F | G F M U I X T Q;Z
X W V U D M K L T | X T U D L V W M;K
A O K I P Y W S N | P A W O Y I S K;N
W C F M S I K V A | W K S C F I M V;A
A I O Z P L D Q S | Z S O A Q L P I;D
G W K F C R A Q P | P G Q F W R A C;K
N G E V S F B H Z | N S G E B Z V H;F
P U S X H B A Z K | A X S P H U Z B;K
Y M J W A P B L G | W A L P J G M Y;B
Z G H Q P R V Y J | G R V H P Q J Y;Z
X Y Z E V G J R I | R V I X Y J E Z;G
Q T F C M A L S H | Q H L T S A M F;C
D R J O W U C A S | O J A R W S C U;D
X U V C D B T Y P | B X D C U Y P T;V
D E W K T G M S Z | E K Z W G M D S;T
T R Q L J B S H N | Q H N R T L S B;J
L Z J P T K C H I | P K C Z I L H T;J
K E B I M U F L Z | K L E Z F I M B;U
T B K N U Q G V Z | B G T N Z Q K V;U
Z V T X H L E A C | E A C X V H L Z;T
T O U Z B I D V K | U D B O V I T K;Z
I E L O D C V Q H | Q I H D O L V C;E
Y Q W U Z K P L E | P E Z Y U K Q L;W
I X V Y C N F Q H | V C F Q X N Y H;I
V J A S L E Y D N | V E N D A Y J S;L
A F V R D X K M T | V M T D K X A F;R
W D O T Y K J V C | J W K T D O Y V;C
L A I W J V C N Q | N Q C J V I A L;W
V G I C O N D W Y | V I O G W N Y C;D
A Y X C B U Z S R | U B S X C Y A Z;R
K G Q C Y J Z W A | G C J A Z Y W Q;K
W K Z L R I D V X | K I R D Z W V L;X
V A O R J W H S T | W R A S O V T J;H
J B S N L W V A K | V L S W A K N J;B
Z Y X W I C O N B | I C W Z X N O Y;B
U Y S N H I A J T | T I N S A J H U;Y
O Y I E G S V K F | S F I G Y O V K;E
N Q G L T V M Z I | L Q I T G V M Z;N
X A P W R U H S J | H A S R P U J W;X
G E C K F M U A I | M C E I U G F A;K
Q W J Y F K Z I H | W Y Q J H Z K I;F
A C J N H W R O V | O A C R J H W V;N
T V O N D E B Z L | B N E L Z D V T;O
U H K S Y I D B E | Y U B I S E K D;H
J I Q G U K R M H | I K G M U R J Q;H
T Z Q A F D H V S | V F A H Q D Z S;T
F D N H S Z T G A | S F N H Z D A G;T
W F J U O K D A X | U D A W O F X K;J
J C F W K P G B U | F B U P K G J C;W
G N Z W U L Q F I | Q N F U G Z W L;I
N I G L S A D K Q | S D G I L K A N;Q
Z U A S R M Q F L | U M Z Q S L A F;R
R E U H G O J V A | G J E R O V U A;H
I E N W H C L T P | C T H L I N P E;W
D E W V Q O K X C | Q K W C V X D E;O
D P O J T A E C G | D P E T C A G J;O
O A X B T I G M Z | X Z I B G M O T;A
J S P K A L T H E | T S E L H K A J;P
J W R B S A X I P | S X W J A P I R;B
C B L X E W D R T | R T L C D X W B;E
K X S F N U J B I | F B I K U S N J;X
B L C S G O E Y P | C Y E G P O B S;L
Z I L J E D H U F | E Z F J L I H U;D
T O V J P E Z N L | N P V O E T J Z;L
S P M D G C J F L | S F L D J P M G;C
X R M G V Y L Z W | Z X Y V W M G R;L
Y D W R B A I S P | W D S P I B R Y;A
Q Y J S G U P D F | Q J D U P G Y F;S
Y V O S B J K D I | K O D Y J I S V;B
V H W R F Z I K O | Z R W K V O I F;H
T I A J V X R C G | A I G X T V C R;J
Y M W O V K B E X | K X O B W V Y M;E
C Y G J U W F N E | C J E U W Y F N;G
M Z B U D G S R I | I Z U S R G B D;M
V P A C H Y F U S | P A F V H U Y C;S
S K X N B A Q C T | S N K T Q C X B;A
T V N Z X D J M S | Z J V D N T S M;X
Z S Q I M A N U X | X N S U A M I Z;Q
I N P L O T V G U | N T G L V U I O;P
N F K O C Y A L X | K O Y L F X C N;A
A N P L Q H U V C | L H C P A N V Q;U
B J R O W K P S Z | K R P O S W B J;Z
H V Y U K F O D Z | O U V Z Y D K H;F
M E Y X K W G U Q | W Q X K G U E Y;M
U W A N X V P B Z | N U V X B A P Z;W
Q M J X P V L W G | J G X V W Q M L;P
Z Q R U S G W H T | H S R W Q G T Z;U
D M C A V X K Q U | X Q M D V U K C;A
U T Q N Y V Z M L | M T U Y L N Z V;Q
G Y X J Q I E R H | G X E I J R Q H;Y
W L X G D A B K Z | D L Z W B G A K;X
Q K I S J V O B G | V J S I Q G K O;B
F N L H B W Y Q E | Y W H N L E F B;Q
P I M U G J V N W | I W U N J G M P;V
B G E Y F V U Q L | L U Y Q F B G V;E
J I K Z O E V F B | V I J Z F O K E;B
R N H L J O K A Q | A N H J K L O R;Q
M C E L N Z K D P | L N Z P K D C M;E
N V O H F B G P T | F N P H O T V G;B
P X A J F H U L E | P L F X H A J U;E
O S T C N F B E Z | B E O S Z N T C;F
Z N D K I Y E B Q | I D B K Z Y Q N;E
P D Y H W O V B Z | D O V P W H Y Z;B
D F M K H U B G S | B S M D U H F K;G
G F K O Z D M V W | F K Z W M G D O;V
J Z X H A I N B M | X H I A B M N Z;J
K Z C F U O I E B | Z O U K I C E F;B
O W H R J E F K Z | H E J O W R F Z;K
P J G Q A S C U Z | C Z G P A U S Q;J
P N U Q K F Z B R | Q R K N Z P F B;U
L U S R W G M P D | G L P R M U D W;S
S Z D H B Y C I W | H Z I S D Y B C;W
Y H M L T S O K U | Y K U S O T L M;H
G B L F D M H P R | M H P L G B D R;F
Z X T A N M U L R | Z X T R N U L A;M
Z I K S X B T A G | S K G X T B Z I;A
X H K U J V G P F | K X U G P H V F;J
U Q D R A W P Y X | Y R P Q X A U W;D
D M G Y Z X F H E | H F E D Z Y X M;G
U Q V L Y O P I G | I Q P O U L V Y;G
P K C G M D V U R | G U D K C V M R;P
S K I G R L A W N | W L G S I A N R;K
A W P F I K E Y T | I K E W A T Y P;F
Q G C E P J F X R | E J C F R Q P X;G
M W U J X H Z S Y | M H J W Z S Y X;U
R Z X M H G V S U | U V R H Z M G X;S
Z Y N W U T B V A | V Z U W T B A Y;N
Q Z O Y V U I T E | Q U E I O Z Y V;T
H Q W Y K M C A N | Q Y C A H M K W;N
Q H V C R W O G A | C W G V O R Q A;H
G N J K H R V M Y | H K J R N Y M G;V
Q E I D O W U X S | E U X I Q W D S;O
V L D A Y H I F Q | F Q H Y D I L A;V
L U D F W S X H R | F U W H S L D R;X
F S K Q I W B O L | Q B F O I K L W;S
O H G E N R D Y I | O D R N E G Y I;H
C W U Q X G V Y A | W A C X U G Y V;Q
B T Z E R A S M K | A Z K E T R S M;B
K H X E F W M L C | X F C H L W M K;E
I Z D U Y Q O W E | I W Q Y Z O E U;D
K U N Z W J M E H | E K H U Z J M W;N
I R Y B H O F L E | R H O E L I B F;Y
J E D Z S T Q B C | Q J C S Z D T E;B
B Z P A V N M L K | B K L M V Z P A;N
M E N Q B J I F Y | J N Y F B E M Q;I
S A D V M N E L G | V L G E A D M S;N
E U F D V I Q G N | N I Q G E D V F;U
X C Z D P Y F M Q | M C F P Q Z Y X;D
U R H O X T J W Y | U O T R Y X J W;H
O P E A V T N C H | H N O P A C E T;V
D N Y H C B Q U V | H Q N D C Y B U;V
K T Y M F P I L N | L K I P F T N M;Y
D H Q W F K J U P | J W D K Q U H P;F
I R K P N E F D M | E R N D P I K F;M
H X O S U V J N R | J H V R O X S U;N
C E O D H Q X V I | E H V O I X Q C;D
S R J W Z F B I A | I F Z S A B W R;J
P X C J B G V O T | X T O B V G C J;P
B W V U K D M C E | U E D W M V B C;K
O P G L V S K H M | M V P L S H K G;O
E V Z Q W G S K N | V Q N K S E W Z;G
U D T V W C A G H | C A D V G U H T;W
M X E I T G S Y A | X A M Y I S G E;T
C F J K Z Y P R M | M J Y K P R F C;Z
R W K Q V N A U G | G V K U A N R W;Q
Z O X Y I V N P W | I P X W Z N V O;Y
H T K Y N E X A B | H A Y B N T E X;K
C B W J K A P O S | B P K C J O A S;W
U Q W C O B P X A | W P A O C X Q U;B
R Q O M N D Y C G | Q C Y M R G D N;O
J F U D S K X E C | J K U S C F X E;D
M Y B X K U D H Z | K D Z U M H X Y;B
E P I G C R V Y B | B I Y E P R G C;V
E U F R H G X Z C | F X U C Z H G E;R
F E C T B G Q A M | F Q A M E C T G;B
S G E N C T K U F | U S E T F N K G;C
M P I D H O L Y W | L M D Y O W H P;I
A B M J R N G Q V | M A G V N R B J;Q
Z B V J P C A U T | U A J C V P T Z;B
X R D E N J Q G Z | R Z G J E D Q N;X
T L J I O M V F H | F T I M O V L H;J
V S I Z G F N P H | P V F H S G I Z;N
V A C B E L X K Y | A B V L K C X Y;E
H R C N M V S Q X | Q X V N R H M C;S
E B S I M D H V X | B D M H V I E X;S
D K A C B F Q X V | X K V D Q F C A;B
L S B A U P R V T | B S P L U T A V;R
S O F W Q B Z U N | S Q F N B U O Z;W
U Y C J D R W O L | R W Y C L D J U;O
H F N R T K Q Y G | K T Y H R Q F G;N
B J P Z A O R M I | B J P R I A O Z;M
J Z V X B Y C D M | J Z X V B D M Y;C
M G X Y C F N U I | C X G U Y I N M;F
N C A F D Z Y V X | C D V X F Z A N;Y
S K O U C D P V Q | V P U Q S O D K;C
M P B Z Q N W H L | P Z W H L M B Q;N
Z G U B I R W J O | J B Z U O G R W;I
E J A H T S Q O B | T J H E A O B S;Q
R V Y O G X L Z J | Y J O G V Z L X;R
K L W G Q T F I H | T K F Q W L G I;H
W Y V Z A G N D J | J N Z A W D V Y;G
Z B I P Q A J X N | Q B I A Z J P X;N
S N L W Q G E I O | Q I S G O L W E;N
H A K E M N I B R | R K H M B E I A;N
K H I T M G B P D | T M P K B G H I;D
N H T B C S P G R | G H R B T C N P;S
A S D U R Z O H X | D H X A R Z S O;U
Z M T S O F H U D | F Z M U H T O D;S
T G M Z U P K Y R | P R K G T Z M Y;U
L Q J I C R X A S | C I Q S X R J L;A
W Q I G V C O A Y | W C I Q A G O V;Y
K Y R W A C J I X | A Y C J R I X W;K
V X C N G H T B E | N V B C T X E H;G
R H V B G U Y N J | B H J G R N U V;Y
V H N C Z L Y T A | N V Z L H T C Y;A
J K N A F L I T C | J L F A I T K C;N
V Z U G I B H A Y | Z H A B U I Y G;V
K V H C F G B D X | F G K X H V D C;B
H X M B T I A R P | T B I M A R X H;P
C O G Q U M T S N | Q T C G O U N M;S
F P B K W L Z M T | W K P M Z B L T;F
P Q C V G U O T K | C V U G O K P T;Q
W H M V Z F G N J | J H N G V Z W M;F
A Z E R I T C D N | A D R C I E T N;Z
V I B R F Y H K S | V Y K S R F B H;I
Z J W O D T V Q M | Q T W Z D O J M;V
T I V E Y O A P S | S E P T O A Y V;I
K V A R T Y S I L | R V I L K T Y S;A
J L O K D T Z B U | O T J Z K B U L;D
L N X H G R Q F Y | L H Y F N R G X;Q
X B Q A F C V L K | B A Q L C K V X;F
O D W U E C L S T | W D T O E S C L;U
U P Y N M A V S G | U Y N P A G M V;S
Q T Y Z H I X L R | Z I L R Q Y X T;H
I N W M T Y O D S | Y O M S D T N W;I
G W A V M I F Z O | O G W M A Z I V;F
T F M W Q B H C O | B O M W F H Q C;T
C E I H U X A O P | H X A P O U I E;C
Y K A O H R G B F | B G K R F A Y O;H
V A B O E Y K N D | Y V B N O A D E;K
O P X S J V F I H | H I V S J F P X;O
K N A R P W Q E S | E P S W A Q N R;K
Q J F I X V B E K | I K J B Q V E F;X
I V M G L H D F O | O F M D L I G V;H
F B K T J R H P E | H F K B R T P J;E
G Y C M O F Q W N | Y Q F C N W M G;O
S H C N T U G W J | C W U S H N G T;J
P M S X K B Z F R | S K M P F R B X;Z
Z K O N U C Y X D | D X Z U O K N C;Y
V C R Y O A W D Z | A Z V O R Y C W;D
G A N U I P H X O | U I G N A P X H;O
M U G Z P S Q W A | G P Q U S A M Z;W
E J W D M P H Z I | I Z W M J H E D;P
S D K G J X P A R | S A G D R P K X;J
Z B F K C Y L R N | F Z B K R Y C L;N
Y A G N K M X Q W | X A Q M K N G Y;W
K U I Q S G V H E | E V U K S G I H;Q
T I Q F N H U Z O | H F Z I Q U N T;O
B Y K M V X H U I | B M X I Y K H V;U
H D P B T I N M O | M D H I P N B O;T
R X E G N A F S K | K F G S E N R X;A
Z E M B S Q L R Y | R Z S Y Q E B M;L
R O A I G H E B M | G A R I H O B M;E
K R V T M Y O A Z | T Z V R A Y M K;O
K Q M P A G S F X | K Q X A F P G S;M
B D X A J Z K M E | A X M K Z D E B;J
Z Y E U H L X F A | L A E F H X Z Y;U
Z S G E Q L C A M | Q A L C S Z M G;E
U P C H M D L B N | M U C B D P N L;H
J P H S M I Q N F | Q F P I M N H J;S
M O Z D F Q V U J | F Q D U Z J M O;V
M S F K T I Q J W | Q M S I K T J F;W
G F K N H L V U O | N U H G L O F V;K
A X F B Q H Z M W | F Q A X Z M W H;B
T G M Y Z L E R A | R L T Y M A Z E;G
G R M O F Q V B I | Q V G R B M O F;I
Q N U D W C Y B G | Q C N D W U B Y;G
A L T W H K M Y U | A Y W K H U T M;L
I W F R U K S B O | W R F S I K O B;U
M I X O P H D Y Z | Z Y X P D H I O;M
G V B X L Q P R O | Q L G P O R V X;B
K Z S V N G F M U | G S F V Z M K U;N
E O F D V T J K U | E K D U T F V O;J
V G Y Q E Z S L J | G E Q Z Y L S J;V
B W U Z K G C A X | K W U X C B G Z;A
X H P B W C G I M | C P X H G M W I;B
L U N W S R C I Y | C U R Y S I W N;L
P L Z A K J X M H | L A M H P J K Z;X
T P G Q R V C M S | Q R T M S P C G;V
Q Z G A C M W O X | M G W Q Z O C X;A
O E T V Z R L S U | T L U Z E S V R;O
O B L K C M V X Y | V B Y L C K X O;M
B L J R D V I Z Y | I J D Y B Z L V;R
Y Z O P R H N J F | N Y Z P F R O H;J
B K L M X U P V I | V M I X P L K U;B
U I M J X F K T P | F X I M K U P T;J
O K H D J Z L V E | D L J V O E K Z;H
B P Y W T G Z N Q | B T Z P Q N G Y;W
G A U O F V K J Z | J K F O A V G Z;U
H S F Q X D V W I | Q V S W F D I X;H
D M F Z Q T H C N | M H D T C Q Z F;N
C G B K F O R J Q | F O K B R Q J C;G
G B W J D L F A E | L F G E A D B J;W
L Q G T F R K A N | R Q K N F T G L;A
O T L G W Z U M V | G V U Z M T W O;L
G M D Y R T N E J | R J G T E D M Y;N
B O A Z U H D K T | K Z O D A T H U;B
R H A T D P F Q M | D P T M R H F Q;A
X L E T Z U P M D | E X M T P D U L;Z
T O W I G B J L S | W I J O T B L S;G
L K C J T I P Q U | L K C Q U J I T;P
W N F X A P Y H O | Y H W A O X P N;F
Y R J I H U L X F | U L X I H R Y J;F
L G C A M X Z D B | A Z X B G C L M;D
M Q J E L I O K N | J L O N Q M E I;K
F Q I W H T M A D | I M H Q A F W T;D
Z K P U T X Q W N | T K P Z W N U Q;X
M X Q C Z O B I S | C X B M Z Q I S;O
C T B M X R N F I | C X F I M T N R;B
D Y P W K V Z X G | W P G K D Y Z V;X
A X Z S Y G P I C | S C G Y X A Z P;I
Q R E D J A T W F | Q R J F W D T A;E
I Z U Q W P K T C | Q W T U I P Z C;K
M G O I X N K B C | I K N M G C O X;B
F C E U D Z W S J | U D S C E W F Z;J
V F Y C X H R W S | V X C Y F R S W;H
P B N U G R Q M S | Q P U R B S N G;M
P O C Y N X H F V | V F P O H Y N C;X
G E Y D R B S A W | A G W D S B E Y;R
V C M R Q T G J W | J Q R G V M C W;T
P V J E T D S R X | X S D V J R T E;P
D W B O Y Z U Q N | U Z Y Q O N W D;B
J G R W X D E C H | W R D C X H J G;E
S G W M K X L F A | K F S L X M G A;W
O V P H Q T U B G | O T V P H U Q B;G
R Q Y U F T M B V | Q M R U V T F B;Y
P Y R D I K T C F | C K T D R I Y P;F
O Q W F V L U D B | B O V U Q D W L;F
S D X U M Z T F L | X D F M T S Z U;L
D G A E O W Z U X | U A X W E O G Z;D
E C K Z G U Q D B | Q E D U G K B C;Z
M U S P E V L B T | U T L S M B V P;E
D H G U T V B C N | G V H C B T N D;U
U J S V I H C X Z | S Z J U H V C X;I
V O I Y B P K T W | V I O P K T Y W;B
G B H P M O N V C | N G M O B C P V;H
O W G N H S X U Z | U O S Z N G W H;X
U E D W K N L S V | N K S V L D E U;W
Z L V T N J K E I | Z T N J L I V K;E
C S R G P L E I N | C G N P E L R S;I
S N P C E M O H F | H P S N F M E C;O
N B X Y M R S Q L | R Q B N X M S L;Y
H Q J Z F P S M X | H F P Z Q J M X;S
B V R P K I L X Q | V R I K L B X P;Q
Z K I B R E V C O | I Z B V R E K C;O
K A I C V N P H Y | A K Y I H C V P;N
T D F L J C Y W M | T C M J L Y F W;D
R V K P O C U Z H | V R H C P Z O U;K
A G E V Z Y X N P | N A Z X P Y E G;V
T S R M C G P Q L | L R C M Q T S G;P
X G C U F L H K V | U X K H C F G L;V
G O H W P D B T J | B T G D O P W H;J
K F C H D J V B Y | J C F H B Y K V;D
M S U C V W B T E | S T M W V B E C;U
A E H T J M Z I K | K J Z I E T A H;M
N D E C W H Z Y R | D E W Z H C N R;Y
Z O M W N J U P K | U W J M Z K O P;N
Z T Y W P I S X G | G X S P Y W Z I;T
D M E O B F N R J | M D N E R F B J;O
P L Q O N S U W I | N S U Q W I P L;O
M I J Y A N G F R | N Y A J I F G M;R
N W T L A S V C E | T E S C V A L N;W
K P D Y G Q J F H | F D Y G J Q K H;P
V G N T J M K R Q | N R Q J V G M K;T
K O T X J A E C S | O S J C K A T X;E
R P T G L E O B M | B O G P E T L M;R
Q Z J U P F A K S | Q J Z P S U F A;K
Z M T R G V Q C U | Q V C U M T G Z;R
Q I W R X A Y P L | P Y Q A W X I R;L
E D I G O R Y T F | G R F Y D T O I;E
Q J A X Y K Z P G | A K Q G Z X J P;Y
D X F P W A H E R | E P D H X R F A;W
P L R I G B K A D | G K B I D P R L;A
N P T H Y B X I E | Y T P E X I B H;N
P V R B E A Z G I | G B A R V E P Z;I
W F K L U H X C S | K U C W F H X L;S
G N U K A X H Y Q | U G X A H Q Y K;N
B V Y D A P S R X | V D P B R Y X S;A
Q J T Z D W N U S | T S J U N D W Z;Q
W Y L H U B D J Q | D U B Q Y L J W;H
Z K Q G N S D P C | Z P Q N D K G S;C
L B M N F O G Y Q | F M Y G B L O N;Q
N A J Y Z C R S W | Z C Y J N R S A;W
Y U O B T V J M H | M V H T Y O B J;U
O D Z F Q C R U G | G O C U Q R Z D;F
E P N C G A X T S | X P T A G E N S;C
G L T W X F J P B | F B T L J W P X;G
L E R U P K C S W | P E R L C W K U;S
B A R S L H J C O | A R O C B J H S;L
S Z X E F C R M O | M F C Z E S O R;X
F X G M D Z A C B | C A G X B D F Z;M
B Q H S E J Y T R | J E H Q R B S T;Y
I H Q X R M D Y E | D X M H I R Q Y;E
U Z M X C K D H W | D H M C X W Z U;K
Z M I A H U X B C | H B Z U X M C A;I
U W A V L T I Z B | A V I B W L Z T;U
L K U H S W T G N | N W H S U T G K;L
K S D N J A O L B | D B S L N A O J;K
W J N G Y Z B E R | Z W Y N J R G B;E
J Q O K D L A P X | L K Q P O J D X;A
V W I H A R B K J | R B V W K J A H;I
L D V G U E B X F | V X B G U D F E;L
G H F U X B Z P T | X G P F B T Z H;U
H Y S V L A U N W | W V U Y H L S N;A
S L J P U W I Z Y | P S W Y I Z L U;J
T J E L B H P W Q | E P W L B H J T;Q
I R N A V L W J F | I A W N R J V L;F
N J C S M V H F W | W C S M J V F H;N
M T S B V K J Q E | K M T B V S E Q;J
Y U X I M S O K T | S K T I O M Y U;X
W Y S O E G N M V | G W E M V N O S;Y
N W T K Q U Z E S | S U W Q K Z T N;E
M B N G V U S L F | B V L F U N S M;G
U W N E L P K D O | D K O W N E L P;U
T A P H C L R B N | R P T N C L B H;A
S T K P I E R F V | R V E P I S K T;F
O F B X E M Q P S | O X E B Q S F M;P
Y G J E S D H U W | E J H W D U S G;Y
Y C O D M I V Z L | Y I O L C D V Z;M
A N T I D M S G J | J A G I N S D T;M
Z J Q C U E F I M | M C J Q U F E I;Z
L H N Q I E R M A | L R E M H I Q N;A
N W F O J E V A K | A W N J O V F E;K
C A M U W X E I T | A E W X I U T C;M
F J I X Q A K L G | G L J I Q K A X;F
L A I S O W H U M | U L S H M O I A;W
G S X H Q A C D N | H X D S G C A N;Q
P F K G S H X W B | F K G S W B X P;H
A L I Z S N J P K | I K L N A Z P S;J
N S Z E M L I K H | E M H I K Z N S;L
W U Y B O M Q D I | B Q O U D I Y W;M
J Q G E R H M L T | J M H R T E L Q;G
J X T R S V G U K | X G R V U T S J;K
T V S N I L P F J | F S P N T L J V;I
X O U Z V E G N H | U X V Z G N H E;O
V H M X N Z C R S | H V R M N Z X C;S
Y A M Z Q D I W C | A M C Z D Y I W;Q
H W S B D L M J V | B H W J M L V D;S
J C N G X Q S E H | H E J S G X Q N;C
Q H X B I J L F P | P B J L I H Q X;F
X P L S V J I A D | S D X J V P L A;I
O N X M S B L Z H | S Z O L B X H M;N
F R B H P X K N M | X R F N H K P B;M
D V Y R E N T I S | T R V E Y N D I;S
F Q K W L P H X U | F Q P K X W L U;H
T W N B K H S C D | N S W T H D B K;C
K U A P B H L R S | A B S K R U L P;H
K E C Z J S L V W | V S J E L C W K;Z
J O W X H T Y D S | O W S Y X J T H;D
V G U R W M S K J | S V K G J U W M;R
W E J L D T M U C | W E T L M U J D;C
D E N S H L I W P | S W P H L D E I;N
Y B A X G O V F C | F C B O V G Y X;A
Z B U R K W X M I | B I W U X K R Z;M
B K P V M S A W Q | V K Q W B M S P;A
E U N D J L I B A | B D A E L N U I;J
M A U L W B H C I | W I M L C A H B;U
A K T S X P H B D | D T X B A P S K;H
Y A G H B V N P K | H G P N Y K B V;A
D N U Z R I B G E | G E N U Z D I B;R
M Y E K C W G D P | M E K P G Y W D;C
G H I F P B Z Y L | L B I Y H P F G;Z
K Q T H X J C Y O | Y C X O H K J Q;T
P H Q J E C Y I B | J I P H B Y C Q;E
T X H B D N G Q K | D H N B T G K X;Q
Q W P B Z A U F E | P A Q U B W Z F;E
U K H X E W J A Z | E U J X A Z H K;W
D X I B G O W S U | O I G W D U B S;X
N H P D C B U Y M | C Y H B U P D N;M
K P X M E T J V W | M E J K P X W V;T
H J L W D T A Y Z | L Y D W A Z J T;H
K W P O M C D R V | C O M V D P W R;K
O G M Z Q S W D R | O G Z D S R W Q;M
I T E S F P B H M | E M T S H P F B;I
L D H B Y C K X R | B Y C R K X L D;H
J P I N Q B S V R | R S B N Q I J P;V
X V C I L U Q T B | Q T I X U C L B;V
N Z E C K V B T G | B K E N V Z T C;G
E Q M D U O V T F | E O V D T U F Q;M
U C A M O Q B N Z | M O N U C A Z B;Q
J W C G M F A U R | M W F C G J A R;U
R F U L N T I J W | I U W J F T N R;L
T K H W V N J O A | V W H T K N A J;O
H G T J I X U F B | T X F U G H J B;I
F H Y P X K G B L | F B G P X H Y K;L
N Y T A C R S X O | X C T S A Y N R;O
S A L N Y H T E O | N A E T O S L Y;H
R M L N W T B H F | N T L M H F R W;B
F W L V K J E X U | W X F L U E J K;V
R F L W B X Y Z D | Z X W R B F Y D;L
I O W N B U T X S | O N X I T U B W;S
W E G L J R Y B I | Y L B I E W J R;G
S W V T M Z D A J | S M A D T Z J V;W
Z M I X C D F R Y | C X D Z F I M Y;R
K C G Z O L T Y D | G Y L D O C T Z;K
J L G I B W C K D | C W K G D L I B;J
H L D V B I O G P | I V O L B P D H;G
J K U T G O Z I W | J I O U Z W T K;G
U Z G S E X M D R | U M R D Z E S X;G
X P Y A D J I Z E | X I Y A E J Z D;P
C E Q W B H D J X | B E H X D J W Q;C
T H R N G Q F L O | F G O R L Q H N;T
Y H P W F C D I B | Y C F P W I H D;B
T P X O I D L J A | I D O P A J X T;L
L O T X Z S K U F | L T X U O K Z F;S
C K U N G X D E Z | X N D G E Z U K;C
T J L S Q E O C V | T S Q V C E L J;O
U Z I M X R S C G | R M Z C G X I S;U
X C Y Q P K O R W | O K C X Y P Q R;W
B X S E I F L O C | S L X I B F O E;C
O Q A E F R H J W | F W J R O H E A;Q
E X H R I L Q Z M | R L Z M H I X Q;E
I N Q A Z X B K L | X A Z B L K I N;Q
X V H A W E J M D | M J E A W V X D;H
A T P X C F L G Q | T X C P Q G A F;L
P X A Q Y B W H M | B Y W Q M H A X;P
X M J Q H N P R Y | H Y R X P M Q J;N
Q F U E Y K I J S | S J K F I U Q E;Y
A T G Y E L Q F U | T Y A L F G Q E;U
O G N R J X V Q H | G O N X V H R J;Q
C X B V A G Y P Q | Y G A X B V P Q;C
P V G D E W Y L R | W Y D R G E L P;V
Q M H D Z X T K R | M T X R K H Q D;Z
W E U N S A O R Q | W S R Q O N A U;E
P Q A Y Z W U F I | Q U F I A P Z Y;W
K C S T G U M L N | K C L S T N M U;G
K P X Q E Z S L N | X S E K L P Q N;Z
E V P Z K O X R B | O V K R E Z B X;P
S M C K J V I E X | I K E C S J X V;M
U O Z R H A J W I | A U R J Z I H O;W
M H I Z B N C K A | A I N B Z C K H;M
K Z J C D G U V W | U W K D V G C J;Z
F J U D N R Y S L | D Y U R F L J S;N
B E T A C R H U S | A C S H T U B R;E
U D P J I O L R E | P U E I O D R J;L
C X B H V J F P A | J X C A F V P B;H
T Y H Z D V M O J | Y H T M D V Z O;J
Y O R W H F U V L | L R O U H F Y V;W
W I M J G R Q A L | G L W I J A Q R;M
X E A P R Y U H K | X P A U E K Y R;H
F B T Z I H J A R | Z B R F H J T I;A
S V A T K W I R F | K T I W V A S R;F
G W J Z X E B Q Y | J E X Z Y B W G;Q
J F I S T U H D Y | H T S J Y U D F;I
H G E R P U Y Q K | U E Y K G Q P H;R
D P K Z G H X L Q | L K D X P H Q Z;G
F W B E L D M R Z | E Z F D B W R L;M
M A X D Q K S T J | T X D J M K Q A;S
A B U X H C K F G | B C G H A X F K;U
P Y I F K S H L V | F L H K S P Y V;I
K G Y H Q X U P D | P G U X Y Q K D;H
S I J N O D F M H | H J F M D N O S;I
I W P G E F J M Y | E I W G Y F M J;P
K J Z D A W T R I | R I D A T Z J K;W
L E Q U G I F R D | R G Q F D I U E;L
X K J H P E N C T | T C H P X J K E;N
A F P Z D N M I O | Z F A P N I D O;M
V D H F A S G I W | I H F D S A V W;G
R U G O H K Z S D | G Z S R O K U H;D
G N D T J I W E B | B W J T D I N E;G
U T S K F B J O M | F T J O K B U S;M
O E G T B U Q Z J | B T Z J U Q E G;O
M P G B N J R Q A | A B G J M R N P;Q
O B R V M Q A U D | B O Q M A U R V;D
U L P H D S Z N E | D E Z L H U S N;P
Z W R H U G D T S | Z D S W H R U T;G
W K T J F I S Y G | S I T Y F K G J;W
D P F Z K T U S A | Z P D U S T A F;K
S Y T B F D H W G | F Y G T W B S H;D
B U O E P Q Z H R | P Q B O Z E U H;R
D U I X Z P T O E | P U E Z I T X O;D
R X A F U N Y K M | U F X R A Y K M;N
S P D V R C Z U K | U C R D S V Z P;K
A C V M F Q P S J | A Q P J S M C F;V
F O R Q Y Z H D X | F D O X Y Z Q R;H
N E R L O D W V A | L O W D R V A N;E
U I Y C F O P Z S | P F Y S U O Z C;I
N K M R W Y T B I | M I B Y T K N W;R
Z T V U G F C L O | T V Z F G C O U;L
U A K X Q H E Y G | E H G A Y Q K U;X
C I E P R L A T H | P C R I H T A L;E
I H L W R A U K N | N H A I W K R L;U
D G L V B J C U P | U V J L B D G P;C
H Q I D J W L X M | L I D Q W M X J;H
Y L A U T H C I R | C T I R H A Y U;L
L T F M Y B C X H | B F L C M X T H;Y
J F Q R I W G A D | Q G I F J W R D;A
D W K A I V G E Z | G Z K V D E W A;I
D J C H G L A Q F | F C H A J D L Q;G
E X I J Z F Q A N | Q Z J F I A E X;N
K J F Y T P X U B | F K B U J P T Y;X
S E A Y N W O J M | M W Y S A E J O;N
V N I L B A W H G | L N I A G W V H;B
X C N V R I G H Z | X R G H C I Z N;V
S F I M V P K G J | K P M J V F I S;G
U Z N W D Y O B E | B U Y D W O E Z;N
E Y P Q J K I U A | A P Q Y K U I E;J
U J R B F N P X K | J N F R X P K B;U
M N K Q U S X H B | X K H N Q M S U;B
Q J W U V Y E X T | U Q J T X W V Y;E
N T M S A G B I P | T N S B G I P A;M
D C T V X L E S Z | S C Z D T V E L;X
I B Q N W Y U K O | O B I U Y Q N W;K
W R O D M F A Z G | M G O W R F D A;Z
A R D I Q H M S E | D S H I E Q R A;M
K X O B E N Y R D | D K R O Y E X N;B
U D K S R H T W O | K S U T H D R W;O
K F Q T X D R B U | T B F K R Q D U;X
G A L Z P O S W D | W O P A D G L S;Z
N O F P W V S E I | F O W S V N I E;P
N M A T G X E P F | N T G F P A M X;E
M Z V K S T G J P | M S V J K T G P;Z
M U H G K P F N B | P G H M B K F N;U
W C X J Q E K Y I | C I E J W Y X K;Q
X J T Z E L O G Q | X O E Q J T Z G;L
J S I Z M Y A N R | N A Z S M Y R I;J
T N D G X Z W S V | X G D T W Z V S;N
C T O L H B K A P | O L P K A H C T;B
S I W K T H V O Z | T Z H S I W O V;K
B V X D A C P G W | V W D A G B X P;C
B J K T R L H C P | J K R T L B C H;P
C H F I Z B O L T | B F Z T L C O H;I
H A X Y Z I W M S | Z M W Y A I S H;X
W S A R Z M T C L | W A C Z L M R S;T
J N V F D Y A L E | D L Y F A V J N;E
U Y W V H G K M R | R M U K V G Y W;H
Q C G D V K S T Y | V C S T Y K D Q;G
Z F J L X T E R Y | E J T R F X Y Z;L
P C W V J K O L E | P W J O K V L E;C
N L I V Z Y A C X | Z C I A V Y N L;X
Y N F X W V L K A | A X K L N Y W V;F
I L S H W U A N Q | U N A H L Q I W;S
Z G B Y K W L P D | B K G Y L W Z D;P
A Y F O S K C N W | N S C Y K O F A;W
A H D U G B Z S J | S B U D Z J G A;H
F P Q C T B H V S | S T Q H B V F C;P
T J E R V P D W Z | D J W Z V P E R;T
U F K J H W N A L | W L N A U K F J;H
U V D L H C G A Z | L A V H G U C D;Z
W J N C H I Y Z L | Z H W N L Y J I;C
N E I J M O U Q L | Q E I U J N O L;M
W D G I N Y A T C | G W N C D A T I;Y
F J Y E I W D N Q | D J I Q Y N E W;F
P U A T F C E R O | U R P F C E T O;A
Z X G O S B F V N | S F V X Z O B N;G
E N W U L K X P V | P N K E U V L W;X
F L P U A E H Q K | E U A K Q L P F;H
V H P B R T Y U J | H R U Y J P B T;V
C F H W Q M A G B | A F H C Q M W G;B
T F Q V G M Y D I | I T M Q D V F Y;G
G K Z J I Q A W S | S G W Z I A J Q;K
O X E A F N R C V | V A F C X O E R;N
C S D Y B R Q H E | E C H Y R S B D;Q
L K M U B P C Q W | M W L B K Q P U;C
P F A I E B L Z V | V I A F Z L E B;P
M E N Z R Q O W Y | Q R Y E O N W Z;M
N O J R S W V A P | R W S P N V A O;J
N W J T G R L Z E | T E Z W R G L N;J
I B T K Y Z A D P | Y K B D I T P Z;A
N S T P Q D B L U | T L U S N D P Q;B
R T N Y V X G K P | X K G V Y P N T;R
M K P G B C Y V W | W V M B C G Y K;P
F G B H X I L W N | L X B F I W H N;G
N F B I A Q E V C | N V E A B C I Q;F
T A N M F O J B C | N J M A O F T C;B
A M L S B H E V N | B V M E S H L N;A
N H U T W B D R Q | N H R Q D B T W;U
Q M O A R L K T Z | Q L M R K A T O;Z
W C K V Z I X Q P | X K I V Q P Z C;W
N A V X O T G K U | U K G T O N X V;A
C W X S O V D Q K | D K S O Q X W V;C
E M B U C L R J I | C E L B M J R I;U
C G R Y K P Z J B | Y P Z R K G B J;C
Q Y B G T Z S L H | L T Q H S B Z G;Y
O T F V R B U C L | F T V L O B U C;R
K G Z H L D J B V | L G D V J B H K;Z
W J B Q T F G D H | T G H J W Q B F;D
C K M U V Z G T Q | Q U C M V G T K;Z
D E X T K C R G S | T D X S R G K E;C
N X R B F U C L I | L X B C I U N R;F
A S E Q K Y W H U | E S A W Y U K H;Q
K F L H V U A W J | H U F K A J L V;W
E R B V Z T F U A | B U A V F E R Z;T
U N T M V X Q S F | T M V U X N Q F;S
X M E H F C Y K O | X E O K M F Y C;H
O I H D J N S P K | I D P K H N O J;S
G X C Z L Y K Q V | V Z Q Y G X C L;K
I G J Y B V M W Q | B I W J Q V M G;Y
I T S Q U Y X M G | Y T M U G S X Q;I
Y F Z A B L J M P | Y J A Z B P L F;M
N V M Z I F R C B | F I R M C Z N V;B
T B E F K Q P C D | Q F P B K E C T;D
Y R V C T E Z J U | C R Z V E T Y U;J
T R J O A W B K Y | K W Y T O B A J;R
F O Q P V Y E L W | F E L Y Q P O W;V
K O G P H X U L C | G P X H C U K O;L
M B H A K T D L W | K M B D W A H T;L
N L C B V Y S P J | P C B L N S V J;Y
X D O R W Z B I M | M W R I B D Z X;O
Z X R S W C A N D | S R Z D W X N A;C
D R M C K U A Z X | Z K M D U A C X;R
E C N H F D W Y S | D W S E C N Y F;H
L N O Z P E F G R | R F P O E L G N;Z
H V Z X R B L M P | Z B V L H R P M;X
C K Z D H J G R Y | D K C Z Y G R H;J
W Z H F G M R T X | T M Z G R H F X;W
T E U R H V X L J | X V J H L E U R;T
Z D O S R Q F K B | D R O Q K B S F;Z
N O E T R L D Z X | L O Z T D N R E;X
Q T O F R I P M D | D T M O R I P Q;F
L E J X T Z W Y K | L J X Z Y E T W;K
W S I K E P O Z C | C P W O I S Z E;K
H N S Q Y X F W L | Q N F S W L H Y;X
Q D L Z H Y X I K | K I H Z Q Y L X;D
R F A U J D I L W | L D I W U F A J;R
T Y I S M C W O P | P M I O S W Y C;T
G O L V N D B C W | N W G V D B L C;O
O F V K Y A U M W | M V W O K F A U;Y
B U G S T X R Q N | N B R T G U Q X;S
Q W P X R K A L E | X Q A E P W K R;L
R K P D C I X N Z | N P R I D K X C;Z
W O C S L T B I Z | S T O Z W B L I;C
B R U L W E V N X | V E X B U W R L;N
A V R M T D U G N | V N U G M D R A;T
Y Z E H X N I W M | H Z M W I N E X;Y
Y G Z S Q B X U M | U M S X Y G Q B;Z
E U N M Q I J L O | O I U N M L J Q;E
V F N U M Y T K Q | F M V N Y T K Q;U
O E N X Z F G W R | W N X F Z R G E;O
I V B U Y D A W J | U Y B J A D V W;I
W O U J Y S X Z R | J Z R U S X Y W;O
U O X W L K R G C | W L X O R G K C;U
U S Z V B L Q O I | V U Q S L B O I;Z
J K S R H W V F P | J F R V H P S K;W
K M S J P U O A T | S U M P A K J T;O
S E A H P R D C U | H R C S E A P U;D
C G I A R N W T J | N I T W J C A R;G
N M O D Z G S B A | D M Z N G B O A;S
Z E O C K V D N Y | D Z Y C E V K N;O
V G F T A N K Z X | T V X K Z G F A;N
Z W O M C D H G J | O H J W G D Z M;C
C M I U G A Z N Y | G Z N C M A I Y;U
L H E N U K D F Z | E D L H N F U K;Z
F K D J G A E V M | K M E V F A G D;J
D L B W S E T J P | B S D T L J E P;W
E J X W B F I C L | I C E B W L J F;X
V N C U Q W J P Y | V C Y W J N Q U;P
F E O I Y Q J U V | Y F E V U O Q I;J
X S N V C Z O H E | C Z O H X V S N;E
I E G Z F N U Y B | I G N Y E Z F U;B
X Z G Y F P J H U | G P F H J U Z X;Y
L S H Z V P W B M | Z P W H S V M L;B
M G J A T Y V P W | Y J T V W A M P;G
K C V S Z B I U H | V C I K U H S Z;B
M G I D X V R K L | M G I L D X R K;V
S G N Y W J O L M | M W J O G N L S;Y
L H R D P C F T G | C P H D F G L R;T
M K S I J C Y H U | H I U Y K C J S;M
A U O W E G T X P | P A T X E U G W;O
R U P S K I B W E | R I E S U P B W;K
Y J R U V F C H L | U R H Y C L F J;V
P X Y K V G R O C | O G K V X R Y C;P
S K Q A O H V N L | Q S O L V H K N;A
L A F J Q X U Z P | P L F Q J U A Z;X
I E T M H O Q J U | U O E T M Q I J;H
A X H U P S N R E | A E N S R P U H;X
R O W P E A U I C | U R C O P I A E;W
I L F Y U D K E M | E K L I U Y F D;M
T L C F E Q U O X | U L E O F Q T C;X
A K O W R V I F D | A W I D O K F R;V
I C K O H V D R A | D I A K C R V O;H
T X Z V D G F R Q | F Z D R V Q X G;T
U H Y W L F K C B | U L H K F B W C;Y
A E S Y X Z M P L | M L Y S E P X Z;A
R K N D I S P V M | N D V P S R I M;K
M D T Q L Y F W J | D M Y J L Q F W;T
D J I V Q A N S W | D N V A Q W S J;I
N Z R I O W B M K | B R K W O N I M;Z
H R U X O N C E M | U M X C H E R N;O
K E T D A S U C R | E T K D U S R A;C
N O M B V G U R I | B G R O I N U V;M
N H Y X C A G W V | N Y A G H X W V;C
B O T J A H V K Y | T A O Y H K J V;B
S J R L E T V Y K | V E Y K L T S J;R
G X R O F W Z J C | R O F G C Z W X;J
J A F S P U R O C | U S O R A C J F;P
E I R S C D B Y X | B I Y D S C X E;R
P F Z M T U S V R | U Z F R V S M T;P
X Q W O Y H S M R | M R Y H S X W O;Q
M P B O J X A E C | M O X E J A C B;P
X A G B Q M E W Z | X Z A M B Q W E;G
A X S N B P J Z O | O S Z J A B N X;P
M H S Y W K C X V | C K X Y S W V H;M
X J L Q V P Z O K | Q K V J X O P L;Z
K J S Y G F T U O | J T K G O S F U;Y
Q L E I X H K O M | H L X E M Q I K;O
F R H P N S U C T | F H R P U T N S;C
U I C H N G O K B | B I N U C H G K;O
S X I A Z E W R M | A Z W X I S R M;E
W Y L F J M X U A | F J X L U Y W M;A
J Z O C Q I V D Y | V J Z Y O I C D;Q
N F A V Q P H S X | N P F S X Q V A;H
Y F I J R C D A P | C P D A F I R Y;J
T K F I V W M E A | M E F K A V W I;T
E R C G U V A M T | T M C U V G A E;R
M H K P X T G J Q | P Q M T G J H X;K
J N D I X E B K R | I N K D J E B R;X
B Z Q M G R L O I | R Z G O M B I Q;L
G C T M X N F K A | C F M G N T X A;K
D N Z B H W O P G | H D G Z B P O N;W
A I Y O M L V S R | O L Y M S A V I;R
D V O H U E R M B | E R D O M B V U;H
Z J D U F G I R P | R I P D U J Z F;G
O X I P A U N K W | U P X N O K W I;A
B D N Z Q X A U H | Q Z A B H U X N;D
L X F Q N U M J V | N V Q F M X L J;U
U M X O F Z B K T | K X M Z U B O T;F
N I C E T M K G A | N G A T K E I M;C
R F B O U Z T E J | R Z J B E O U F;T
L X K U O T G Z W | Z T U G K X W O;L
Z K Y L R A N W O | O R Z K W N Y A;L
O M L A R D K H S | S L H K A R M D;O
R K Z E W I A F V | Z A R V K I W E;F
K V P Y N Q O T J | Y N K O P V J Q;T
K H L U J N Q W M | W K H N U Q M L;J
F M Y H K T B S J | B J Y S F H M T;K
F K G V S H A L R | K L H G V F R S;A
X J D Z O W R A Q | O W J A Z D Q X;R
Q U Z I O E S P K | S K E P I O Z Q;U
N U C L W A P F T | U L A F N C P W;T
H S J P L T I C W | L T I S P H C W;J
P N B O C W U K V | W B P U C N O V;K
U M F J S E Q W K | F J M W Q K E U;S
T I L M D S C Y B | B C Y M T S D L;I
A K F X C W G P D | F G P A X C D K;W
Z B F V A N T D P | P N V T F Z D A;B
C L D U S K M W I | L S M U D W I K;C
Y P Q J U O C H N | H J U C Q N O P;Y
I Y E V Z G F A O | F Z E I A O V G;Y
V N F W B H U C L | V W B H N U L F;C
U J K F A C T X E | X F J U A K C E;T
Q J R L K A H N Z | A H Q N R J K L;Z
L Y P F B G U M J | J G P Y B U M L;F
P K U J B L S W F | U J B K S L F W;P
I D T F L K S V R | R T F S K D I V;L
I Z L N D G S O R | D Z L R O S G I;N
B Z M R I F K E Q | R E K Z Q I B F;M
O R X U L V C E N | U N X E R O L C;V
U M Q P D W F G T | W M P D Q G F U;T
E O R J Y V D W G | O D E J G W V R;Y
Y J Q A D S H G Z | H S A J D G Y Q;Z
W Y T R J M Z V S | S V Z T W R Y M;J
T X L E A G Q U N | A G E Q N U L X;T
W O S T L X B Y J | B J S T O Y L W;X
G O J D A M S K T | S K T A O D J G;M
Y P M W S E G N K | K N W S P Y G M;E
R Q T P A W M G F | G M A Q T W F R;P
Z V M W Q X K N F | V M K X Q W N Z;F
T U H X F P Z W I | I H W P F T U X;Z
A W G J D K V Z E | W V D E J G K Z;A
S J O I L M T H V | O T V S L I M H;J
Z A J F C H Q P N | P H Z N A J Q F;C
B U E A X I J F O | J B A U X E O I;F
A H B U K W G N S | K S N G U B W H;A
M Q C I D F S Z T | Q M T Z C F I S;D
F U A L M E W P K | P M U A K F W E;L
B I N H T L Q R K | L B T I Q K R N;H
Q M I L U K W J V | V W M U Q I L J;K
B C Z N I H T Y P | B T N Z C H Y I;P
J Q C M V I F Y A | Q I F J V C M Y;A
K B Q W Z X T V C | B V T W Q C X Z;K
X P T J C K N F E | X P J F T N K E;C
E Z T F N H D B Q | Z T E N D F B H;Q
B V Z A O S K E Q | O Q K A Z B E V;S
K A Y B W G J T F | Y B J A W F K T;G
P Y O V B R G K T | T P K R G V B Y;O
C K F U S L V J Z | L V J S Z K F U;C
R I G C S U V J D | S R U D I C G J;V
C Z T M H V F S I | S F V H C T M I;Z
F N G S O B T E M | M F G T N O B S;E
R T Y S U P G B Q | B U P Q S G T R;Y
K M J I B R N S Z | R I S B Z K N J;M
N X B A P F E T O | P B E X T F A N;O
D X K M W F H N A | M K N D H A W F;X
J S T Y X F G H E | E Y S J G H T X;F
D V Z I M T N K S | M N T V Z K S D;I
I P L M T A K W H | T H K L P A W M;I
K M P V Q C R N Y | P Q V K N R C M;Y
L J K Q D Z R Y A | R D J K Z Y A Q;L
M U V Y J X C Q D | Q M Y J D U X V;C
S B N K J L G P E | K L J N S B P G;E
C J Z W Q F E Y O | O F Y W J Q E Z;C
I P U L F O H G E | H F P G I E O L;U
J Y A V Z S M O Q | M S Z V J A Q O;Y
C L M O H G V Q B | V G L M O C B H;Q
C S E P Z V N G K | G V S K C N Z E;P
T L I X Y O D K H | L X O K D T Y H;I
Z C T D R J M H W | J R C M T H W Z;D
B A W U I J V C K | K J U A V I W C;B
N I A M W R G F C | N R F C G I A M;W
Z N D R U A J E W | N D Z U J R A E;W
P C O G F M R U E | G F E C U P R M;O
U T L F D Z A G H | H T A D F U G L;Z
P G I F X K U T N | X G T N U K P F;I
C L N S A P R Q B | A B R S Q P L C;N
Z G A S P H W Y L | A W H G S Y P Z;L
Z X D H G I L C S | L X H Z S C G D;I
M O X J D W U Q N | W O J U X M Q D;N
A O E U C H G Y B | O U A G B C E Y;H
L P Y F G J D M T | G P L J T D F Y;M
F M Y S T I E K N | I T N K S F E Y;M
H T W O A Q G F C | Q F T A O C H W;G
P B F L G W V S Y | S V F Y B L G P;W
G B V I N J W R D | W R J B G D I N;V
M U H J V Z N D B | U V Z H D J M B;N
F O N C U K J L S | L C K U O F S N;J
E J Z A T U R G W | W J G U Z T E R;A
N D W V X C I J E | V J C N I E W D;X
P Z F C X L J Y W | W C F Y X J L Z;P
K A F X B L P U M | X U L K A B P F;M
R U D W X M L E B | L M W X D E U B;R
S C E N G A P B W | A G B C W N E P;S
V F X Z K B W J E | J V E Z F W K B;X
F Q N G H L V U T | N L H Q G F T V;U
W O P X U R Q F V | V F U Q W O R X;P
D X A M C B E S L | S C B E X A D M;L
E Q G O J Y F C A | F E O C G A Y Q;J
A X D B F P E C Y | B P C A F D Y X;E
W E N Y Q T O S A | W Y S Q E T O N;A
G M H R N L A V B | G H L R V M N A;B
B N Y L D M I Z H | H Y B I Z M D L;N
I G Y J B R N E M | R B J G M Y N E;I
L J S O V H W Q G | W G J V L S H O;Q
L E U S R D Z W X | X W R L S E U D;Z
N H S O M F L U J | M F L J S N O H;U
A R H M Z K G Q V | G R Z A H M K Q;V
W X Z V T J K M N | J Z K M X N W V;T
N G T B V R H F Q | F V H B R G T N;Q
J V T A I B N S Q | T N J B Q A V I;S
J U O B Y S Q G D | S J D U Y Q G O;B
U W Q R P H T G E | T W H P G E U Q;R
J C S Q Z X Y G L | X Y S C Z J G Q;L
N A B K W Y F H R | H F N B A R Y W;K
X F O E V Z K Q N | X E F K Z V O Q;N
P T H R Z V N O C | R Z O P H V T N;C
A X S Q P B N Y Z | X S B P A Y Q N;Z
O W D Z X G B P Y | Z W O D G Y B P;X
A Y U H Q D P I V | A I P Y Q V D U;H
U F G J H W D C K | G D C J K H F U;W
D O M A U S F X Z | M A D U Z X S F;O
D N Z V I G Y J K | J V Y K D Z G N;I
R H T F K Q O X M | Q F M K X T H R;O
T F R U K S P D Y | K S U P D T Y R;F
R P A E U L W Z Q | Q E Z W L P A U;R
F U Y M X E I C B | E I X U B M F Y;C
V Q X T J L P N O | V L N O X Q J T;P
H B V L J F G A Y | A L B J V H G F;Y
C M B V G U A Y K | G B V K Y M C U;A
L D O W H M Y I E | L M Y O I W H D;E
Y W V C Q M E T F | C F Y T W E Q V;M
O D M V H J R S Z | R M O H Z S J V;D
F N M Y X S L V R | V R F L X N M S;Y
W F I C Y E Q B H | Y H C Q I E B W;F
O W P J N U R H K | W N O P J K U H;R
P K V R L J O M G | O V M R J K G L;P
V L H S Z Y Q W B | Z Q W Y S H V B;L
S F U V D R L E N | R V S U D F E N;L
C I D Z P R T S U | P D S Z U C I T;R
D Q T O L N F Z R | D T Z F N R Q O;L
K H S J Q E Z X R | K R H Q Z X E S;J
I M X P U Y A N L | P U Y I L M A N;X
F P X G Q L U J W | W U X F G P Q L;J
K V I P W B L X Z | K X W V P B Z L;I
W S U M F T Q H I | H W M F U Q T S;I
U G O Q A F K B I | A K F Q O B G I;U
R A I P C Z S X U | U C P X R A S Z;I
W H G D F S J A M | J D F S H W G M;A
O K F Z S U R B I | R K S I F B Z O;U
X Z G R O V L D F | D L X V F O G Z;R
F K Y U T M N D S | T Y D U N M S F;K
H Z B D U J A R G | H G R A Z U D B;J
J B Y G I Q E U O | Q G U E I B Y J;O
R I Z S J Q V L M | R L Z V J M I Q;S
Q U L R F T K B M | M B L R T F U K;Q
E I M T P U L J Z | L Z T J U M P I;E
P C I Q U F L J S | F I C S P Q J L;U
B J A P X K T Z N | K A N X B T P J;Z
A L P J D C U Y T | U A C T D Y J P;L
J K X U E T G S P | E S X T K P G J;U
N V E S U Q D J X | E N D S V X Q J;U
X H G P T M C A R | H X A R T C G P;M
I N Y L D R U W C | R C N W L D U I;Y
Y U Z X N D G B T | Y U X N G B Z T;D
P R D C B I F W A | R A W P C I F D;B
D F W M B O J Z N | M W B D Z N O J;F
Q R H E K L S W M | E Q L K S M H R;W
F P H C D N R E A | E H A C N R P F;D
L V I S F U B O A | U F S A L O I B;V
X Y P U J O V T A | Y O P J V X U A;T
X B T H G R V U K | V T K H U R B X;G
W Z A X O E F H R | A O X Z H W E R;F
M X H R S T K G O | X H R M O T S G;K
L I Y D V X Q P O | V L I Q O X Y D;P
Q M O K E G I P N | N O I P E K M G;Q
M B Y K C V A N Q | V B K Q A N C M;Y
F R B X Y V O K I | I B K O V Y F R;X
G E W V C D X L N | L E W V G C N X;D
S M R J A I E D W | S E M J R I D W;A
J A M N K C O Z E | Z M J K A N E O;C
L C R E Z Q O J W | R W J C E L O Z;Q
Z I R W D N L H P | I Z L R H D P N;W
W I J P M S D Q L | I J W L P S D M;Q
T J W S Y F H G V | F V Y H T S G W;J
H L X E T M F W Z | E Z H L W M F T;X
G C Z H I N R V J | V N G J R I Z H;C
Y Z R S E Q M B W | E Y R M Q Z W S;B
E C F Q A S M W Y | M A W C Q F S E;Y
H M N L B R Y G U | R U Y H L G M B;N
G C H N Q X S W R | H S Q G C X R W;N
H F P V I R M J N | M I H J P N F V;R
L Q E Y T K G C R | Q C E Y L T K G;R
P Q B V O M Y R D | R D O Y P M B Q;V
M U E W N L T R I | R W U E N I L T;M
D B J L Z P M O C | M D L B O P J C;Z
H T N I V E M X K | X T N M I H E K;V
U F X G S B A K W | B A X K U S W G;F
N U K T H Z D B P | U P H K D Z B T;N
W H R N Q I F Y V | V F R N Q H Y W;I
K M F A Z X B R U | M R A Z F X K U;B
A J Z I M Q S U O | S M U O I A Z J;Q
H D G Y Q U I N O | N H Q I U D Y O;G
T R U X P Q S N M | S N U P M X Q T;R
L P U Y J F D Q E | Q P J L Y F D U;E
G R L J B M Z T H | R H L J M Z T G;B
X T O R M B H Q N | B N T R X Q M H;O
R O I D E H B W Y | E R W H I D B O;Y
O B Q W Y H E U N | N U W O H Q B Y;E
E T Q D I B L N W | L N B I Q W E T;D
W U Y T C E P Q A | P Q W A Y C U E;T
Z C W T Y D A N Q | C Y N D W T Z Q;A
M A N I J X H E C | M A N H J I E C;X
F C U N G M B H K | N M G H K F B C;U
O A F U V C X E I | U C E V A X O I;F
J X K B O E C V A | A B C E O X J V;K
P X T Z A N F E U | P U E T A F N X;Z
U P E Q Z V Y I F | I Z U F P E Y Q;V
M R K V Q P A S J | J V S K A P M Q;R
O A B K Q G Z H S | S K Q A H Z O B;G
L M V F H K W C O | K L F O M H V C;W
U R M Z Q X S E L | R S X E Q L U Z;M
R M E L G Q F X S | R G M E L S Q X;F
U L A R C B O G S | R A L S C U B G;O
Y E D H M J F G B | F D J Y E M B G;H
R M X B F S N P Z | Z M R P S X N B;F
Y L Z N H V S Q T | S Y L N Q H T V;Z
J P X A G B I Y F | G I X A P B J F;Y
U S O D L F Q I Z | Q L I S O U D Z;F
Q F G V J B T Z H | T H G Q B Z V J;F
Y S X O V B I D G | I V Y S B O X D;G
C J A V R F Y D E | A Y J D E V R F;C
C V Y S B Q O Z X | Q B Y V C O Z S;X
K U I R A M H T N | R N M I T A K U;H
N J G K Y P T Z U | Y T U N Z P K J;G
Z M C D H X S K V | K H M S V C Z X;D
G D Z C K I A X Q | D Z G X K A Q I;C
C T I N S Q X B R | N I C Q B S T X;R
Q I O V N Z B C Y | I B Q O N Z V Y;C
J W B Q I T P C U | P B W J U I Q T;C
G A Y X N Z R H P | N X P G Z Y R H;A
O M S Q T J G V R | S G T J Q R V M;O
W T S X P Y J N E | S Y J T N P E W;X
Q D R G X U O V S | U R S Q O D V G;X
U K O A F J H G S | U F G A S O H K;J
A J C Z E P L K I | P J L I Z C E K;A
M R T W A V O U K | K R U T W A O V;M
Q T R X C D A B U | B R U D T Q A C;X
K J G I N F C P E | E F N J K G P I;C
D F P G Q Z M H S | F G Z D S P M Q;H
D Z W F R E N H I | E I N H F W Z R;D
P K N R V D A U G | V G D A K U R P;N
Y L Z G A E K W S | E L Z W G S K A;Y
X D V T L M P C R | P T R V X L C M;D
N G M J Q Y L C B | G Q L C J N B M;Y
L X F N O R Y D H | R D O X Y H N L;F
Q O N M C J I L E | L Q I J O E N M;C
C A Z I N P B R M | B N I P A Z C M;R
S J T V I X N L F | I J N L T X F V;S
B R H Z G F P C W | R F C W P B G Z;H
H T I U R Q G S D | D U S Q H I R G;T
F C U P L D H G W | H L W G U P D F;C
W Y T N M I J Z U | U J M Y N T W I;Z
C G T P N A V W F | F G V N W T P C;A
B M F A K T N I J | F A N T M I K J;B
V U D S G J X O B | O G U D X V J S;B
B P C J T V Y Q K | J V K B P Y T C;Q
M Q R L K D H G Y | H M G R Y Q K D;L
V M F S L J O C P | J C S O P M F L;V
Z L M S Q E J T C | J T Q C E L Z S;M
E X M D Q R J B Y | R X D B J Q Y M;E
P K C U Y B F O G | G O F Y B U K P;C
S J W T V P Q A O | T P J S W V O Q;A
Y R T O E U P S B | O U P T E S B R;Y
M Q A W N E S I K | N I Q W E A S K;M
C K O H Z X Y J S | H X S K O Z J Y;C
Z E M H B J D N S | D S M Z J H N B;E
Y T G X V H J A P | V A J P Y X T G;H
W D C R X T U P N | W P X T N C R D;U
Y L Q I U D F M G | I D M G L Q F Y;U
Q T D R M V G P H | V R Q M G P H D;T
T Y W V K A L G J | L Y J G A W V T;K
R O M J Y E T I V | T I Y M O R E J;V
M G V U S C F X D | F M V G S X U D;C
O B H A L E C M T | O M C A B E H T;L
N X F K M Q V T G | X T G K N M V Q;F
V H L R Q M N P Y | V R L Y P N H Q;M
F G Z N V C S P J | C Z P V J S N G;F
O Y I G Q T B Z A | Q A Y Z I B O T;G
I D C A B Z J K L | K I Z A L J C B;D
L K C G F B R Y A | G R C B L A K F;Y
Z T X O U N I C V | I X O U T V N Z;C
A R T M L Q D Y U | D M A L Q Y R U;T
V T A F K S B H E | V K B F T S A E;H
U O X L Q F G K Y | Q L O U G F K Y;X
O C V F A Y M U D | D O V M C F U Y;A
L F Y N V M O R J | J V R M O L Y N;F
R J G X Q F U C S | R X G Q U S J C;F
L Y B H Z Q P I C | Z Q I P C L H B;Y
V Q M K J E N T R | J N T E V R K M;Q
X F Z M R D U S T | M R Z D S F U T;X
C A P V J Z G F B | B C Z G P F J V;A
W I S L A M P E J | S J I E P L M W;A
A M G J I C B H S | I A S M J G B H;C
K F B I Q V J T C | B V I J Q K C F;T
L U D E J I Q C G | U E C G D L Q I;J
I Y D T Q V S E J | D E T I Y Q V J;S
T E C L V Y P J M | T M L J V C E P;Y
H E Y Z J D F R U | E U H F Z J R D;Y
U T C W G D B P E | E P D B C G T W;U
G B L Y S D A J C | J S C D B A L G;Y
W X F Y G H E U P | U F Y E W P G X;H
M L K B O W J G R | J G B W L R M K;O
Z L Q W J S G T D | L T S Q J G D Z;W
W A N D V U M L C | M A C V D W L U;N
A U V Q I M K P G | A U M I K V Q G;P
J H X Q B A E D C | D C J A X B H Q;E
T V Y E J N Q G X | N Q X E Y J V T;G
D Q W S O B T C Y | D W C Q T B O Y;S
Q B A X C R T G N | A N X G Q C T B;R
Y A N T L E H Q C | C T H A L Y E Q;N
Z E A C F V H X J | E A H F Z J V X;C
K Q O M B N W L H | L N B Q O H M K;W
Q U K C V P B S A | K B P A C U S V;Q
D Q L B U J G I W | B Q L W D I U G;J
F Y P T N B W J X | B T F P W Y J X;N
N U A V F R Y X W | F Y X R N U V W;A
D N O I U B M H Q | O N Q M H B I U;D
T M N O G F Z X C | G Z T F O X C N;M
X F U M L N D E J | J M X N F L E D;U
D H Y K Z R M F P | Z K Y R M P H D;F
Q E W R V T X H B | Q R X H T W B E;V
D V G F J S C K Z | J K S V G D Z C;F
K C N P A Q Y E M | Y P K M N E A C;Q
C N L H K I Y G O | N K L G I Y C H;O
Y U Z B N X T E C | U E C T N Z X Y;B
B C S I H O Z X V | B X H I S Z C O;V
B J N I E Z W D V | W J Z E N B V I;D
Q E P Z M K D F S | M Q S E Z K D P;F
K A O X E Q D S H | K E A D X O Q S;H
Q J I C E P H B K | Q J H B E K I C;P
E R D Z P I B O J | P Z J R I O D B;E
A P R E M J N U T | P N A M U T R E;J
K B M T G X W J D | T B D X G J K W;M
D K G J H C E O V | H G D J V E C K;O
V E G B O H M F I | V O F E I M G H;B
L N R D F T G Y I | I R Y T L G F D;N
N M D F P A E W L | F P W D L M N E;A
G C P Y Q R H N L | L P Q N G R C Y;H
P K G A D B E W S | E B S A W G D P;K
Y X Q G W V J O S | W O S Y V G X J;Q
D E G O B I F V X | V X E B G F D I;O
Q O S C A F I M Z | F S I O M A C Z;Q
U B A W J M Z C H | M A C B U H Z J;W
X A R F N Q D I H | Q I A F D N H X;R
W T E S B Q L X A | S T L Q X W B A;E
F M K I Y Z G W N | I G Z Y F W K M;N
J H G F Z C I E U | H E Z I G U J C;F
Z H S M O G P C W | C S Z O W H P G;M
O P K T U B I V F | O T B I P V K F;U
N J E B X R W C Z | R Z W N B X C E;J
Y O S P Z X A C Q | P Y X A S Q Z C;O
U G K M L W J I P | L U M J P G W K;I
H B K Y I G M E O | K I G B E M Y O;H
C M L F V Y B Q J | L V M Q B J C Y;F
M P C U H V A X Y | U X P M H C A V;Y
F G A K L O E X V | L G E K X V A F;O
W O A D I R U H F | F A R D I W H U;O
A U H M V T D B R | H V M R B D T A;U
E G A Q R L M F C | R F A C Q M L G;E
M D W I Z H C B A | Z A M D W B I C;H
E H Q L R K C M S | H M C K Q S R E;L
C V Q R Y F J D W | F W R C D V J Y;Q
G B T M N E F H P | T B E P H M F N;G
Y T E R B F V Z M | T Y Z B R E V M;F
U C X F B R Y L W | X B F W L Y U C;R
A F O X G E L J U | A J U O X L E G;F
A F B H O Z W D V | O Z A H F W V D;B
R B H J F N Z P G | F H Z N B G P R;J
R A V H T C K S G | K G R T V C H S;A
C F X U Q J K M S | M J F X U Q C S;K
U V R W M A N F E | N V M R U A W E;F
B Z O E F P X G D | Z P O G X D F B;E
J F P K W A T L C | K T F P J L W A;C
X I C E Y Z T A G | Y Z C T I G E A;X
L I R F W T D M K | I R K F T D W M;L
T J O G M H A P Y | J G A O M Y P T;H
H F Z Q W E N M C | Q H N F E C W M;Z
L G X E H I C J R | E C I H L J X G;R
U D N W R G O Y T | W U G T O R Y N;D
E W O F L P T Q A | W Q F L A E O T;P
I V K Y E C Z S D | I D Z C Y E S V;K
D B L A F M C Q T | T Q C L B A D M;F
E Z P A J V N T X | P X E A N V Z T;J
K Z H T I O X E C | H E T I K X C O;Z
S Y Q A G B C Z I | C A G B I Y Z Q;S
P S D W H J I T V | D H S J I V W P;T
X U W J A V F I T | U A F X W T V J;I
V P I Q K Z E Y B | E K I B Y Z V Q;P
Y B K L W C I R H | Y W B K I L H C;R
W S H E G D U Z R | Z E D U G W H R;S
P L W C H I O Q D | C O W Q I L H P;D
W U A J Z B L P Y | L A U J B W Y P;Z
X K W B J G T A P | B A G J K P W T;X
U W E Q V J O D Y | Y J U D E V W O;Q
D I Y W E V Z T N | Z E W T I Y N D;V
Y H J P C E V W G | G V J W P C H Y;E
V S O A Z E N K D | K Z D N S E A O;V
Z Y N U D I Q H S | N Z D Y U H Q S;I
U L S Q D V R B M | D Q B U M L R S;V
C Q I B Z T L E Y | I Q B C L Y T E;Z
K S O E C F T B W | B K S T W E C F;O
E D B R G Y W O S | Y W R S G B O E;D
J O L K A G Y N C | O N C J A K Y G;L
Y L T K O A Z H P | T K A H L P O Z;Y
O X R F D G Z C A | F G A D Z C O X;R
Y P E J V B M G C | B P C V M J Y G;E
Z G W B O S U X A | U W X A Z G O B;S
D I U Y B K R V S | V Y K D B S R U;I
M B S J O G Y P Z | Y Z G B O J P M;S
K C E D Q N I P F | F K P N D I Q E;C
M R V B T I E Y U | B I R M Y U V E;T
L N Z P B H K W J | W J Z N K L B H;P
L H Q A Z V C K J | L A Q V J Z C H;K
L R V Q D X E B G | V D B L E R G X;Q
S Q A U H I P Y B | I S B Y H Q P U;A
A R J K F X Z Q G | K G Q R Z J X F;A
G K Y F D W I X Z | G X I Y K D F Z;W
A K P U C V Y J S | K Y S U A V J C;P
H T E P I O V G B | H O V G B I E P;T
R I X S G T A D O | O I A G S X T D;R
M F P Y D C W K O | Y C O D F M W P;K
I B U G D E L Q M | I D M L Q B E U;G
X M P N R Z E T V | T E N Z V R P M;X
H Q W R V M J Z B | W J H Z Q R B V;M
X V P J D W U C H | P X U W V J D H;C
L T U I H S R B V | H V U I S T R B;L
Q D E Y P B S J G | G B J Q E S P D;Y
V R C S O Y U A H | V C S H U Y A R;O
W N L P U S D J V | N U L J W V S P;D
H F S E T X M J Z | E M S X F J H Z;T
O M D F U N C Q P | D N M C P Q F U;O
V W Y I P Z C D M | D W P Y V Z I C;M
N Z U A Y O H W P | Y Z A N O P U H;W
B I L W A C X Q S | I Q C W L S B X;A
X E R K U C B P H | P B U R X K H E;C
O Y C X A T L G V | A O T L C Y V X;G
H L S E C Q P X B | X E S B H P L Q;C
Z P J Q B X H I U | P B Q X H J Z U;I
F W I Q D R V B E | D I Q F B V E R;W
Q I K O V T E M W | I W E Q O M K V;T
P Z B E I X J D R | R D B X E Z I J;P
C R Y D L W E A U | W L A C R U D Y;E
E S R N P B L O C | N O P L B C R S;E
Q I D H U V F P X | I X U Q V H P D;F
P X Z T D V Y R I | Z V P Y X R T D;I
C R U P O Q K L Z | L P R U K Q Z O;C
V C K G P N A R H | H G K N V C P R;A
U Y O S V B L R A | B A S U O Y V R;L
M K R A J Z W Q F | M J F A Z R Q W;K
O D G I R B E N Z | O B I N Z E D R;G
I B Y J F U N W P | U F Y P N W J I;B
Y L A U G Q M D N | Q G U M Y N A D;L
E Q L C G S V B A | G Q C V B L E A;S
O X D R I Q N V U | D N O Q U R X V;I
C V Q I P M W H S | S H Q C M V W I;P
S O Z D U F G M X | Z O G F S D U X;M
F N J D I L B C Y | Y L C F I D B J;N
Y T R X Z Q N F W | Y X Z F T W R N;Q
D N U Y A P I W X | P Y D I U X W N;A
D G I C W A R E N | N A D W R I G E;C
W Q N R E F K X G | G W R Q F X N E;K
R H Z E T Q X U M | E T R U Q M X H;Z
N H V J M G T D W | G N T D V H W M;J
V Z R K U I H D F | H U R K D F V I;Z
R K M Y X H C S F | M X H C S K R Y;F
J L M R B U G S I | J R S G B L U M;I
B Z X J U E P K H | P U J B Z H E K;X
D M Q R P J O L K | D M P R K L O Q;J
W E X J B S H Q U | S U H Q J B E W;X
K J H V A O L Q M | V K A Q M L J O;H
B Q T K Z M N J G | Z J M Q T B K N;G
U W X R O V B H G | H X W O V G R U;B
H Z I G M D P B S | G D B P I M Z S;H
C M J N H B W A L | N J B L W M C H;A
B R V J D W Z T S | S B D T Z J V R;W
L E B O K Z I F W | E I W O F B L Z;K
W G T S M F J L B | G F S W T B M J;L
Z V C B S P H I K | I B H K P S V C;Z
J F O U T R C K H | J F K C O T U R;H
V S B T R Y H I G | Y G I T B H V R;S
B T G V N X Y J M | Y T J X B N V G;M
O C M D W V S H K | D V H C O M W S;K
B O Y H N F P M U | P H B N F O M Y;U
O F N Y K M P U V | M P U O Y N K V;F
U B Z O N E F S G | O F G N S Z B U;E
B C H W P L J N V | C J L W N V B H;P
Z G M D A V Q O I | I G D O A Z Q M;V
Z V U Q K P A W X | X P A W Q V K Z;U
T K R P S N U F X | F K N S R U P X;T
D C A J K S N P Q | P J D A K N Q C;S
O V M C J Q H T S | J V Q M T C S H;O
P E V C M F Y W S | P Y C M W F V S;E
A J P R C I V Y S | S V J R A P Y C;I
W D B O I C P E A | A E B C P O D W;I
L T U A X C G I E | L A G X E I U C;T
U V X Q S J H K T | U H S T X Q J V;K
Y A T M H V C G X | G Y X H C T A V;M
U J X H N L Q Y I | H N Q J U X I Y;L
W R Y L B N T A O | R B N T L O W A;Y
F U K Z A J N T I | F J U A Z T K N;I
O L P F Y Q M E D | D Y Q E O L M P;F
C B E T I M D K S | K S C I M B D E;T
H L X O B N W F Y | B Y W O L H X F;N
O A F S K Q U V I | Q A I U V K S F;O
Y I T C Z J K W G | Z I W C T J Y G;K
U O H V F A P W N | O F W V H P U N;A
O U P D E G J N R | G U R O N P D J;E
M T V W Y C J O L | T W V L O Y C J;M
P R B N K W Y Z F | Z K N B Y F W P;R
Q D Y W I K T S U | Y I S W Q K D T;U
E Y L C M R T B K | T E B K L Y C M;R
S X U L Z K J T O | L O S J U Z X K;T
M D T I W F J U C | F I W M J D T U;C
X S P N R T G V Z | T X P S R V G Z;N
N S U C G R B L H | L B C R G U N S;H
V O D C I M T A Z | I O D M V T Z C;A
C Z M S F D X W K | Z K W F S M X D;C
E F L K H U S N P | F H U L N E S P;K
V I M X E Y K B H | V E B Y I M X K;H
P J G O E D R Q F | Q E O F G J P R;D
Y G F I V A D X E | X Y I D G A E V;F
R P O D K X N V B | B R V X K O P N;D
J R S O Z N V I A | I O Z J N A R V;S
Y Z O P F W X G L | O F L W Z P X Y;G
E L O C V S W K H | C K W L H V E S;O
W O D S M F A P Z | P O F D W S A Z;M
L M X N S I P K D | M X P K S N I L;D
I B D Q K T N Z V | V T N D K Q Z B;I
E J U G K Q R D B | Q D U J G E R K;B
J U Y C Q E B H O | Q U E Y J O C B;H
C Z T W V G U S F | F U Z G C T V S;W
S A K R Q M X U Y | U S X Y R A K Q;M
R S P X G O A I M | R O A X S G I P;M
X S T Y C K G M V | M S G K X T V Y;C
I O E F H U J L R | E H O U L I F J;R
P H K S Y L J D V | K J H P Y D S V;L
S X M U H A W I N | I A W S U M X N;H
L F W T I G Q C O | Q C O G T I L W;F
C H X F V Z P L U | X F C L V U H P;Z
J P G U Z Q C S X | U S X C G Z Q P;J
B E N S O X I L Z | B S O X N I E L;Z
P I L B S Q X A K | L Q K B X S A I;P
N U V W X J R C M | C U R W J V N X;M
R Z B G V X J N L | V N J X L B G R;Z
N J C U A I K W O | U A C J W O I N;K
J A H E N K L T V | K H L A J V T E;N
R B F D K Z A P X | D X K Z P F R B;A
N Z Q A D K V J W | D K J A W V Z Q;N
H Q C E A K S R I | S Q I A R H K E;C
F J O B D I N C T | T N F J B D O C;I
I N R Q Y P D H L | I P D R L Y H N;Q
C N K R J G L O D | N C R O G D K J;L
L H V J X I N M W | H W X L M V I N;J
Z W I C E K D J L | E C D W Z L K J;I
P Q T D W V O H U | W O U T D Q H P;V
S Z K P E T Y X Q | Y Z E X K P T S;Q
L A S H B M K Z F | F A M Z K H B S;L
E G T N K M X Y U | Y G E T M U X K;N
V C L T W P E Y B | E Y L P W C T B;V
W Z A X U O T B G | X T G Z B O W A;U
U C H M G Z F O T | F M H O T C Z U;G
I Y K E A L Q F M | F L Q I M A Y E;K
J F P L B T Q X Z | J L Z P X B Q T;F
T R L H Y S B G N | L Y G B N H R S;T
L T Q S Z K W C J | Q W L T J C Z S;K
N O S Q Y Z H G V | G V O H Y Z Q S;N
Z U O P L R F G X | O G Z U F X P L;R
S O F R P U Y L M | L P O R F Y S U;M
G B Q T A U J F D | G T B F A D J U;Q
Y U M P T H R V O | R V P M Y U T O;H
H N K G D B A R X | D X B H G K A N;R
Q V K H M N F S P | V M P F Q N K S;H
N Q B C U P R T Z | N Z T R B U P C;Q
U B T Y M J F V D | F V J M T B Y U;D
Y J U O D L Z K Q | J L D U K Y O Z;Q
Y G V S J R C A Z | S Z A C J G Y R;V
R K S Y U O L I X | R O K X U Y S I;L
U G Z J D M C S W | Z U W G M C J D;S
J P X W U M E C Y | J W Y U X E C P;M
L M T G Z U W P J | T M L P U Z G W;J
Q N I W R A F T J | W I F A R Q T N;J
B T K S Z G H I O | T I Z O H S B K;G
Q U T F A E P J X | E A U T X P J F;Q
O V C A G U Q X L | L O U G X V Q A;C
Q B V T A D W C N | N T W D V A C Q;B
W K N F B R P J A | P R K B W J N F;A
Q A Z W L D U T F | Z U W F T A Q D;L
A M C K X O Y B F | C M F B Y A O K;X
F A T Y L I B S P | L P T S Y B F A;I
S O N M F Y R A P | F Y N O S P R M;A
P S W F R N H L K | H K L W N F R P;S
Z T Y V N B X J H | B Z H X T N V Y;J
M J B Q K N U C X | U M N X K J B Q;C
I E Y Z N O T M F | E Z Y T F I M O;N
J X O B G N E Y F | B N Y G O X E F;J
I C K G D O M J U | I O J G M C U D;K
W R T O Z Q F B E | W Z E O F T R Q;B
W P F D B Y Q I C | C W D Q B P I Y;F
V G H C M P W S N | N V G P W H C S;M
F T J H Y B C X P | P J T C B X H Y;F
G W B E J Q K C Y | Q J W K G B C Y;E
V A D C L H S K O | K A D V C S H L;O
V W U J Y H P D S | S H D U W V Y J;P
N X T G V U F E O | N T F G V U O E;X
M D C S H O Y K J | C J M K S Y D O;H
P C R X Q G H U N | X P U H G Q R N;C
S N B G P T L I C | T C B G I N P L;S
J R F C D Y S V L | D Y V J F S C L;R
J T U Q E M H Z I | I Q Z J H M T U;E
W N B M Z T Y C K | W M B C K Z N Y;T
Q Y Z O C E J A H | J Y C A E Q O H;Z
Z F V Y G W I A B | Z Y B V G I F A;W
P S N D O W B K J | W N P B S O K J;D
R D O A U S G L E | G E U S L O R A;D
L G P M I A R E J | E J R A G P I L;M
V O Q K T H X N J | T O K X H Q J V;N
J F S L D B C K V | S J V L C B D K;F
I S L O M H C W V | O I M L H S C V;W
F L W T U S Y D Q | D S W Y U Q F L;T
V E B S T R I H Q | I R S Q B H V E;T
W M O I P C Q H S | W I M S O Q C P;H
I W K T Z S J R V | T S V K J Z W I;R
R V I W S B Y G D | Y S V D R B G I;W
Y V F O G T N K L | L G F Y K N T O;V
Y Z D V W B H J T | T Z D J B W Y V;H
G K J M O T I V E | I O K G T E M J;V
Q L T V U I F S W | T W V S L I U F;Q
I Y B X A L K O W | K A W B X L I O;Y
O U P W Z I K M T | M Z O P W I U K;T
Z N G D C Y O R P | R P Z N C O Y D;G
D X G F K M V O R | V D O F R G X K;M
I H B Q Z P F T S | Z F B Q H I P T;S
Z Q R F N X W J E | Q F E N X W Z J;R
M W U O F K D J S | M F D O J W U S;K
R M C J Q G I E D | R C Q J M I E D;G
O A F Z D B E T N | B D O N E F A T;Z
L H A I Y O M P T | L P T I Y M H A;O
W T M B G O D P Q | Q T G W M O D B;P
G R B J Q A V S K | J R Q G B K V S;A
N K E F P C D A Z | K C P E F D N Z;A
U R E V Z W Q J L | Z W V E L Q J R;U
W M Q F N L R B I | I L M B R N Q W;F
D J Z G R Q O B A | J B Q Z O R A G;D
O T L R Z J D V N | O R L V N T D Z;J
V D E I O L A J U | E O J A U L D I;V
T J L U M P R S G | P T M J S R L G;U
Y M A J B G X L T | G A J X B T Y L;M
S M Z K G D J C P | M D J C G K Z S;P
M L J C H G E A U | U E J L M H C G;A
F G H P E L V M N | V L H E F G M N;P
Y C O V M K T Q E | T C K V Y M E O;Q
B E G F U R H W Q | B F Q H W E G U;R
E B P U R T G S C | R G C B T S U E;P
H F N J X Q I A V | A N J X I F V H;Q
N V Y L Q C M A O | Y L N M C V O Q;A
I P K D O G C M F | F I P G K M O C;D
P L E C U G R Q V | R U C P Q G L V;E
K X J R I L Q B U | J R X U L B I K;Q
C F I V K E T X U | F T K U C V I X;E
A D P Y O Z W B S | P W Z A Y D O B;S
V L U S N Q W F X | W N Q U X V S F;L
F E A U D B P G M | A G M D F U E B;P
I X L T S U K R J | K R T L X J S I;U
O J S G K R Q F B | S F Q J K R G O;B
R G S J L E U H Q | E H G Q L S R U;J
J C V L H Z Q R T | T R Q J L V Z C;H
O G E Z A L V D T | T L V D A O G Z;E
V M K U S N I B A | B A I V M U N S;K
S Y U K Z V D X P | X D K Y S V P U;Z
P U C M S T R J Q | S Q J U T R C M;P
O I H V X J C E F | F X O C H V J I;E
F H M Q V X T G P | G T Q M X H P V;F
Y C P I S V Z G E | V E C Z S I G P;Y
E L G P W Q H F R | E W G F L H R P;Q
X F O S A L G N U | S A N O L G X F;U
I L Y A N R Q C T | T C L I Y R Q A;N
Y B A P M N K J R | R K J N M Y P B;A
V T Y H X L S N G | V G Y S X L T H;N
K D M P G U Y S B | B G U M K Y P S;D
L C D G U Y I B R | L D C U I Y R B;G
O Z V M W N K E D | E N M K O D W Z;V
X J K L E H N Y I | K N J H E X Y L;I
E C R L H O U J Q | L J U Q R C E O;H
W R K L S G A V O | S O L A W K G R;V
P X A U M F V T Q | F U Q V M A T X;P
W N Q Y T H F C O | W O Y F H T C Q;N
P B R C U Y G N X | N U C X R B P G;Y
O F L N H M Z J B | B H Z F J M N L;O
T Y M O E D I L A | A M O I E L T D;Y
Y F H O J M A K U | H K O J U M A F;Y
N M L E S R P U F | R N E U S P L F;M
I V O Q L B M Y W | M Y B Q O W L V;I
Z F U V O X M I P | V X I U M F Z O;P
V U L W Q Y Z E N | E N W Z Y U V L;Q
H C M R K O X I J | I O C X J M R K;H
F I N R X Q W E B | N R B F W Q X I;E
D L V X R U N C I | X I R D U V C N;L
W L O T G M I J S | G J M S L O W I;T
H Y O W R K Q U V | W H K O Y U Q R;V
N W G V F Z L P K | Z N G P L K F W;V
X K S Q C R J O V | J S K V O C R X;Q
W G T Z N S U I B | S W T B N G I Z;U
B Z S H N Y J X A | B Z J S N A X Y;H
U Z M O T W S J G | U O J M S Z W G;T
D P R E Y U M G Q | U P R G Q Y E D;M
C E P L T A H G D | T A H E P D G C;L
W D L O R H S T N | L O T N S W D R;H
R O B Y N W V M S | Y N R O M V W B;S
E F C I H Z N K V | N V F Z K C H I;E
L F X D N U J V A | X V J N U A F D;L
E K H Z D N I S B | B Z E K D S I N;H
T Y K Z I G L V N | Z I Y G V K T N;L
F U S M J X G W E | X M G S F U J W;E
P B M X H W V N K | H K M N X W P B;V
N B A I E C D G H | I D N C A E B H;G
X I S V W L B H O | S O B W V L I X;H
C G T F Y I U S L | Y G T L C S F I;U
O W C U F X G V T | T G C X V U W F;O
Y S P V N F U T C | S Y F N C P T V;U
Z J P B K S M D F | B K P J F M D Z;S
M U K E C G X F L | X F C L K G U M;E
O L H N C R S Y K | H Y R K C S N O;L
O U I V R S F C M | U M V R S C O I;F
P X S F D V Q T R | T F D V R Q X P;S
G W T N K B L F R | G N W K L T R F;B
L M U E I C J W V | M E W U C I J V;L
G O H D K P J N B | D K J B G O H N;P
Y S Z G C Q E H W | E H Q Z C W G Y;S
B E A Y C Z Q H K | K H Q B Z C Y A;E
U P W L Z A G S M | L P S G A Z M U;W
H J T R X Z B F Q | X R B Z Q F J T;H
Z S N Y O L B D M | Y S Z O D N B M;L
A B F H D N S O W | F S A D W H O N;B
T L P Y G D J X N | Y L D J G P X N;T
S R N A H G Y D C | G D N S A Y R C;H
V N Q T O H Z G E | G N E H T Q Z V;O
W M Q G V I C B D | M G I V W C D Q;B
Y J I D N P F H A | H N Y P I A F D;J
Y A F Z P Q D O T | A F T Z O D Y Q;P
X G B Y H F R Q I | X I H B F G Q R;Y
Q O A T B J K I H | J O Q I H K A B;T
U M Q F X A O D K | X K U M Q A F D;O
E W F U Z S C G D | S F D G C U W E;Z
G N I H A T K U E | I A K T H U E G;N
I P C B J E U F Z | E I P F Z J U C;B
R X I D V P Y H N | N I R V H X D Y;P
S F L X P B C H Z | X L H B P C Z F;S
T L Z H S Q R K I | R Q I K L H T Z;S
V Z R G S Q T K D | Q T S V K Z G D;R
G V T D U X J E H | U J T X E G D V;H
W L U R T I Q P M | T L I R W M Q P;U
J D F L E K W S I | S I D L K E W J;F
W Z B J I Q R A C | Z I Q R A J B C;W
U P G E I T F S O | S I O E T F U G;P
K O L Q H P X C T | C L K O X Q P H;T
J Z W P H D I U C | U W C P J I D H;Z
E G K Z S X W V Q | Z E K G X W Q V;S
X B H T U P D J Y | P J B H X U Y T;D
V X R F Q Y A W E | A Q R F W X E Y;V
N D L J H T C F B | H F C B L J T D;N
H N Q M K F G S I | S I Q G K H F M;N
E N D O X K I F Y | O X D I F Y N K;E
V H E M K U F D T | V D F M H T K E;U
A J N P F U W R M | M N U R J P A W;F
D F U H E R X G W | W F G X D R H U;E
V M L K Y F T E G | V M T E F G K Y;L
U H Y G C A R L W | L Y R G H A C U;W
H Z O V W X G E A | Z H X G W A E V;O
F J Y R S M O G L | S Y J L O F M G;R
D M Q A W O H K R | W K Q M O D R H;A
K C B A U H X D W | W B X C U H A K;D
Q P C X F V O E R | Q E R C O V X F;P
O Y G F H S B Z D | S G B D Z F O H;Y
G U Z L R N D E K | G R K Z U L N E;D
M L Z W G V T Y X | L X M G W V Z Y;T
X O A S M E C Y B | C S B X M E O A;Y
X F E I U K H R W | F X H K R U I W;E
G E V Y X B W P K | G W E Y X B P V;K
F M I R B E V Q J | I V F M R J Q B;E
O S Y X G M H V P | S X H Y P O G V;M
L F N X K W T O A | N A T F O K L X;W
I H X A E R M J T | X T J E I R A H;M
L B M R P Z J T Y | T P M Z R L J Y;B
N O R K W B A I V | R B O V K I A N;W
M A C H N P X V K | N K V M P H A C;X
J S M K E H Q R B | E R H M K J S Q;B
P E U K V C O X Q | K P E Q V U C O;X
K X G T S H U V Q | X T U H Q V K G;S
H B E M U D Y O S | M S E B U D O Y;H
S F L H P C U K I | C S F K P I U H;L
Y O E N B A D R W | Y O E D W N A R;B
S L U J I M A D K | K U J L M A D S;I
X Z R S V K I T M | V I X R S K Z T;M
W S A R J B H Y Z | W H A B S Y R Z;J
N K J C S X F L V | V L C N K J X F;S
W K M T H G X E O | O K X H W T M E;G
T S F O J P H M L | H J P T L M O F;S
L M E V J P X C R | L X R P E V M C;J
P J U W V N C Z B | C J U W N V Z P;B
S Y N J P K D O X | X K O Y N D P J;S
L E D Q A N S G M | L Q D M E A G N;S
Q A M G F Z B N Y | B Y Q A N M F G;Z
M G C T X V Q A R | C A V T X Q R G;M
Q W O J A D C K M | D M W O K C J Q;A
N V S F G A Y M U | Y U S G F M A N;V
Z S M A O E N I W | Z I O W S E N A;M
W M I T B H Y D A | B D Y W M A T H;I
Q E C B J H N A W | C N W Q H A E B;J
O K J Z S C F R Q | R C Q O K J F S;Z
Y J Q M O F E S N | E S M J O Y Q N;F
V C O B U A G K X | V U C X B O G A;K
Q Z N B X P R L U | P R N B X Z L Q;U
C J S M V T H Y G | T Y M V H C G J;S
Z B P X A G U C K | Z X B A U G P K;C
S N L H I G D R Q | H S N Q I R D G;L
F M Y E U Q N R W | W U F R M N Y E;Q
P S W C D H J T K | P T S D H K W J;C
L Q D Z U N K B V | N V B L D K U Q;Z
G J W D E F Q T L | F J L T Q E D G;W
D G S T H P U K O | K T S D P U G H;O
Q Y O E C W M N R | N O Y R C E W Q;M
H F A O J R N W T | W F A T R O H J;N
R U Q H Y P C X Z | P Y R X Q Z H C;U
H M S G D J U L A | H U A S J D G L;M
S Y T Z R A U O H | S Y H A O U T R;Z
U Y O N A W Z X C | Y W Z X O U A N;C
C R N D T A S B H | N S B C T A D H;R
S O K V J B L D N | N S D B L O V J;K
K W I Y A G Z L E | A L I Y K G Z W;E
P C T D R G L W I | I D G L W C R P;T
O I G L J D N K V | K J V O N L I G;D
X O P T G S N M I | O I T X G N S P;M
T N Q J M F U V G | G T Q U N J M V;F
J B G V M D H S C | G J S D B C V M;H
L Z E U F M B H I | H L I M F Z E U;B
X I P F J W G T Q | F J G T I P X W;Q
Q G U J X N V S P | P V U X J S G N;Q
K O D Z S Q U N V | S O D N K U V Q;Z
Y A R Q X W C U L | Q C U Y W X A L;R
E K S V P Q T H Z | K P E V T Z S H;Q
I X V B L N A H P | V N X L B I H A;P
C G P Q O L H B E | H E Q G B O L C;P
K J H L V E O C G | H C K L G J E V;O
O I U H C Y G F L | L I G F C U Y H;O
D J X A L O Z S I | J L O A I Z D S;X
D J Z M F X Q H S | F J Z S M D Q H;X
M B T J A Y I Z E | J B E T I M Y A;Z
T X D I F C W O N | T W C N I F D O;X
Q G T K M I A F N | Q N G M A K F T;I
S Z U E Y L G H W | W H U Y S L E Z;G
M X C O N U I A K | A U O K I C M N;X
O M K C Y A G W F | W Y M G O C K A;F
C J L H E M F R O | L H O C E M R J;F
K D E T Q Z P M L | P L Z E K Q M T;D
X Z H P J Q C K S | X C P S Q J H K;Z
S J N C A F B P O | B P F N J S O A;C
X J V G Q I R S T | S J V R X G Q I;T
P C J I B T F W H | B T W H J I P F;C
L W Y I X Z P S M | M P I S Y X L Z;W
P T B U D Y J H V | H J V Y B T U P;D
W T M G X H C Q S | S X Q W M T H C;G
C J I N S R Q T P | C Q P R N T J I;S
L Z C B I X V N Q | I L N Z V B C X;Q
L U Y S I T O V G | V G I U S O L Y;T
F A X E Y I U T N | F X Y N T U E A;I
I Z D O H J A P U | H U I Z J O D P;A
N S O F Z V J D T | O Z N F D J S T;V
M G X Y S U H B A | S M X A B U G Y;H
B Q Z M A S C E H | H Q A B E C M Z;S
N B D H J S Q W V | B J V N S D W H;Q
Y T X E N G W K Z | E T K N G Z Y W;X
B F E Y L X S J R | B E X Y R F S L;J
E Z F A X S J N R | S J Z F E R A X;N
Z F K T B H N A C | Z H K A T N B C;F
J V G T U O I E Y | G E O J U Y V I;T
E Z G T B A I Q U | Z E U I B G A Q;T
W O Q U J F Y T K | T O Y J W Q K F;U
K T E P O U H N D | D T K N H O P E;U
A E P S C T B H G | H S E B P A G T;C
N Z V E U H O D T | V D T E Z U O N;H
F Y N G C P R H X | G C F R Y P H X;N
P L I Y W C D O Q | P W Q D C O I Y;L
W B D C Q F R U O | D U O F Q C B R;W
E L A K Z R F J I | J R Z E K A I F;L
B S N L F C A R I | A N C S L B I R;F
Y R H C X O K A Q | H C O R X A Y K;Q
R V Y U N J B Z O | N Y Z B R V J O;U
Y N O C E J Q T F | J C N Y O Q E F;T
D C E W X L N J G | E J L D W C N X;G
S Z Y A W D H K U | W Y D Z U K S A;H
E Z F P J G R S V | Z E R F J S G P;V
X W K M F U T S R | F X S W R T U K;M
P G S Z I E Y B Q | I Q S Y G E P Z;B
F X V U K O L Q Y | X O Q L K F V Y;U
E V B R U C G W Y | E B G R W U C V;Y
A T X U H M W G R | T H M A X U W R;G
D C V E W K B J S | J S E B C V D K;W
B K V T F H A R J | J T H A F B K R;V
W K D T V R A E C | E A K W D C T V;R
O C F H R A M V P | A R H F V M P O;C
F A L C M U N G Q | A C L N M G U Q;F
P I Y H O A L F C | H O P A Y F I C;L
Q I P A U N G O F | G A O U I P N Q;F
Q A N I S V T O H | V N T S Q O H A;I
U I K J F V T W R | K I R W U T V F;J
V M K D E P H W O | D P H K M O E V;W
S D X K F Z E J A | J X D E A S F Z;K
T K U H Z B S X G | G H S T U B K Z;X
W B G P U I Q L F | Q U B W G I P F;L
E D T H B L A Q M | H Q B L M T D A;E
F C W G M D S U A | C D M S W G F A;U
G M J Q R F K E V | V G K E F Q M J;R
B E W O L P A J M | B O E P L A J W;M
Y T I U A E R W X | X W R Y T E U I;A
V Q L Z E K C G J | J V Z K L C E Q;G
O F M E T W P C L | E O M C W P L F;T
P L G B X C H N O | C O P X H B N L;G
N S I P B X F M T | T M B S F X I N;P
L W G M V B H T O | L H M B O W T G;V
F S M P X H U Z I | S F H M Z U I X;P
Z S V W G D X E R | X E V W S Z R G;D
U L W Z F E H G S | F E H S Z L G U;W
U O M P I Y D R C | O Y P U D I C R;M
N A G Q L W U T P | Q W N G T P A L;U
P M N K E W Y R O | M R K N Y E W P;O
B L I A M K D X W | W M X I L K D A;B
Q B C A K R S E G | R S A E K Q C G;B
L P E B Y C H V F | P B L H Y F E V;C
F G B M Z D O P V | M D P O Z B G F;V
Y E R T D N Z M G | T M G Z R E N Y;D
Z P C T F A R E G | R F G Z C A P E;T
U W A Y P O D X L | W O A Y X U D L;P
A E L Y S O I J U | Y A J S I E L O;U
A G L P K H O F N | O K P G H A L F;N
X N E O Z B K L H | K O E Z X N B L;H
X P J K U Y E S Q | J E Q Y S P U X;K
D I A T Q L J P S | I A L Q S P D T;J
L J Z W X V I H U | L X I H Z J U W;V
B T R L X N Z V W | W B T X N V Z L;R
G A O Z E C M T L | C L G T O A M Z;E
E B D H W J R Z P | B R W P H E D Z;J
R P N V Q L O K X | P V Q R L O X N;K
H I G L X F C D Q | Q I X F C H G D;L
U R Z O Y X Q G E | Z U R Q E O X Y;G
U F H Y Q E P O N | P E Y H F N U O;Q
P F N I Y Q O X M | N F Q I Y P X O;M
U T D Y C K R S M | D U S K Y M C T;R
D J C X H I Y F A | C H J I A X F D;Y
T L V O Q X Z F P | V X F Q P T Z O;L
B V H Y P C E I L | V H B P C E I Y;L
R G F I M E X Y B | E B X Y G M F I;R
N O U S T Z C G Q | U Z O C T S N G;Q
K I E P O J U S V | P S I V U O J K;E
O N B K W I P R S | O N K B W S R P;I
S C M Z K O W U Q | S Q Z U M K C O;W
J U T L R X H I M | M L X T H R I U;J
I Y V T S C Z P J | J Z V S P I C Y;T
B F T C O Z A G E | F A C O B G Z E;T
O V M Q I H R L X | M X O R L Q I V;H
O M N F Q K R S G | M G O N F K S R;Q
F U V C S W X Z B | F V W X B Z S U;C
U Z M O X Q W C I | I M Q C W U O X;Z
J A D X C P I Z U | P U X Z D J I A;C
Q W O G L U V Z P | Z O W Q G V P U;L
P K H U R D F J L | H L U D R P J K;F
S K N E P B I D L | B D S E N I K P;L
P J A K Z E X I F | F J I K P A X Z;E
Y N E W U H J P A | J A U E H P W N;Y
Z Q D U V S F E W | U W E F Q D S V;Z
S T W D F M Q I E | F T E Q S I D W;M
J V S X M E B R A | R E M A B V X J;S
K M H F I B O U N | B H K U O F M I;N
I K P B T W U A C | B A T P K U C I;W
A Q H R T J X L W | W T J L R X Q A;H
F P R Q C W Z G V | P V W F Z G C Q;R
S O N R L Y E P G | E O N S G P L R;Y
A P G B O Z D F S | A O Z B G F D P;S
F P B J K Q L W R | F P W R K B J L;Q
T R W G H V K X C | W V T K H C X G;R
M R F E Y X T U P | M U X R T Y P F;E
K F P W U I O Z L | O F W K P L U Z;I
D J B F X P M E L | D F M E P J X L;B
L B Z G R H U T J | G B H U J R T L;Z
Q H B E Z T O L C | Z T C B Q E O H;L
L Z N Y X E O P C | O E L N X C Z P;Y
M X H E Y S O D L | H S M X E L Y D;O
Q U C S G Z H W F | F G S C Z U Q H;W
F E M U R S H K O | U H O E F R K M;S
W F I K A E Y S T | Y I A S F K T E;W
Q X L G U T D E W | D T U W Q L G E;X
I H D X M Q E G N | G X N E I D H Q;M
Q J G D P T U Z K | K J P D G Z Q T;U
K M A E B F Q W D | B K Q E A M F D;W
Q C M W Y K E H G | H Q Y K G M C E;W
M J Z F D N V W T | F V J T W D Z N;M
U T K M N S E W Z | E S U K M N W Z;T
X N R Z Y V I A U | Z X R A Y I U N;V
Q D I C J K G Z O | Q G O K I Z D C;J
Q X U B R N P F C | U Q B F N X C R;P
V N L F Q I B X J | N I B V L F Q X;J
Z R A E F B N D C | Z F D C N A E R;B
F N M B D W T S I | T D S M B F N I;W
C S H O W A Q Y J | C A O H W Q Y S;J
B M U E A N H C V | A H N E M B C U;V
P Z K N R B U T X | T K B U X Z N P;R
X S N Y K J G F Q | X G N K S Y F J;Q
O I Z X P T Y C H | O C Y T H I X Z;P
D K L G S W T J I | T I D K L J W S;G
E P Q Y A D R M U | Y U R E D M Q P;A
K C O L W V I M P | M K W O P I C V;L
G T B V Y U M N Q | T N Q U G B M V;Y
Q A F I T G C L O | Q F T O L G C A;I
Q D C L S J H W G | G W H L D C J Q;S
E K F J R T P D B | K B J P E R F T;D
Y N F D L C K S J | Y N L S C K D F;J
M X S L U N P Y Z | S X L U N Y P M;Z
G S I H K X L O N | G X O K N L H S;I
N Q E H O F G X T | E G Q X N F T H;O
B I L N M Z K F V | Z K I F M L V N;B
Y R K B T M F J V | F V J R T M B Y;K
C U R T E Q I D H | R H C I T U D E;Q
L R D N Z F J Q M | J R Q D M Z F N;L
L S E V U A B G R | U S L R A E B G;V
T H I B L E W U X | B T X E H W I L;U
F G H W X C P S D | C X D W S P F H;G
D S T X V H Q M C | M Q H C T D X S;V
M H V C G O L D A | H V G D O C L M;A
Y O S I P Z M F L | Z P F I L O M S;Y
G H R I P N A V Z | Z I G P N V A R;H
R M H X C Y F T I | T H X Y R M C F;I
K J N L T Z O M Y | N Z L Y T J M K;O
G Q A E P I L O S | A S L G E Q P O;I
D O X H E Z G S Y | G E O H D Y S X;Z
F M R C Z B G P S | F S G B M R P C;Z
T H X M C G K D A | D T H A X C M G;K
I S F C P V D T Y | S D I Y F C T V;P
D F V L Q T C H Z | C H Q Z V L F T;D
O T C J F I B Q M | T O F J B M Q I;C
J Q V A X W P F K | P W V F Q J X K;A
C G V Z M R F U L | G V F Z R U L M;C
Z A R Q G L D B N | Q Z A R L D G N;B
X N Z Q H F G C M | Z M X N F Q C G;H
X P K L C M B T Q | X T Q L M P B K;C
L T D S B V Z R I | Z T I V R B L D;S
J G L N C Q V E X | G L X N C Q V E;J
F Q E M Z K T V R | M F T E Q Z K V;R
F S B L Z O A C U | U S O B Z A F C;L
E Z R M X C B S I | X S M R E I Z B;C
E M Y I G O C V U | M C V E I G O U;Y
X I S W C Q N J U | C W N I X Q U J;S
T M E W H J D A Y | T Y M J H W D E;A
S D K L Y M W T C | D K Y T W S C L;M
D T H B X I A U F | X H T U D B I A;F
Z Y I O Q D B W P | Q D O Z P B Y I;W
I Q X O M A C T E | Q E I C A T O X;M
P K J W I G E N F | J F W K I E G P;N
D I T E L C S K P | D K S E L T P C;I
T N O M R F C B Z | B T Z M C O F R;N
T D B I C Z Y F O | Z B C I O F Y D;T
G X I S O C A V T | A G O S T I C V;X
R X F A G I J Y D | A F R Y X I G J;D
W H C F N Z D Q O | W F D N C H Z Q;O
H R K G U Y N S E | R E G K N Y U H;S
T J P L H A S N Q | N S P A T L Q J;H
F L X A Q H Y M K | Y K L Q A H X M;F
V T F I L H Q N A | H N Q I F V A T;L
V C L I J T U H G | T J H U G C V I;L
R A Y Q F C T B G | Q C B T G F Y R;A
L M H Z A Q X R U | U Q A H X R Z M;L
G I H K Z N B Y J | J H K I Y B G Z;N
S C X R Q F U V P | F X S P Q R C V;U
X A Z G Q J S N K | N J S G A K X Z;Q
W X K S Q T D B P | P T K D S Q W B;X
C V D J G W Q Y N | Y G C W D J N V;Q
B P T V Q Z N Y F | Q P F Y N V T Z;B
Z M Y P X O B Q E | M B Q O P E Y Z;X
R H N I O W Q T C | T R C O W I H Q;N
I O F V Z R Y D X | I Z Y F D O X R;V
B K E P T X M Y G | Y G P M K E B T;X
T H M L Z O Q J V | O Q M L J H V T;Z
C X H V W F R I B | C H W R X I F B;V
Z R A V M B Q K H | B V R K H Z A Q;M
I Y K F W V M B C | W C V Y M I F K;B
S Z P Q F L B U O | U Z L O B S F P;Q
V N U P A Y H M J | A M Y U V N H P;J
N M J W U C B E F | N W E B U J F M;C
J A M W Q F P E K | E J W F K P A Q;M
R N C Y M D T Z L | N T R D M Y C L;Z
I A F W D Q X H K | I A X D K F H W;Q
Q E J X V K U S I | J E U X K S V I;Q
N O W V T B L Q C | O T W L C N B V;Q
Y M K O R E I A P | I R E A O P Y M;K
L U I M N H V G F | L U F N V M G I;H
N T O U M X B I J | I N M B J T U X;O
G D N B V J U P C | J N C D G V B U;P
D I Z R C H N F S | D C Z N S H F R;I
T L N Q S O P R G | Q L G T R P S O;N
P W L O V Q J R Y | V L P W Y R O Q;J
H K W R D E Z U T | Z W T H K R D U;E
Z F T O S P X D A | A D F X T P S Z;O
P V F E I G R D C | I R F V G D E C;P
O J M D F G N P S | F O N G J D S P;M
C S E R W G I J K | E S J G I C W R;K
C I V S E X Z P K | P S E X V C I Z;K
S A R C K E O Y W | A O W C Y K E S;R
Q C B U Z I D S X | C Q Z U D X I B;S
P L O Z V E T B C | B Z T V E L O P;C
H D T W B S V N C | H S V N D B C W;T
C I X D M O H K N | M I C H X K D O;N
N T J O C G E X A | J E G A N X T C;O
Q S D P A K J F C | Q F D C P A S K;J
C O G E K L R S V | R K G L E O S C;V
W M O P F L C G T | O W G M T F P C;L
T I L J O D S P Y | D P O T I L S J;Y
V M H G O F N R Y | M R O Y V H F G;N
P M F X C K S J B | B C K J X F M P;S
J T B C W H I G O | B J I C G T O H;W
A I D L V C N R M | D C V A I M R N;L
T V A N H J I P O | T J N H O I P V;A
J W M E B O Z Q V | M B Z J W Q E V;O
X P Z Q H I M N J | J X N Z M H Q P;I
D W R B S Z A X U | B A S U R X D Z;W
A N M Y G L F E W | W G F L A M Y N;E
R G Q X S Y C V D | Y V S G Q C D X;R
M V O Y Q B Z G H | B Q G Z H Y V O;M
N R M E F A J Q D | M J R D F A Q N;E
G Z P L O W K V Q | V G O W K Q P L;Z
J G Y P W R C Z A | R Z W A C J P Y;G
I W A D Y Q E Z T | I E T D Y Q W Z;A
I Y A C Z R E S X | E Y S R A X Z C;I
E M S B P O F R W | W M R S F O E P;B
W F A M O P G J B | J G P B O W A M;F
J G B U N T F A W | W A U G T J F N;B
X R Z V O F A S L | O A X V R F S L;Z
F I S T W P N Q J | P I Q J N W F S;T
T X B S Y C O L H | S T Y H O B L C;X
R U W C A G N Q S | Q U R G N W A C;S
J R Y B M V T G I | Y J I T G B V M;R
T M U Q N X D H B | X M U B N T D Q;H
C E J R U S L N W | W J L R U E C S;N
W P Z H M U D R E | R H D U P Z E W;M
L C M B S N X U D | N B D U S L M X;C
M H Z N I R K S A | R Z M N I H A S;K
P A M R D W Q U C | M U A W Q C R P;D
W I H E S T K O L | S W L K I T E H;O
I R O E Q A Z G C | E I G A Q O R Z;C
G P I R K O U H V | G I H P R V O K;U
L B Y X W K P J T | T B J Y L X W P;K
C I P D G F Z L A | I P D Z G C F L;A
P E F V M D W Q A | A Q W M E P F D;V
A D Q G M V W Y N | Q W M N Y A D V;G
F B X Q A I J Y C | B C Q X J A I Y;F
G J Z B I Q U E C | E G C B Z Q J I;U
U H W Z B K N P X | Z X P K H W U N;B
W D A L V S J Y Q | V W Y A Q D L S;J
B C N E V Z L J Y | J L E B Z C V N;Y
F B O Y G P S D J | B G Y O S D J F;P
B C T V A L O N Z | A L B C N V T Z;O
R B J P L F M H C | J R F H P L M C;B
F I C R H E N G D | I F C G R D H N;E
M D H G C A Q Y O | D A M H O G C Y;Q
Y G A F J N W Q O | Q O A N J Y W G;F
A N T H B F S M J | S B H F J T N M;A
P B M Q S R L F X | L M X F P S R Q;B
C O L S B K W R E | S C O K B E R W;L
Z N V T K A D E M | D V K N T E Z A;M
M R B C L N O V I | R I N V O C L B;M
J Z C N B U P W M | B C J Z N U P M;W
S I O Y X F M H A | A S Y I H O X F;M
U A M N G Z I H Y | Y A U I M H N G;Z
J A R T C F D B U | B C R T J U F A;D
U J G D X A Z Q O | J O D U A Q Z G;X
Z S U H N P V J E | H V S U E P N Z;J
U F X T A D W C M | F W C D T M U X;A
W F D E R C I Z U | U Z C E D I W R;F
M X P Z F S A I N | Z A F N P X M I;S
Z O V Y P G L M B | L O B P Y M Z V;G
P R I U N B A Y W | N U W R B I P Y;A
V Z W H B O Y U F | B W H Y U Z V F;O
K Y T N F M L I E | E T K Y F L N I;M
Q P X R I G F O J | I G X P Q F O J;R
M S Q U E T C K A | T E U C Q A M K;S
I M L N F P C J U | N M U L C F J P;I
X B W P O Z R K A | P B K X R O A Z;W
B Z P T H X F Y Q | Z X F Q B T Y H;P
R A Q C O S B X L | X O L C Q B S A;R
L S E J N B I O F | L O N S E B J F;I
V S Q M U R T O Z | Z V T R M U Q O;S
R G Z J K C D Y I | K G Y I Z D R J;C
C V F U O I S R L | L S R V O F C I;U
U R D Y K O W S C | U Y K C R S O W;D
B Z G A J R K P N | P K B N J R G Z;A
M X I Z B A P G W | X W I B Z P G A;M
B J R Z S N L I Q | Q Z R S L B J I;N
W E B N P Z V O Y | W P V N Y E Z B;O
T V G K B H D W E | B E W T V H D G;K
V I F E J B W L R | L E W I J V R B;F
K C E V Q L I G U | U E G Q I L C K;V
J Z V N I A W O H | N O A H W I J Z;V
C X P H Z L M O G | Z X G H M L O P;C
V M R I Q W A D P | D R I A P Q M V;W
D X G W R E H Z B | D E W R X Z G H;B
L F Y M T H X G K | H F M X G K Y L;T
F E O Q W P A M D | W O P Q M F E D;A
H A J D S K Y N B | Y N D S A K J H;B
G A E I Y C U Z D | Y Z A U I G E C;D
S C A O F Y K R Z | Y C S O F Z A R;K
Z L F I N E R V C | F Z C E V L R I;N
V M Y D C F N U A | Y U A F M N V D;C
V R B U I D L H N | D V B L I R N U;H
X K U S Q Z P R J | J U Q K Z X S R;P
V O P A S Z G D B | S Z V D P A G O;B
C L I J Q O A Y V | C A I Y L Q V J;O
W U F V D M R Y K | U R F K M V W Y;D
H G X S M L P O R | P M X H L R O S;G
O G P S X W Z F I | S Z I O F W P X;G
C V E U K P N M Q | E M U C K V Q N;P
C D K Y Z U G P A | G D Y C P K U Z;A
B N U L Y D E C A | A E U C N L B Y;D
B R A Y S Z X N O | Z O B R A X Y S;N
M G Y I Q H Z U W | H G M Q I Z Y U;W
W L A U K F T Q P | T P A U W F Q K;L
U L W K O G T V S | K T G O L S W V;U
B H Y N X J D G R | J B Y G R H X D;N
U I P D B M F G J | F I J M G P B U;D
Q F P U L D X C M | P F L D Q M C X;U
W T I J L S X E B | B I W T S E J X;L
G H F Z W A U N C | U C G N Z F H A;W
B P F Y L G I M C | C I Y F P B G L;M
A B Q E J X W Z D | W B D A E X Q J;Z
P V X M N K H U J | U P K J H V X N;M
Q T W U F J H V M | V M H T U J Q W;F
N M S D J Z H C E | N S Z D H E J M;C
D L O V P X A C R | X L A O D R P V;C
Y M S U F R N B I | Y F U N B M R S;I
E K W L R J D Q Y | Q K Y D R L J W;E
R X A Y K O D I B | D I R X K A Y B;O
E S I N A Y X Z R | I R S N Y E A Z;X
P L B Q R I D F Z | D Z I R F P Q L;B
U O X T N C L Z B | C N U O Z T L B;X
K P G N D W E Q A | K A E D P G N Q;W
R A E Z O D T L C | D C A Z O R T L;E
V G R A H X E L Q | A Q L E H V G X;R
C X A Q N M R O F | C A O N M F Q X;R
A B X U Y N H J S | Y B N J A S H X;U
D Q B A I S H P V | Q D B H A P I S;V
Z H J O R L N S P | P N J O H S R L;Z
S G K O N V D X P | K S O P V N X G;D
G P B Z T O S L K | B K Z P S O T L;G
P T X N O Z I C K | O Z I P T N X K;C
O T K S Q P X H C | O P H X S T Q K;C
Z Q L S M K X H A | M X K Z A H S L;Q
W L T O Q I Y R D | D T L R Y W O I;Q
O N Y J F Z W G U | Z O N F U W Y G;J
P Y R T C L O S F | P F S O Y T R C;L
L Q Z K O J B H T | K T O L B Z H J;Q
A D N M Y S G T O | G O S T M D A Y;N
E O S Q K T D H B | E B H T S O K D;Q
N E C R M G B Y I | I M N B R G C Y;E
S L N C X T R B M | B N T M R L C X;S
F N J C A K E Y U | U K C Y N A F J;E
A B X H C D J E F | B H X A E J D F;C
S Z N C U F Y V D | F U D Y C S Z V;N
R V B W F A Y J D | V A F J W Y B R;D
G F R X C Y N E Q | C Y F Q E X N R;G
D V S U G X K C Q | K U S C D X G V;Q
Z I D M W S K G Y | Z G S M D Y I K;W
A G P R C B J F O | C R J B G P O F;A
U Q K J I S P M D | I M D Q K P U S;J
C K A I D H T Q F | Q I T K A D H C;F
F L A Z E U O W H | H A Z L W U E O;F
H E L T O X C A I | C H T O A X L E;I
A Z U R C S J D Q | J S Q Z U A C D;R
I O Q U X A Z P Y | O Y U Z I A P X;Q
H P C M E B K S G | E G S K B P H C;M
H K P X J N E L I | I N J X K L P H;E
I A P Q M B T U Y | B A U P Q Y T M;I
M U H V S I J F R | J V M S I U H R;F
N D O A E J U T B | O T N B A U J D;E
E C Q W I A M H N | C M H A W I Q E;N
V E R W C J F P Z | J Z R V P F E W;C
K N V D X O A Y G | N V G D Y A O X;K
W X E G O H B K S | S O B H K W X G;E
Z D C K P U B I S | C D U K I B Z S;P
R K X J G Y U P O | U P G R Y X J O;K
Q Y F O P I X S R | I O Y P X Q F R;S
D I J H P R O K U | H I U R K J P D;O
W D S H G E R N U | S G U D H W N E;R
Z J I H Y A G U E | I Y A E H U J Z;G
J Z A X N H Q I F | Z N X I H Q A J;F
B U E S G Z K X O | G Z S B E O K U;X
L K C Y U G X P V | Y P V C X G L U;K
M B Y C J T X K F | X T Y J C K F M;B
T S Z E B V L R U | Z R B T V L E S;U
T Y A O L C X W B | Y A X W L T B C;O
J A C S Q Z M V N | C Z Q J N A M V;S
S R A Q X O Y K I | K S O X Q Y I A;R
C B E J N D Z Q K | N E C Q K D Z B;J
O D M K W E Z H N | E Z D K O W N H;M
H O F Z S N J X V | X S J N V H O Z;F
U I L S O X P K J | L P I X S U J O;K
L S Q C M Y F P K | Q M S P F C Y K;L
T G W X Q D S Y A | X S G T W A D Y;Q
W E X C H O B P Z | X W C H O B Z E;P
R W O X S I F K C | I X C R K O W F;S
F A L H R T N B S | T H S B L A F R;N
D E B H Q C P O R | C E O P Q R D B;H
N T C I Y E J A V | I N E J C V T Y;A
U B J X N A V K Y | V U B A K X N Y;J
D J U Q E N S P V | N V U S P E D J;Q
Z S C F R L P Q U | Q L R F Z C P U;S
H Z K Q R M G E F | Q G M R Z K F E;H
P H Q M O X B W A | B W M P A H O X;Q
U C O M B Y E T V | O E T B V C M Y;U
Y V Z P X I G J B | I V B X Z Y P G;J
J I Z P M T Y O U | U Z J M I T O P;Y
P Q I E H Y Z R A | Y E Q A H P Z R;I
B D U Q M L J W H | L W D Q H M U B;J
G E V X U Y Z R N | V R Y Z G E X N;U
G C M J O Z E F K | F K J M G O C E;Z
J K S G X Y W H U | K Y X H U G S J;W
C Z T K Q E M A N | Q C K T A E Z M;N
B X I P Q T A K G | B T A X K Q G P;I
L Y G F M C H R N | L R N G H F Y M;C
I V T N K E P O S | E P O S V N T I;K
Q X B F Z A E W Y | X Y B Q W F Z E;A
Z V Y N M I X U P | N Z V I M U Y X;P
Q N R W A X S M V | X V R M W Q A N;S
C Y S O K G J P F | O S K F G C Y J;P
X K H R I P Y S C | X I P S K C H R;Y
U M R V B N I Y W | M W Y N B U V I;R
K T B H M Z O P F | M Z H T P F B K;O
V I H W T E A G B | A G B H I V E T;W
C M A T I N V Z G | A I G N T C M V;Z
P Z S L H C E G X | S H P G X E L Z;C
R O S Y W F J K T | S Y O F J W R T;K
N H J E K C X P M | M H P N X C J E;K
Z O L J W T P C D | Z T D W L O C P;J
B F V J O G M U L | O L M V J B G F;U
P M F C B L V E Y | V E C F L P B Y;M
M G A C O R H F E | A M F C O G H R;E
M P H R K W Z V E | P Z E W V H K R;M
R J E D V T N F O | T D O N E V J R;F
J B L V X I O P E | L P I O V X E B;J
E K C Z P F D T I | F E C I K T D Z;P
T D N R M P F V X | P D N F X R T M;V
R Q N O M C A P W | W C O A P Q R M;N
X Z S T M Q L F I | X I Z T L M Q S;F
F V O Y T L E G Q | Q E T V Y F G O;L
G A O H F J U Q Y | J U Q F G H A Y;O
V L B F N K E C S | F C B E K S N V;L
Y H N E C G L O K | E H L Y G N O K;C
N S L H U P T F J | N J L U T F H P;S
H W Q A O M K B I | K Q W I M H B O;A
P W D F B A Q C S | Q A F P W B S C;D
K F V J W O S Y M | F M J Y S K W V;O
Q R U V F X K L J | X V Q L F K R U;J
T G P R F C Q Y K | R C K F Q Y G P;T
K E A Z D I T V R | K R Z E A I T D;V
V J H Z A W R K I | Z J H V A W I K;R
W E C H M S U V Z | W M V U Z H S E;C
V Q I C G P H O Y | Y O Q G I V H C;P
K Z H M T L O V W | V M L H O Z T K;W
G A J R H Q Z O E | G R J Z O A Q E;H
V Z D K Y X W N I | Y N D I X V W Z;K
M C W Q N X P V Y | W Y N C M X P V;Q
L D U W R E O K Z | L Z W R O D K U;E
A B M H D W K P O | P A D W H K O M;B
L R G Y V M W F N | G L V M N Y R F;W
Y L F A S T C B D | C F S D Y T B A;L
E C B Z V A K F U | K Z A V F U C E;B
D Q H W P O C Y T | P D W O T Q H C;Y
F O I L Y H Q X K | Y I L H K O Q X;F
A V E T B S M C W | W T M E A C S V;B
G N C W O F A Z Y | O F Z C G Y W N;A
W P L G M S I J B | G W I L J P S B;M
M H E I C Q S R O | S Q M C R H O E;I
Q H Z C A P B R D | A C D B H Q Z P;R
P Z G S M B D K I | G M K D Z I S B;P
J B Z W O A M H F | J A M Z W H B O;F
U H K G B A Y S E | S H U E A K Y B;G
K Z R Q S H N V Y | R S V K Y H Q Z;N
T G O F Q I X D U | U Q I G O T X F;D
I Q Z X B L D S K | L I Z K S B X Q;D
B M L D X K Z E T | L E X D T M K Z;B
P S N M C Q B R J | S P M N Q J R C;B
O L J G R C K Q U | J C K R U O L G;Q
M O W G U C Z V X | O Z U C G V M W;X
P Z O H Y C L F E | Z O L H Y F P C;E
W O X Q Y D J M V | M Y Q D V X J O;W
O D Y N Q L R E Z | Z N Q L D Y O E;R
K R O I T N E D G | E G N T O I D R;K
J O D W U Y F A Q | J Y D O F U A Q;W
U K D A Y C H Q F | U K D F Q C A H;Y
F N R Y P V T L J | J V L R N P Y T;F
Z H K C F S J B Y | Y S J F K H Z C;B
T O C E X J R G N | G E N O T X C R;J
I N J M E Q A S X | A J N Q M S X I;E
G J P S I E O F K | K E G P J F I O;S
T W X V J K P D I | W P T V D X K I;J
F P B G D C Y A S | Y D B F G C S P;A
R Q I F T U P K O | T P Q R U O I F;K
B R M S J V Y A W | Y S B A V W R M;J
X S Q P L C D I N | L I Q S D P X N;C
M Y O E J H X C P | C M Y E P J X O;H
Y X W D B N G V F | X W F V N Y B G;D
I R M G K U T B N | T K I M R B G N;U
X Q H M A I S Y E | E M Y S X I H A;Q
O D A C N Y G K T | T G Y A K N C O;D
Y D U O B L Q A I | O D U Q A L I B;Y
G E U M A C P J K | K M J A C U E P;G
G I P O M U C A W | I C W G O A U P;M
Y Q S B R F V W J | Q V W Y J B R F;S
J N O T H I Y X R | X T Y J N I O R;H
M S N Z Q O Y U T | O Q Z U N M S Y;T
U S L K E J O V B | K V E U O L J B;S
R K L Z Q A P M J | A Z L M K P J R;Q
V T D K P X R Q H | Q X P V K T H D;R
F Z K A V L J O X | A Z X F L V K J;O
O X G I E U F L Y | G Y I O E F L U;X
C M Y I V D L U O | D I C O Y U V M;L
M T V K O R H E Q | M V H K R E O T;Q
P S X H Q Y D I J | P S I J Q D X H;Y
A C X V Z M R H D | V X D A M C H Z;R
D G P Y B U C M R | M U R G Y D P B;C
L S W H F C E I B | B H S L E I C F;W
B W Q A R U V M C | A C B R U Q W V;M
Z N H M R Y S A L | L H A R Y M S N;Z
O D G A X B Q Z K | K Z A B X G O D;Q
H B A R W V O T K | A K O V R H B W;T
Q A S M V P J Y G | G M Y S J A P Q;V
S I D L B N Y Z E | E L I D S Y N B;Z
N J H E A G U B D | A J U G B E D H;N
U T E B A F M G P | B U P G T A F M;E
I S T J A E F L O | S J E F A O T I;L
G A H J Z K C P X | K Z G A X H J P;C
K S T F G R J P U | U P F T J R G S;K
K G L F J Y M W Z | L G J F K Y M W;Z
M N Z G W T X S Y | S X W Y G T N Z;M
R J K C O W M I T | J C I M W R O T;K
Z X V L P C J G N | Z J C V P N L X;G
U A D R F M N J C | A F D N U M R J;C
Z P N H J L F A S | Z A L F N S J P;H
Z W P J V F L O I | L I W Z O P J F;V
G Q V I U P M B F | M Q B U I G V P;F
B H F P D L R E Z | H P B L F R E Z;D
C L X O P E Z M R | Z C R L X P M O;E
D I C R G J S P L | L R I D P J C S;G
L B H O G D Q U M | L M D Q H B U G;O
S X O V F T R G D | V G T S D O R F;X
F W R L V E A J Z | J F E V A L W R;Z
F E D T L Q P V Z | Z V T P Q L F E;D
N E S V W Q R T H | N V H E S Q T R;W
H N G M B X J D W | M B G J W H N X;D
V U X Y W G Q A D | Y Q X A U W G D;V
F B C U W R N Q E | U R Q C B N W E;F
L C D U R A Z F N | Z F D L N R A C;U
I H M S D J F O L | S J I F O H L M;D
D X K Q G P W B U | B P Q G U X K W;D
P Z K W G S X R L | R K L W Z G S P;X
F A W M V C S Q Z | F C A Q M V W Z;S
U E Q M G W P S F | W M S U E G Q F;P
A E V Q H T X W C | V A W Q H E T X;C
Z S X A P F B E G | A P E X G F B Z;S
O L N G V S J D W | L O N G D V W S;J
C B S M G P Y T X | S C Y B T X G P;M
F B I V C Q R O Z | Q R O F B I V C;Z
Y Q I A J C D M T | A C I T Y Q J M;D
O E A H Z T S X D | Z H S O T X A E;D
O P C E D Y W I S | D O S Y C W I P;E
F W R U J T D L X | D W T J R L X F;U
W O G C H V T A Q | C G T V O H Q A;W
L W A D Z U F G S | D L Z A W S U G;F
E G M S R K Y T O | T Y O G S R E M;K
C I S N H P G O D | N C I D H O S G;P
F P O X Q I B N Y | Q O X I N F B P;Y
V S N A W P F O E | P O F E V N S A;W
Z W G Q J U Y N A | Q Z N W G A U J;Y
O S Y Q Z C X K T | Q S Z Y O C T K;X
M Z T N W V Q G L | Q G T N M W L V;Z
V C J K D L W Z N | K V C L W J D N;Z
Z I O X K B Y Q P | K O X I Y Z P B;Q
S C R U V B Z K D | Z S U D R C K V;B
D A R C U X Q I W | I C X R A U W D;Q
X G U P F R W V N | N F U R G W V P;X
D L C T K I Z H B | K T Z D C L I H;B
X Q S Z F G P W C | Q P Z S G C X W;F
Y P S K N W H D A | H Y N P A W D K;S
Y S W B N C P M R | N R P M Y S W B;C
I Z F N E W A X U | W I N A X F E U;Z
Q E Y P I B G A N | I Y A B P N E Q;G
Z M G J B O T D L | B O G D L J M Z;T
A H Y J U I T L X | A H J X I T Y L;U
O Q M A F P J D C | Q C J F D P M O;A
U W E F A T K S N | U F S T E A K N;W
B Z K V N S D Q T | T S Z B Q D N V;K
Z U E A P B M T X | Z A E X B M P U;T
Q O B L W G Z D T | O B L W Q D T G;Z
I C Y H J G P T R | T J R H P G Y I;C
V X A Q R T F K N | T R F N A X V Q;K
C W I U D Y Q E G | U C D W I Y E G;Q
X T N S E A Z R J | R X T N J Z S A;E
Y I S A O J W Q D | Q O W J D Y S A;I
W O R U X B Q A P | U Q P O B W R A;X
Q J G N L P M B C | M C L N J B G Q;P
V S T W X N U Y K | X N S Y U V K T;W
O D N C M R K V F | O N F K R C V D;M
F Z U N G S M J A | U Z M S A F J N;G
T X D A K F Y Q I | D A F Q Y T K X;I
B V Z E D I P W U | P I E V Z U W B;D
I V A R P K B W M | I K B A P R V W;M
W S Z J V K A O M | O W Z K S M J A;V
C G V W P Y M N B | M V Y P G W B C;N
L F Z T Y X U H A | X Z F U Y L H T;A
H T L M Y U J V R | M T U H Y V R J;L
V O Z L H C U E J | U H O V C J L Z;E
I U A S J P T M E | I M J E P U A T;S
E G M U I B O Q P | U M P Q O E I B;G
N O J B I V F L E | N J I O L E B F;V
M I L K C O V A F | V L C F K M I A;O
T R J Z N B Q I X | J Z R B N Q X T;I
Y X L V A K R F O | K V O F A R X Y;L
Q N Y C B M X S H | N C B Q S Y H X;M
I H T G V Y U O K | T K H G V Y I U;O
O L S N W H G Z X | S O L H N X G Z;W
U X Q J I O Z F R | Q F X J Z U O I;R
K Y L P S A R H M | L M K A R S P H;Y
P Y C D M I K X L | X I D M Y P L C;K
V N W O P M Q A T | A W M N P O T Q;V
N H L Q D F T Y W | W D L Q H F T N;Y
U N Z X L E S T Q | Z S N U X Q L T;E
Q D P J O E I Y H | P Y J H I D O Q;E
H B J Z M S R K E | M K B H J R Z S;E
K F I W A M N D E | A N K E F M W I;D
R K X J F Y D V G | J Y F V G R X D;K
C N X P U W I Y E | P X W E I C N Y;U
U S B H C P N K X | K N P B C X U S;H
J N I A R H W M E | N E A R J M I W;H
C J P K S A X V Z | X P K J S C V A;Z
S B K F I A G T E | F T G I B S A E;K
M J F N Z T O H U | T O F U H Z J N;M
X T O W R K E S B | S E T X R W O B;K
O U Z H J A P F C | Z A J F H P O C;U
A F L X G T K C H | X F G T H K C L;A
J G K T N Y F R W | G J N K Y W T R;F
W X U L Y H C Q N | N C Q H U W X Y;L
J C V A H G O E U | J G U C V O E H;A
C K Y B T V H U E | Y K V T U H C E;B
Y N E O W D U R J | E O W N U J R D;Y
Q D N R U Z F T W | N Z R W T F D Q;U
F I X G K P U J E | E G F K P J I U;X
V Q X H M D C J I | V X H D C M Q J;I
B C P G W T E H N | N C H P E G W T;B
H R K N Z Y S V D | Y V D Z N K H R;S
C E B M D F I Q J | D J I B F M C E;Q
O V I Z Y X J E Q | Z Y I J E Q V O;X
E D F X V U T Z M | E U X T D F V Z;M
F S O J U Y H E N | Y J S E U N H F;O
F Z R D V M B H E | Z M H R E B V F;D
O S C N B Q K H U | H U K Q C S O N;B
W E O S M X T G L | S E W X O M G L;T
R C Y B Z O G H F | B Y F G Z H O R;C
J F D P Q U K H G | H U Q P D K J G;F
I R C V E K Y A N | I K Y N V E R A;C
H F G L T Y A D X | L H A G F X Y D;T
H A C T X S Y D W | H D W S C X Y A;T
Z P E O D C X T I | E Z I C P D T X;O
O B A Y R U X N C | X N Y U B O C A;R
R I D N M Q J T C | T M C Q I J N R;D
U B T W K E J F Z | T Z E J B W K F;U
I S U A D P H C X | X P U C D A H I;S
N E C X K L F U Z | E U Z C X N F L;K
T P J D E H W X N | N W T P H D J E;X
W I D E K B M R N | R W N B I K E M;D
G N I V S R X B O | R G V I O S X N;B
Q L J G M W T U X | Q G J T W U M X;L
I F M B N Z A K P | N F I Z A M P B;K
O H M S F C T Z D | Z T M S O F C H;D
H B M D W E S K X | K E W M S X B D;H
O L Q M N P V R X | O V L P N R M Q;X
P E I B W R L K V | B K R V E L W P;I
F O D I V H B P K | F K O P V B D H;I
S C H J P A O V N | V S A C J O P N;H
P V C Y B T X U E | U E P B X T Y C;V
R Q X V U N F L A | Q N F X R L A V;U
F P Q Z U C G R H | F U G H Z C P R;Q
W L V N K X Z Y J | V K W N Y X L Z;J
D H G M J A P V E | M E D A H V J P;G
U Z B O K X H C V | Z C V U K H X B;O
C W R G J A U Z F | F W J R C G U Z;A
I X T A K F U N L | L T X A N K U I;F
W M R L U V P K N | R P N K L M U V;W
J U Z M D S P O E | P E U O M D Z S;J
A V U O Z P R N J | J R U P V Z N A;O
G I W A V R X M B | A M R I V X W B;G
W T M C S V X E F | F M S E W C X V;T
I E J X F N V W H | N X H W F V J E;I
A R L M E D J O S | J M A D O E S L;R
F R N Q P V M C S | C V M R S P N Q;F
A P E H J Q V I F | Q J I P E H A F;V
O I C N S H J Y F | F H J I C O Y S;N
K C T M Q O A Z F | A K F T O C Z Q;M
S B K F V J N W T | F V B T N W J S;K
B F O L J W X N G | G W O X F J N L;B
N R O V U M D Z K | V N K R M D O Z;U
I P S L O X K J D | D O I K X J S P;L
L W S U F V N G O | S W O L G V N U;F
K C N I X Q A D S | Q A N I C S X K;D
U P M C Y N W B Q | P Q U N M B Y W;C
Q W I N S C V F A | C Q F I A V S N;W
K T B L O I D M Q | B L Q T K D M I;O
D N X U G E Q P I | P X E I D Q G U;N
I N E Y S Z R G H | Y G N R S I Z H;E
O C I V N R Z P E | V I Z C E N P R;O
E Q V G D B O K U | O Q U D K V G E;B
V Q H G T F O Y E | E H F O V G Q Y;T
Y D M U A P C E H | D A H P E Y C U;M
L G A N S H U C I | N U H A I L S G;C
V R M B F U S X Y | V B S X U Y R F;M
G V D U H K L M Y | L D U Y V K G H;M
W Z D M O N A G L | N D O W G Z M L;A
R H O I C D Y J X | Y J D R I H O X;C
C N G Y M L U H I | G N H Y U I M L;C
W I X U Z D E N L | L N U E I Z X W;D
P H D E Y K G W X | P X Y H G K E W;D
E F P S M Z G R X | F E Z S X R G M;P
W M V K L X A Z N | V X Z A K M N L;W
D Z H T X I F S W | T I D H S X F Z;W
O S N T I V X A C | V A C N I X T O;S
T K R S H D J G B | B G R J K S H D;T
C B J X S V M K L | V L X M K B C J;S
F R E W A Z I Q H | R F I Z A E H Q;W
H X L K E U D P I | P H I L K D E X;U
J P F U B G Q Z C | P B U Z Q G J C;F
P H A Y S O I J U | P U A H Y J I S;O
C U Z L R X V A B | B C V Z L A X R;U
H M S G V I J E B | V S M B I J H E;G
D Q P X Y O G V B | X P G O Q D V B;Y
X Q B C K T F G A | T B A X Q G C F;K
F E X B G A K S R | G F R X A K B E;S
M W B J Z V Y T K | M Z W B K Y T V;J
H C G P U D Y O L | O L U D H P Y G;C
T E N X Y V O Q M | N X T M E O Y Q;V
K D A Q U Y L G E | K E L G Q A U Y;D
U J N C D G F S Y | D Y G C F S J U;N
X U P L I A H C T | U L X H I T C A;P
I W C T A Z F Q G | I Z C T Q F G A;W
U I P J O Z L Y A | L A Y Z U I P O;J
E I Y B C T Z A P | P Z T A I C E B;Y
N J H L Y P Z T E | J E N H L P Y Z;T
N B O Y H A T P D | N T H D A B P Y;O
N Y D U V I G S A | Y I N D S G U A;V
B X U I S A H J R | X S A I R U B J;H
T S N L Y P E V M | P N M E Y T S L;V
L Y B Z X H K M E | B M Z X H E Y K;L
K Z S X L P I J C | S Z C I K X L P;J
P V X N K Y G C W | K Y N W G P X C;V
P F H A U C Y D M | H D Y A M F C U;P
E X A G U Y L C J | J C Y X A E L G;U
B H Z A N P T E J | Z P E B J N H T;A
O U Q D A Z X J T | O J U D A X Q T;Z
O M D S K Z U L I | U M K I S D O L;Z
O F M B R G Q E Z | F Z M R E O B G;Q
H I V U C A F L X | V A L I X U H C;F
X H K P T Q R M U | P H X K R Q T M;U
F B U W T S K X A | W T U A S K F B;X
C Q D I E X W V N | C E I X D V W Q;N
S X I U O Y P D A | X U Y D A P I O;S
R B S Q G C M J K | M J K S G Q C R;B
F X L C W D O Z A | A O L W X Z F C;D
U X S M L Q G E C | L E S X Q M U C;G
T W Z E Q L U H V | H V E L Z Q U T;W
F X N P I Z C L Q | I N X F Z L Q P;C
G E S L Q U D C W | G S D U L E Q W;C
U H Y I Q L V B T | U L T Q Y V H I;B
P V C N T X Z S Q | S T C P V Z N X;Q
Q F O K P R G U T | G R O T U F P Q;K
O X V G D I Z H K | O D Z K H I V X;G
X A B R U N Y S I | U N R B A Y X S;I
Z A D O M V P U T | O M A D P T Z V;U
F J P Q G O U K V | U O G V Q P K F;J
W V A U K S N Y B | N W V K Y U A B;S
S X C Y V L Q R H | V R L H S C X Y;Q
S E G B F J X P A | P J B E X A S G;F
U M P H L D C G Z | D M P Z U H C G;L
N V J M S H Z W G | Z N H J M S G V;W
F N X O I C S W T | X W F I T C S N;O
V Q E D I A C P L | V C D A Q P E I;L
D E J L U A V I G | I E V G A J U L;D
A V U F C T D P X | D F X V T P A C;U
C Q V X T S O W Z | W Q S O X Z T V;C
A O N T G I D F K | N A I D T K O G;F
Y Q I N T D X F S | D X S N Y I T F;Q
T A Z K B D S O L | K Z S B D O L A;T
E A N G H O P T V | N O E T H G P A;V
V C M A F N S E U | M C F S E A V U;N
S A Z B Q X Y H J | S B A H Z J X Q;Y
O R M I P U H S G | I S O G P R H M;U
W B Z K V C S Y O | C Z O W K V S B;Y
I F E D L N T Z V | T N F V I L Z D;E
M Y Q T W X N F A | N A Q Y W M F X;T
F N O G P H X V U | V H F N O U P X;G
W Z N P H I L J O | W Z O P H J L I;N
B S C R Z N G V Q | N Q G R S B C V;Z
C L R E V P T Z Q | Q C Z R T P L E;V
H T E W J D L F Q | E W T H D L J F;Q
Y Q W Z L A T K X | L Q A X Z K W Y;T
N E R F P X B D J | D E X R F P B J;N
A G N I P C D B F | D C P A I B F N;G
G Q I Y W N U C A | A W Y N I C G Q;U
B N H P C S V I D | H V B N D I C S;P
C N L H V Y E O P | P O H V N E C Y;L
I Q S G H T X M A | A T I Q M X H G;S
H B W J I T O X F | W J B T H I X O;F
R Q M H J G Z N T | Z N R J Q M T H;G
M K Z Q R W L C X | Q C K Z M L X R;W
R Q C U I K E L O | E L U O C R K I;Q
X A J M H W R K D | A D K M X J R W;H
B P Y U I X G W K | B I G U Y X W P;K
A N X P F D U L V | N V A U D F L P;X
B C Y Q K X I G M | Y G X C M K Q I;B
J R Q X C S A L G | L C J A X G Q S;R
V B M P N O X J E | M O P V J N E X;B
G R Z D F Y T V S | Z G R V F D S Y;T
A C Y M Z D K P B | Z C M B Y K A D;P
N R U Q K Z V J B | K U N J Q R B V;Z
Z E M V H G O X Y | M G V X H Z Y E;O
O A E I P T M D Q | O T E I P D Q A;M
I E U Q S F Y X G | Q F E I S X U G;Y
L N F U B K C P O | K N P C L F B O;U
B H W Z I V E L D | W D E H L I V B;Z
S F O W A I V Y R | S W V Y O R F I;A
Q C L I T R Y X B | X I C Q Y B T R;L
I J V M X O L N A | O M J X V A N L;I
D I F L G H S B Y | H S B G Y L D I;F
B U T V Q F L S D | V D Q T L S B F;U
V E Q C M K B N A | Q V B K A C N M;E
X S A H I Q N Y F | S F N H X Y A I;Q
N J M R P S E B X | B P X M N R E J;S
B A D K N G Y C Z | C D G Z A Y B N;K
R Q V K D F W S O | D V Q O S R F K;W
R A W E I N M H C | I W A M C H E N;R
W H B A F E J Z Q | Q W J B E A F Z;H
N W G J R D E P I | W P G I E N R J;D
A J I M F K Y V D | J V A D K M I F;Y
J Q O S T U N L D | D U S N Q O J L;T
F C A M G N U W P | P F M A N U G W;C
X N U B S I P H Y | B P X U I N H S;Y
X G T E F D B I S | T B S E X I G F;D
K Q V Y C D L F J | D K Y C L V F J;Q
X M W I U O E G Q | U Q W E M X O G;I
T O G L R Y X I N | I L O G N X Y R;T
R K C G A N O V H | K C G O N R V H;A
M J Y P T C B U F | F B M C P T J Y;U
S N H Z T Y D U J | J N Z S T Y D U;H
I H P S L W B O M | I P S L M O H W;B
O X M A S Q Y E D | O Y S M X Q E A;D
J B T V Q O K L Y | V Q L T Y K O B;J
U E K J N Q F Z D | D U E Q J N K F;Z
J U H B S G Y P C | S J U C H P Y B;G
V L Y P W U F Q H | Q V F U L H W P;Y
C I H P W K U L Q | K H U Q W P I L;C
U J G B D T V X A | A J V T D U X G;B
A N K Y H G P D E | A G Y K P D E H;N
N T A X L Z H O C | Z O X C H L A T;N
K N S I L W A Y R | Y K S R L W A N;I
P N T W D B F E A | D A T N B F W E;P
E Q X J W B M R T | B T Q X R J M E;W
S F P Q E C R W Y | P E F Y Q C R W;S
Y H L J Q W K X G | Q L J Y G X K W;H
J V F W H S X B I | B H J X V F S I;W
L X S Z P Y T G R | Y L S R P Z T G;X
O M W I Y R B C D | W I Y B O D M C;R
V P F C Y Z B J G | Z B F C Y J V P;G
M V Y A R F I U G | F A M G I U R V;Y
Z X V Q M U W L R | U V X L Z M W Q;R
R Y N D A F S E Q | Q S Y E N R A D;F
M D A L N T J P H | T D H P L M J N;A
X G J L F P E H Y | P L G Y E J H X;F
X B T S M E Y K F | T X K Y M S B E;F
W T E K U L F X I | I L E K T W F X;U
L Z X O P U C H M | H X O C P L Z U;M
Q S H X V B M N W | W N V M H B Q S;X
D C B H S A X Q F | H C S Q D X B A;F
A J U X Q Y W O B | U A J W Y B O Q;X
U E C V I L X D A | X D L C V E A U;I
O N K R V F M E A | M N A K R E F V;O
C M N W S D X Y Z | M W S X N C D Y;Z
L E M G P J Y V B | M L B E J V P Y;G
K A O X G N V L B | G X K N B L V O;A
W S A U X F H Q B | Q S U X A H B F;W
A N G L R Z J H V | L A R Z G H N V;J
P O T U V Y E N W | Y P T E W V N O;U
H L R U E T K F S | H E S F L K U T;R
Y A J C H B U P O | H J A U P O Y B;C
T B H N A C K Z I | C K Z T I H N B;A
K N Z U R T G P I | G R K T U N I P;Z
N Y W S C X T M G | N X G Y S T W C;M
A R X K H Y J Q N | Q A Y X J H N R;K
A X F L Y E T J P | E F J X A Y L T;P
S Y D I W M F T R | W Y M S T D I F;R
L Y S T J C E Q H | Y H E J C T S Q;L
C N T Y E D V B K | T C K V E Y N B;D
Y Z C N V K X B H | Z Y X C N K V H;B
C W Y T G E M R O | T W Y O R E G M;C
D C A K J Z G I O | C O I A D J K G;Z
Q M Y T V X H W Z | H M Q V X W T Z;Y
F U N G J Z Y D I | N U G I J Z F Y;D
J M L I T D A K V | V M D L T J K I;A
A P Y O W K E Z I | K A E Y O Z W I;P
H R C Q L M P B F | P F H L B R Q M;C
U R N S M V A E X | V U R A S N M X;E
S G D I O R E M V | R S O D E G I V;M
C Y G W R B T V S | G W T R C Y V S;B
X W I P S J Y C V | I X S V W P J C;Y
I Z Q D T X G N U | N I X Q T D U Z;G
C H D G X T A S I | G I X S A D C H;T
M R B U J H N Z P | N B H U Z J P R;M
K U L H Z M V N Y | V K Y U L H Z M;N
N F S I H U Q D T | I F S D H N T Q;U
V O Q T P U L A Y | V O T Y L U Q A;P
M D B H Z W P S F | P F Z D B W H M;S
B E C Z K N X S Y | B N K C S E Y Z;X
U J P T Q D N C G | Q D C J G N U P;T
B O T X Z W N I E | I X O Z N T B W;E
M C V I N U A G Z | I Z G M A N U C;V
Y I K O Z G B V J | Y G J K I O V Z;B
T E F A L P K N Q | F E T A K N Q P;L
Q O V H Y M F P I | F Y O H P V Q M;I
Z X S G Q Y U L N | L Z X U G N Y S;Q
N I T Z H K R C E | E Z N R T I H K;C
A C T F G S P N V | F V A G P C S N;T
F L G R A S Z V P | L P A G V Z R S;F
P Q L Y J V N M W | P Q Y N M J W V;L
W B Z I M J X P G | X P B M Z W I G;J
Y X M R I F G S L | L R X G I F Y M;S
C U S F I A X J E | C F X A J U I E;S
F T S X P C Y M V | C V F S Y T M P;X
B G N X A F R H K | K N B H F R A X;G
O M F S X K Y E A | O X K A F S E M;Y
H R O S G J M Q X | Q R J O G S X M;H
D E B T X C J N H | J T D X B C H N;E
M O K T B P L J Z | P K Z M L T J B;O
B Z W D G N F R H | N H W Z D G R B;F
U F A Z N V P J L | A N P Z L F V J;U
X K E R M U D W Z | Z E K M D R U W;X
A M B H G O F T E | T H M B E G A F;O
L Z I E W X R H U | R X L I U Z H W;E
O C S K D B E P N | N D K B O S P C;E
A L Y F J E Z T M | Z Y J M F L T E;A
O J D Y K I G F X | Y X F D K G O J;I
H F G L V Y X A R | A V R H G F X L;Y
B H O Q D L Z N F | Q H L F D N Z B;O
E V X S W B F U R | E U W B F S V X;R
K S D V T G P H Q | D K S V P T Q H;G
Z B V H I Y N T A | I T N B Y V H A;Z
D V B P S T C F U | D S C P F V U B;T
Q R P U O T Y M C | Y O U P C M T R;Q
O H W S G J Q D V | S W H O Q V D G;J
N V G B S Z Q Y J | B S Y V N J Z G;Q
E Y X I M P O S F | E P I S X M F Y;O
V P Z F K L N S D | P V Z F N D L S;K
Y F L T U P N S X | U X P L T F S N;Y
E C X A P H O F D | F P X D E A C O;H
C F L Q Y T J V Z | Y L J Q T Z C V;F
F W M N Z A U D T | M U T W Z F D A;N
R G E L U K P N V | P G K N V U R L;E
U B P K Q D F T C | F K P Q C T U B;D
N P W F J D K I B | F I K B N J P W;D
R V U S K G D E F | D V S E R G K U;F
K M Q R H W A X G | Q A M H G K X W;R
G K M P S F Q D X | D Q F G S M X P;K
M Y C L H V P G F | L P F C H M Y V;G
U C R B A E X P G | A X E U G B C R;P
R D P B Z V N A Q | B A D V R Z N Q;P
J R Y E H G W X M | Y W G H M X R J;E
S T N W U I Q Z O | N O Z Q I S T W;U
U C J F T P A E N | A F P E C J N T;U
N I L P R Q U S M | R M P S L N U I;Q
Z K C S N I G Q A | A G K C Q S N Z;I
H Y X F A C E O D | A Y D F O E X C;H
C D X A V Z M H G | V G X C H A M D;Z
F K S Q U G Z W P | G K S W Z U F Q;P
X R K E G A C D W | K D A W X C E R;G
C W S A K T N Q V | Q K N W A V C T;S
D H K P Q L B S U | S H P D L K Q U;B
U Z T L B K A R D | A Z T B K L R D;U
Q D E A S G H F O | S Q O A D E F G;H
A J I H V Q O C Z | A C Z Q I O V J;H
P Z N S J G E V U | Z S V E G N P J;U
T F A G E U O Z J | G O F Z A E J U;T
W O J X T H E S C | O T H C X J E S;W
S W D X Y G Q N V | Q Y S W D V X G;N
I Q R B N V H G A | H B Q R I G V N;A
J W N P M T U K R | K U M P W J N R;T
Y K Q D F A I H J | K D I Q F J A Y;H
M C D X S U I E K | D S U X E K I C;M
G L I S H Q D A M | S L D M H A G I;Q
S Z Y R I O H D P | Z S R D H I Y O;P
A S U R N X O G P | N A X P U O R S;G
M P S G I V K X H | G S P K I V X M;H
O I W F K H C Y Z | C Y H Z O F K W;I
S Z W O P J M A B | J P A M W Z O S;B
K V W S D M C H T | K C W S T D M H;V
N T K B Q X O V H | N Q K O H T V B;X
M J W U X I T F Q | W I T F U Q X M;J
P H L Z V W S Q G | W V Q L P Z G S;H
H C J F S R A B V | J R V C H A S F;B
C H T B Y N S F P | H S C B F N Y P;T
A I T B Z S X P D | X B Z D T A I S;P
G A D M J E X L W | A M E W D X L J;G
E Y B N C U G W O | E U W C N Y B G;O
U Q N Z M T D I G | N T G Z M I Q D;U
S O Z V U X Y H E | E O S X V Y H U;Z
W J F G M K S Q Z | Q W S G K M Z J;F
C V R S T W L B D | B D T S L C R W;V
U J N G Y C T F R | U G F N R C T Y;J
Y J W X V F U M C | U J X C M F V Y;W
C V N L G R M I F | M V L G F C N R;I
F B N M T R C Z O | C O B Z N F R M;T
S L P D A T M Y Z | M D A P Z Y S L;T
E M S O C B W Q T | C O E W B M S T;Q
H B G T I Y M P S | H M G P B S I Y;T
S V D Q T B Y F H | B D T Y F V Q H;S
Q H Z J W B X T K | J K H B X Z Q T;W
C L H U Y Z Q R O | U C Z Y H O Q R;L
O N A V F S Y T L | A T S V F Y O N;L
L E J Z K W D B T | W B Z J T E K D;L
S Q O N C W I U P | U N W O P I S Q;C
W K C Z M I H S G | M K G I S H Z C;W
K M V J S A Z G P | V M K P J Z A S;G
B P E J G Y A D O | D G E J B A O Y;P
D N S R Q O Y L A | O R S Y D N A Q;L
I Q U P Y X E H L | E U X L Y I P H;Q
G B L U J I R Q H | I Q U H B R J G;L
X L M U C Y E V W | E L M X W Y U C;V
Y H V W M X C Q P | Y M Q W P C H V;X
U Q C L A X I H Z | Z L A H X U Q C;I
L X Q Z C Y I V P | V I L P C Z X Q;Y
O H Y B G K C R D | O G R K D H Y C;B
D U M A I E Z S L | M I A D E S Z L;U
F G O B R C M A Z | A B R G Z O M C;F
S N L U R V X E D | E L V S R X U N;D
T Z R I K N A B U | B R N U I K T A;Z
S A D M C J R B W | S W M A C D B R;J
C N X W O R Z P B | R O N X B Z C P;W
D R J G A W U F C | U G A C F W J D;R
G X A H T I D J P | I J X A H P D G;T
D R O Z F J B Y G | D Z O G Y F R J;B
S B Y M J C P T E | M P T Y B E C S;J
R T J V H Y D G W | W R J T V H Y D;G
O D G I K J S M N | O S D I M N K J;G
P X J I M Q O K H | Q P I J O X H M;K
O D Q V R F B S L | R D V F Q S O B;L
N D R P K F A Z H | N P F R Z K H D;A
D L V M P I F W H | P M H D I W L F;V
I G N L M K Y W T | M N W L Y I G T;K
R F X I P D W S B | X W R F B P D I;S
H S T P M L G U X | G P X T H U M S;L
T O W M L Z G A E | T A O W L M G E;Z
N O E T S R H Y M | S H E Y N M R O;T
X D Y G F R S N E | F E R Y D X G N;S
A C R O H D N S P | N S O H A D R P;C
K Z N G F R T P E | T E R F N G K P;Z
Z E V K S G I Q O | E K G S V Q I O;Z
C U D G P Y R K M | D M P G K C U Y;R
M W X V T N H Z A | W T M Z X N H V;A
M S R T W F D K H | W M K F H T R D;S
W I A G U Q O C N | Q O N C G I U A;W
S D W V L P R Y H | Y W V R L D H S;P
K P J D S E T C Z | S C P K D E T J;Z
Y E L X B R H U C | Y L X C E R U B;H
A B K W D G V I R | G D V R K I B W;A
O R W L V U D K G | K W L R V U O G;D
Z O X D V P F A L | L O A Z X F D P;V
G K B W R A O J D | G A O B R D J K;W
U W Y T E X K L O | U L T K W E Y O;X
G Y E M Q O A K Z | K A E M O G Z Y;Q
I H S V T Q B W G | S B G W I T V Q;H
I Z O V K P S B N | B O Z N S P K V;I
D J V X M Q W U P | U W M X D Q J P;V
X Y F H R K B J O | B Y H K O R X F;J
D E H G X M I R L | I M E L D G H X;R
S I C A R G Y O N | Y G R N I C S A;O
A P X L J G V O D | D G L P X J A V;O
W C B Z Q O T I S | I T C Q O B W S;Z
G X Q Y E L O J U | U J L Q X O E G;Y
X Q E U B T A R P | X P E B T U Q A;R
R M T K E X L S J | R E K X T L S M;J
T H A J G S L X F | J L S F X G H T;A
S Z Q U C H I X Y | S Z X C I U H Y;Q
Y J Q F O D M X S | F X J Y D Q O M;S
E N S H R A P I G | G N E R I S H A;P
U Q H M A E K W S | A W U E S M K Q;H
Y E H K D N U F S | U S D K F E N H;Y
O J T H P M R K B | M H J T K R O P;B
V W U A C X B G R | B C V A X R G U;W
E L F N Q C G V D | N L Q C V D G F;E
I P Z X C D G K S | K S G X C D P Z;I
Z B Y K U N J X R | B U N J Y Z K R;X
V L M S B A Q O F | L M F S B A V Q;O
A E M R L S H X W | E H S L A X M R;W
R X O H T Q K N M | H M Q T O R K X;N
Q E P Y I V X T B | B E X Q Y T V P;I
N J A M W X E T I | W J I E X M T A;N
P O B E F D W X H | W E O H F P D B;X
P D X Q E U R I L | U L I E Q D P X;R
Y G C K Z P J T H | H G C Y Z J P T;K
P Z T L A F N Q H | Z Q N L P F H T;A
I D U Z J V B E N | U Z N D B J I V;E
A E H K Z T O J C | A H T K E O J C;Z
F K X Y L B I O Q | X O Q F L I K B;Y
X C V J E N A Y I | E Y I C N J A X;V
G R F T C W M V L | F V R L G T C W;M
T L N M H I D P K | N T L M D I H K;P
R F K S P N O H E | K E N F P H R S;O
O Y C P D F N T X | X T P F O N D Y;C
T Z W Q J X I G R | R T I W Z G X Q;J
K R V N Y Z Q C O | V C Z Q O N K Y;R
C N V M W P D H Z | V D N W H Z M P;C
Y G S W R A X C D | X W R Y S C G A;D
E T J X C Q Y Z U | T E X C U Y Q Z;J
D T J I S B M K Z | S M J K T B D I;Z
U J C V X L F Y Z | L U F X Z C V Y;J
R E U D S J M V K | V M U R J E D K;S
G M D L C X Q A J | M G J Q D L A C;X
M U O G N L I D R | O L G I N M U R;D
L W O H Y F K I X | W H F L X Y I O;K
A H G O Q L N S K | K Q S O H N L G;A
J O K W E B R N G | G B W E O R K J;N
V G X A T U F P H | T V U X G H F A;P
R X Y E G U J I D | Y R J G D X I U;E
N Q P W L V K G C | Q V W P C L G K;N
E T G X J S Q K Y | X G K J E T Y S;Q
H G V Y M L A E J | L H V Y G A J M;E
H S R P U D M V G | D S G V U R M P;H
E V L Z Y J W C S | J Y V L S Z C W;E
W E Y Z A X S D L | W L X Z D E S A;Y
D S G Y U I F J R | J F D U Y I G R;S
H U O L T D A G Y | A D T H U L G O;Y
Z R C Q A B G J Y | Y G J B Q R A C;Z
W H B D I U N R F | F H U I N D R B;W
D N E I M J C A P | D P M I E N A C;J
W B J U M A O F D | B D O U M W J A;F
Q I G D J O F T W | Q J I G D T O F;W
P E Y W U J H R X | J W E Y H X U R;P
F D Q E T Z Y S J | Z D S E T Y F Q;J
S Z V A D F C G B | Z G C A S F B D;V
M E X W D U G Z L | E M X G W L D U;Z
R P H E C D M T V | T V H P E C R D;M
G I L K W J Q M S | I K S J M W Q L;G
P X A J H U G O E | A E O H G P U X;J
A X G D W H L S J | A W H D J S G L;X
B C V E K L P D Y | B L E C V K P Y;D
D R G S E U B T C | B U E T R D C S;G
F A G N Y Q C J Z | Y A N J G Q C Z;F
L F J M Z Y I U P | F J Y I U L P Z;M
K O C E R V H M L | E M R V K H L C;O
G E F A T V L W H | A L F V W T E H;G
W U S H B J L C O | U B C J W S L O;H
P X Q F H E I V Y | Y F I X E P Q H;V
J U G Q N I Z O M | G M U I O Q Z J;N
I Y C G N J L E W | Y N G W L I J E;C
M A C L F G Y E H | A F C L H M Y G;E
U Y M K V O W N C | W U O M K Y V C;N
J H C Z S D I L P | P L H I S C D Z;J
S G R O Y J A Z I | J R O Y G I Z S;A
Y X U D K P J R Q | D R U Q K X Y J;P
R M K I S E W N Q | S M N K R I E Q;W
E J U H Q L B D T | J U T E D B L Q;H
Z O M R K T J U P | J O U M T K Z R;P
O U M J K V Y S L | L J U V K S Y O;M
D Q S G K W P N I | Q G S D P W I N;K
T S Z K R W O N P | K W P N R S Z T;O
F O J I X N G R Z | X N I R G Z O F;J
C E H F P W M O X | P X F E C O W M;H
Y P K N L H T I V | K I H T L V N Y;P
M S J G E D F X N | F E S G D X J N;M
Y H N V E X J S Q | H Y X Q S J V E;N
V Y A W D P H M S | V H Y D M A W P;S
M S U X N L O I F | L O F M U S I X;N
V Z I S W E C P M | P S E I W M Z V;C
S Z H D E X F V J | V F H D S E J X;Z
B N X S O U K C H | C K N H B S U X;O
I P D Q K Z N H B | D N H K P Q I Z;B
T Z P I K B C H R | Z I H K B P C R;T
D J W Y H G O S B | O B J S Y H G W;D
Q Y K L I C T H B | K I Y B T Q C L;H
M I C Z O L F G A | M C L A G I O Z;F
Z G J M E S B X V | M B V G E X S Z;J
Z O P Q X A G N J | X Z O P A G Q J;N
R S J L U D K G N | J U R K N S D L;G
F O B Y V N S C P | F P O S N C V Y;B
T Z R D U I S X K | X S Z D U K I T;R
D W N T G P B J Z | T Z B W D J N G;P
K Q R Y H V W N J | J N K H R W V Y;Q
E Z I G P C B L Q | C G P L Q I B E;Z
B Q C Z H S E O L | O E S L Z Q H B;C
P G T M Y N X K A | X K M T Y G P A;N
F Q Z E Y L M A O | F Y Z E L Q M O;A
U D N H C L I G T | I H U T N D L C;G
J Z R G B V Y P C | V Z Y P R C G J;B
R C B Q N V F K U | U C K R F B V N;Q
Q E C G X T R A U | A E U C G Q R X;T
V J A B Z W R C X | X W A J C R V Z;B
H A O P T W Z Y V | Y H W V T O P A;Z
X A H F K P M D W | M F K A P H D X;W
H Q N I T D A V F | T H F V A Q N I;D
L B W N X D E S Q | L Q X B S W N D;E
Z X H B Y S E A I | E Z A Y I S H X;B
J E Y V N I S F W | V E F J W Y S N;I
I H R Y Q E A M C | H E A R M Y Q C;I
I D V L E A Y B W | Y W E A V L B D;I
H Y T M Z V O J X | Y T O J Z X M H;V
P L K O C N U J W | J N C P O U W L;K
L T K E H W B Y R | K Y T E L H W R;B
K Y U Z A Q I F G | A Q U F I G Z K;Y
H O W I T P L Q Z | T Z O P Q I W H;L
E R J M V W B X D | D B M J R E V X;W
R Y U S E H C Z F | R U C Z H F S Y;E
K G T A X W H L C | A K W G X C L T;H
T Q O L G X V H R | G Q X R H T V L;O
X K P Z F S M C I | K S X I P Z F M;C
R U T C J X P B A | T X C J R B A P;U
Y N J E Z M T V S | Z E J V S T M N;Y
C Q U R M B E X A | X A R Q M C E U;B
S C E J U O Q W L | L J O S W Q E C;U
U T I E F K X Z Y | I T F Y U Z E X;K
N S G C H D L V K | S K G V H L N D;C
E U B S P F V I M | M P S U F I B V;E
G H D N B V Z F P | B N Z H F P D G;V
Y Q A N V I S F R | A I F Q S V Y R;N
Z I X T F A W E R | W T X F I A R Z;E
S G P F W D R J V | R F G S W D J V;P
W A V L U F Q C X | W Q F V A L C U;X
J Z B N W R Q T M | J Z N T R Q W B;M
X Z P K E O F D Y | X O Y F K P E Z;D
Y Z U L G P I S O | L U I Y S G O P;Z
N M Y D I E J O Q | E O M I Q D N Y;J
G A J H I Z C V F | G F A I Z H J V;C
X Y Z H I Q N C W | Z N W I Y H Q C;X
X Y S F H E V P W | F Y W P S H X E;V
K T G F N Q X L S | G Q L F X N T K;S
R D O F N X S Z U | F R O N D S X Z;U
Z G U K X C D T M | D G C K U Z X T;M
W N O M Y U H X K | Y H O K W M X U;N
A W N B Z I P L J | J A B Z N L I W;P
X W Q E G Z H B T | T Q X Z G E B H;W
I W B J Q Y P E F | F P Y I B W E Q;J
D S T I A M Q F B | I D Q S T M B F;A
Y T C V A F K D B | T D C Y K V A F;B
J K E Z S L C X P | E C Z K S P L J;X
G Z D L R T X B K | L T X R G Z D B;K
L T S W P Y I C K | K T Y C W I S L;P
U T S W P A M I C | T C S P I W A M;U
X C F N H K Y V I | I K F X N C Y H;V
A B W S Q P O Z N | A W N B S P Z Q;O
H U W N G X M Y Z | W H G Z Y X U N;M
A S N Q F U V T P | U V A F P Q T S;N
B C M Y G V P K I | P C K Y B I M G;V
H M Z Y B T X W N | H M X N W Y Z T;B
X K A H Y B C N P | X C H Y A P B K;N
U A E H T D Y M G | T D U G E M H A;Y
S K I Y X O R U A | R Y O X I K A U;S
D S L Y K G N O F | D F Y S O G K L;N
X D R H N Z Y P W | R D X N P W H Y;Z
O H R P I G S F V | F S H G O I R V;P
E M H U B Z C S O | M H B E S U O C;Z
C U R V A K S O X | K U A C R V S O;X
K H B C L R V X Q | C L Q H X K B V;R
E C V B M R W J P | P V E R W M C B;J
N T Z I Q A E J H | I Z T H E N Q J;A
I U D J O W Q R B | Q D O U I R B W;J
X Q W T P Y S E R | E T Y X S Q R W;P
Q K Y N S W H C A | N Q K S A C W H;Y
M S O T J B V D I | S D T O I B V J;M
L O N K F P H M U | U M L P N O K F;H
Y O E H L Q M C B | B C Y O E Q M H;L
L S C T I Q O W J | S J O C L W Q T;I
I B N S V O G P X | B P N X S G V O;I
F I C H E D Q A U | D I F E Q C U H;A
V X I R J U F H T | U T R H J I V F;X
Z Q K V D J P Y W | D J V P Q Y K Z;W
H G O X S U I F T | T X U O S F G H;I
K A R Z N X P Y F | A R K Z N Y F P;X
N T S W K C B X D | B X W C N K S T;D
B P Y E V G L O F | Y B F O P V G L;E
K I A T W P H Q C | H C A T I Q P W;K
L F Q R Y O W X N | Q N Y X F L O W;R
N U Q D H Z P X L | U X L Q Z P H D;N
Q E Z C H I S A W | S I W Q E C Z A;H
Q A S Y O C D X F | O A Q X F D C Y;S
W M T C Z L I Q J | J L Q C W T M Z;I
Y N E S W M R Q J | J W R Q S N Y M;E
B A W K H D E L O | H L D A B E O K;W
P G Z I F Y V S U | V P S G Y U Z I;F
K E X L F P Y N S | P F K S N L Y E;X
I Q L G S M B N P | I P N S M Q L B;G
A E K D U Y L O H | K U E Y O L D A;H
D C A E I P H K G | K A E I D P G H;C
X O C I P U Q A N | Q I N P A C X O;U
G E H O X T J C U | T C H E J U X G;O
K P H I G A F J D | A K D F P G J H;I
H N K M P B G W Q | P K M N B H Q W;G
H F E W T K O N U | T N K H E W O F;U
U C N Y I D G M E | E M N Y G U I D;C
Q S Z L M F U O X | L S M X O U Z F;Q
I W R S Q P D B J | Q I J B P D W S;R
E L O Q K Z X P I | Q P Z E K X L O;I
M N G I A Y Z L Q | Q Y M I Z A L G;N
M L O U B N Q X C | C O N L U B X M;Q
Z F M V D Q J R U | J V D F M R Q U;Z
R G D L U Y I T F | Y T L I R F G U;D
L E Z K C G O Q H | H G Q L O E Z C;K
V I D X H N L E C | N C X E I H V L;D
A V Y J N M C E U | M Y V N U C A E;J
E A J V Z F K Y T | J T K V A Y F Z;E
U B Q P G Z M A I | G A M P Q Z U I;B
F C T U A X P Z Q | P X C Q F A U Z;T
A T W H U O X C Z | Z T C O W U H A;X
Y C S J U M I D L | S M C Y I U L D;J
Q Y C T N S G P W | T C Y G W S N Q;P
P F R B A T I L G | I P G B F L T A;R
I Q Z B T R V J K | R T Q Z B K J V;I
L N J P H B M K Y | P J N H B L K Y;M
P Z W N R H T X Q | X R N H T W Z Q;P
R N T Y V F H S X | F V H Y N X S R;T
B K G Q P O X C D | X C P D G Q B O;K
G Y B R N A Q F S | Y Q F B G S N A;R
V T P N J U F G B | G F B N U V T J;P
X T M Z C A I Y L | T I Z L A C Y M;X
E L F W S G R I U | S W E R L G I U;F
Y E I A B D M P J | D I P A E J Y M;B
B C D A P W H F U | W U B P D F A C;H
Y N E K C U B A S | K C S Y U N A E;B
E L Q C A N Z T R | N Z E L C T R Q;A
O K G C N Q E A W | E Q G W C N K A;O
Z Y D A C S H E M | Y M D E A H Z C;S
A U C S V E R N I | R E V S U N A I;C
V I D B Y R F U L | R Y U B V L D F;I
J G X T E Z I F Y | Z T I X Y G J F;E
J V Q B I D M A F | F J I V M D Q A;B
W N C R H J S E M | C H M J N R S W;E
E A O C N K L B I | O K A B E L I N;C
B C J Q U Z V N E | N U B J Z C V E;Q
Z H Q L R N P C D | H L P Q Z N C D;R
F U L P C R T S Y | C L F U S T R P;Y
F U Y N B R Z D H | F N U Y D Z H R;B
E S Y Q W V I F N | N W Y E V I Q F;S
S R L U Q E G D K | R D L G S E Q K;U
D C F I A S P N H | I A P H N S D C;F
L K R F T Q A Z U | K L A T R Z F U;Q
Y C U F P N W Q H | P Q Y W H U N C;F
W O E M J H S C T | S M O W H E T J;C
T S F O V D K J Q | D Q V O J T K S;F
Y V W G T D H K J | T H Y K W G V J;D
Q S N Y Z E L O X | X Q Y Z L N O S;E
H Y A C Z D U Q I | I H Q A Y D Z U;C
R C X A Y G S U T | R Y C G A X U T;S
R H K U F Y M G A | Y A R G F H M U;K
J P H F X D Q G R | H Q R G D P X F;J
A U L N F E K Q B | L Q K N A F E U;B
F M Z R X Q I T N | T R X N F Q I M;Z
D P G H K F X B J | D H J G X B K P;F
Z Y U T F W V J N | Z F N V J Y T W;U
Y L T R B U S N J | Y S T J R U L B;N
S Q E K J Y M C U | M Q Y U J E K C;S
X W G S D Y T Q N | W N Q T X S G Y;D
C W U V O G J R H | U C H R O J G V;W
C O K S V L J U H | C S J O U H L V;K
D Y E Q B M X H S | X B D S M Q H Y;E
E U I F R J C W K | E W F R J U I K;C
G X Y P D W N U R | N Y X G R P U W;D
V J Y C U I S N R | Y J S V U C R I;N
E C H L P G I R B | L R P C I B H G;E
C L F U I W D S Y | U F L W I C D S;Y
P L Q F K M X T R | P F R L X K M T;Q
Q A C Z F W P N T | Q W F T Z A N C;P
Z R K X D V Y A C | K D Y Z V X R A;C
I K A B Z D F T U | I A Z B K T D F;U
W O R S Q D U H J | S O H R D U W J;Q
O A D Y W G K F X | O D A X F K G W;Y
R W U D Q L A B X | U X D L Q W R B;A
I F H K Y U V C L | L V I H F Y C U;K
O C W K D Q A U Z | Z Q D A C U K O;W
Q X F I T E D J K | I X E T J F Q D;K
D O S V F P I J H | O H F V P S D I;J
V D F A O M N S Z | A F V M S O Z D;N
C V F X A T E Y Z | T A Z X V C F Y;E
W R F S M Y U K D | M F U D S W R K;Y
O E T H P A G N C | G H E T C O N A;P
A X F P R S Y J K | S X F K A J R Y;P
N X L R P A T U Q | U T A P X R N Q;L
K G V O R D F E J | F V J R O G D E;K
P L R U Z C X H K | K H X C R L U P;Z
B M D U A F O X C | X C U A O B F D;M
C D Z S U R N W A | S W R N D Z C A;U
N V Z Y J L R C M | Z N J L M C Y V;R
O A L S M K Y B V | O B L K M S A Y;V
J U F N P X A S W | P W N U J F S A;X
S V Q L K R G H T | Q S H R K V T G;L
M Y A X G D F O U | G O D U F A M Y;X
P I O E M G L B S | E O G M P B S L;I
A D X M U J C P N | A D P N X C J M;U
Z C B E P N L F D | F P Z L N C D B;E
R S G D T L A X J | A G X T S D J R;L
F Y R A T X S J D | J X D T S F Y R;A
U K X N H A Z W P | H X N W A K Z U;P
C G K N A S O T U | N C T K G U S O;A
J U P O K H D Z B | U Z B O K D P J;H
Z S W K Y O C D P | D Y C O K S W P;Z
L P A B F S X N R | N S R A L F B X;P
U M R P F C A B K | R M P U F K C B;A
B J F X C U A D Q | F C D U J Q B A;X
S R Y M F X T D L | S D T R M Y X F;L
J K A M E L G R W | A W K R M J L E;G
K P M R O V G D U | R V M D O K G U;P
F Z N T Y I M E G | Y I N F M T G Z;E
L N Z V W M D O I | N M V L O W I D;Z
B X K T E N G J O | G X E J N K T O;B
Z C A G I P Y B N | B G C Y A I Z N;P
J Z I W M X S G T | S T Z X I J G W;M
S E B V A W I T X | I X V B E A W S;T
P A N T H Y R M E | N E A R T M Y P;H
T R X W U L M V P | P W R V M L U T;X
Z B O H P N J T E | P N E O Z B J T;H
X A H L K V N U M | V M N H U L X A;K
S C N U Z A W D F | U D W F C N A S;Z
A L O B D F J K G | A J O B F G K D;L
U D T I A X E S C | U A S T D E I X;C
Z G A R O Y W U N | Z A N O R W U G;Y
J X F W Y Z K S C | S Z W C X K F J;Y
Y V P E R H A B O | O H V P A E Y R;B
K M E T P U S L D | M U P K D T L S;E
C B M L S D J Q F | S Q M C F L D J;B
O A T N H Z Q E B | E B O A N Z H T;Q
I N S W Z B O U L | O U Z S N W B L;I
G T A K C U B F D | F D U K A T C G;B
L I K R S O Z U T | L T Z S U K R I;O
R A J O I P M G L | J A R I M G P L;O
K S W Z H E X B Q | K Z B W E X H Q;S
C Z T K Y W U M B | B U C T Z W M K;Y
U R I D B F H C S | I B S R H D F U;C
H C G Q K I S F Z | S Q G Z H C F I;K
Q P T X H G A J S | T S Q A G H X J;P
X R V K U W N S P | S W N U V R X K;P
Y T D E M R P K V | Y T P D E M V R;K
Q O H P T V S Y K | V K T Y O H S Q;P
O L I A F C B Y P | B P L C F A O Y;I
T J S W K Q V X Y | S K T V Q Y J X;W
O X D W Y P F V Z | F Y V D X W P O;Z
L R X S G E Y K N | S K X Y E L G N;R
Z M K V G O B R J | K M J R B O Z G;V
I C D P B S H Z U | Z H P D B C S U;I
V X A R S E H Z F | S H X R V A F E;Z
L O Y K I A H B G | L K O A H B I G;Y
Z P D I U L A C N | N Z I L P D C A;U
N V L M Q O P C B | L P C B V O Q N;M
A D V S E W K Y H | K H W A D Y S E;V
M D E R A C F H I | F D I M R E A C;H
G P T U J X R C F | C P J F X G U R;T
M A B I T W U J O | A I U W J T B M;O
Z O K D X M I U A | Z I M O A D K U;X
T B F S O L E Y D | L F D B E T O S;Y
Q D B J N M Z P A | Q D N Z J M P B;A
S I M R C F H N T | F I R S N H M T;C
J M P N F R W E T | R F W M T N E P;J
K Y T G H M E O P | G H O P M Y K E;T
C H L G O V D M K | O H L V K D M C;G
C M W K I O Y X E | E C Y X O K I M;W
F U M H P V S A B | U B H S F M A P;V
M L Z R N B C J H | Z B J H N C R L;M
M I X C H U A P L | U I C A P M X L;H
L S Z W B J N M U | Z N U M S J L B;W
J U V S X Y O M T | U Y S V M T X O;J
T B F M A I L P N | T N P B F A I M;L
N P Z R I C Q U L | C U Z L Q P R N;I
M Q I Z E G U C R | I Z Q M G R C U;E
G S M L C N O Q I | S Q G O N L I M;C
H Z M C R A L F W | W M R Z C A F L;H
Y E R G K N Z W H | K Y Z R N E W G;H
V M T Y X J A Q F | X A Y T J Q M F;V
N H Y W E S X L T | L Y E N W X S H;T
Q Y D T K G L O C | Q G K T O C D Y;L
E N P A B J T L Q | N P E L A B J T;Q
Y T V K H M J I L | I Y H J V K L T;M
M N G U D L X Z T | L Z G N M U D X;T
J K A U O B E F C | B O K J F A E U;C
Q H W L A R K T V | V Q T R H A K L;W
G S J H A P N R Z | Z A G R P N S J;H
T J X A S V E D C | V A J E S D T C;X
R A P B X K V U W | X R B V P U K W;A
I Z R B Q C U D F | D Z Q U R I C B;F
E T P M K Q R B S | T E R S P B M Q;K
T J A Y H V S W N | N W T A S H V J;Y
K G Y D W P L F I | G I Y P L D F K;W
G J O H Q M L T V | G V M J L H Q O;T
S C Y Q Z K A V O | V Y Z Q C S A K;O
Z G N Q L V U Y T | G Z N U Q T L V;Y
O L N M D Q W C A | O D N M C Q A L;W
U M P A Z I B L H | M L A B Z I H P;U
M W F N B C E J Z | F M C W N Z B J;E
V E N U Y B D T X | E V T B U D N Y;X
O R D E G I L B C | E O L D G B C R;I
V G E Q R O I L U | E L R Q I G U O;V
U D T I E K W F V | D U T E F K I V;W
S Y G A Z O T E M | A T E Y G M O S;Z
Q C N H F W V K B | H Q C N K V W B;F
A U Y H W V Q P O | V Y O U P W A H;Q
I J B V L Z Y G R | V Y Z R B I L J;G
B D S P N X O C L | S L O C X B D P;N
A B W F J M N U D | M W F U B N D J;A
V Z Y N I C T K O | Y K Z T N V O C;I
B G A M F R X P Z | P Z A X R G F M;B
G B P H C Q U L N | L U G P B C H Q;N
B V E H Z J C W G | C B G Z J W H E;V
R A X Z B N L T M | B X R Z N T A L;M
D R B E S Z Y G V | E V S D B R G Y;Z
G Z S P B N F L C | S F L N C B Z P;G
P C N F R Q Y K X | P R Y F N C X K;Q
I C U H N R S T G | U C S G H I R N;T
J Q Y I K W R V S | V R S Q W I J K;Y
M Y L K R Z S C O | S K C L Y Z O M;R
V R H T N E P J I | E J P T I V R H;N
C F N V W O K H R | R F H V K W C N;O
I F Y E S W Q Z H | H Q S F Y Z I W;E
T H V E W Z Y O Q | T Y H W O V Z Q;E
E V J Z Q Y F P I | J E V F Y Q I P;Z
J R E F P M C Q D | M E P F D C J Q;R
I F J P T L W D B | I D F L P J B T;W
D X O Q T H A Z Y | H O Y T X Z A Q;D
R S Z T V D G F H | F T Z V S H G R;D
E Y B V T L S A J | L S T J V B E Y;A
T S D Q V B L O E | T O S V Q L B E;D
P S T O N C L Q D | T L D C O Q P S;N
V R A L F Q U Y X | V Y Q X R L U F;A
U R S I L Y F M D | R I Y U M S F L;D
B V P G N U T I A | B G A T I N P U;V
O M C L K S Y I U | I U C K M S O L;Y
L F H R Y B O D J | F H O B J D R L;Y
K T V A Z Q H E N | Z V K Q H A N T;E
V J P Q G C U Y E | V E C Y U G Q J;P
K J F P Q X I U Z | J X F U P K Q I;Z
S Y J F K G C Z P | F G Z J Y C S K;P
O B U C I H Z E R | B H Z I C O U R;E
J W O Z E U C M Y | E Z J U Y C M O;W
Z Q H P F S A B I | S P Q H Z I F B;A
I S J F B A V T U | T A S F V B U J;I
N C V Y I S Z D U | Z U D I S Y N V;C
M K G R Z H C Q X | K Z Q H C X R G;M
D W Z U F E P C H | D E U Z F C W H;P
D U A Y G B L Z N | G Y N D A U L B;Z
G I R L J S X M E | G J I L R X E S;M
U X T M Q P Z A H | Q U A P H M Z X;T
A Y N V Z K B E P | B N V Y K P A Z;E
G C H O U V D B L | B U D L C H O V;G
D Y A P L I R U N | I L A P D U N R;Y
H P D U N A L K F | P D U H K L A F;N
N P D X I E H B G | B I N H E X P G;D
H O X G W M T S P | G P O S T H M W;X
G N E K Z H S D U | G U E S Z H N D;K
W G P K I O Y D X | D I W P O K X G;Y
F P C L R Y I J A | R I Y J P L C F;A
A S J P V M U Z X | A P Z X V S U M;J
K X V T M L D I J | T M X V D L K J;I
C A S V J E X L B | A J C L S E B V;X
K S M Y D X Z J Q | Q S Z X Y J M D;K
S X N O G Y U I H | X I Y S G H N U;O
B R Z L C G F A M | C Z B G F L R A;M
Z W J S L O K V C | K W L Z O S J C;V
O J A F D U V W L | L V U O W A D F;J
Y Z E X D T W S P | Y P X Z S W D E;T
W U T Q S R Y Z P | T Z Y S P U R Q;W
H B W O U L Q T A | B L W O U H T A;Q
L W X N T S D I H | X H I W D T S N;L
U F Y G V I K B A | G K U A F I V Y;B
Q Z N I V C Y R P | N Y R Z C P I Q;V
B K I Z Y C L G U | K Z U C B L Y G;I
Z L H O C F N W G | L H O C N W F G;Z
T P Z A U C I V W | P Z A T W C U V;I
X M K S Z F J C B | J F M C X S B Z;K
Z Y F D M O L C B | C L D B F M Y Z;O
F H B S P V Q O D | O B S Q V F H P;D
U D X A B P V F M | P V B U A M D X;F
G R H O Y C B S J | Y G R S B C J H;O
N I F W C J P L Y | F Y I L P W J C;N
W R B V Q N Z H O | N Z H B O Q R W;V
S J Q X M H I V B | S H V M Q J B I;X
L X G B P O N Q C | O X Q C G P B N;L
T Z F W N Q I E M | N Z Q W M T E F;I
A C Z K T B S Q X | T X C K B Q Z A;S
Q C K F J G P S D | G D S C J F P K;Q
M V I G Z Y Q K O | Z K G I O Q Y V;M
D Q B U K N P L A | D B A U K L P Q;N
O Q H B Y K W V N | H B W K O V Q Y;N
M K O V H B E A X | V O H E M A K X;B
C Z J U W P F G L | J L P Z U F W C;G
F I X L U V Z S A | Z L F S A X I U;V
T R C U O J W S P | U C R T J W O P;S
U G D M N I R T O | N I D M U T R O;G
N K X E S Y H Q G | E K S H X Y G N;Q
T H R B O V Z M Y | Y O Z T B V H R;M
B K P D F O Q R H | D F R B K H P Q;O
Y C A T Q X R M S | C Q M A R X Y S;T
Q T A H R Y F D B | F T H D B Q A Y;R
J Z O S C W L R I | O Z L S R I C W;J
N L F O Z V S D I | Z L F D O V S N;I
K N F W J Q E B C | C E J N K Q F W;B
J N Z U P M V R H | R J V Z M U H P;N
Z D F H B W A L Q | H B Z F W D Q A;L
K N B R L D W E H | D N H B W R E L;K
F C X B P K T I J | J C F T I B K P;X
I J G X V A E M N | M J G I A N X E;V
H M E O L W I D Q | D H W Q M E L I;O
Z I N J V A K O T | Z N A K T O I V;J
L R Y J B H T N A | N R B A T J L H;Y
J H V E L O B R F | H J E R L B O F;V
T S M V D L X G H | M T D L X H S V;G
E N V J F C Q I M | M C E F V N J Q;I
E R N G B V Q Z P | E G V N R Z B Q;P
V K L P N Y C M G | L K Y V G P N C;M
S M J P N K L D Z | K P N M D L Z J;S
O Q E M K G S Y T | O M S G Y T Q E;K
Y C X Z W A Q L T | L A Y Z C Q W X;T
O I W B V X L T C | V B T I C O W X;L
J D X H G Q C W Z | X H G Q D Z W C;J
Q N E G R T K A Y | K E R N G Y Q T;A
H S W N V M U Q K | S K N U H Q W M;V
N H Z R U G X W F | Z R X F G H U N;W
X N L W D Y K R F | X L N K R F W Y;D
U R C W F J I N V | W J C V U R I F;N
N M Z Y O U L Q V | Y L N Q Z M V U;O
G V B A H E I L T | E B T I L A G V;H
N D X K Q T W C L | W T Q C L X N D;K
B H P Z I A W G Y | G B I W Y P H A;Z
G S J Q E O D A P | P O S D J G E A;Q
X H R I B G C V Z | H B G X Z R I V;C
E U N I P G C O F | P C N E G U I F;O
N E K G R H C X T | C R H X G T K N;E
J R W V D X M E H | M J V W D R E H;X
Q K I H P J T Z W | Z Q K T W H P J;I
W C T S V Q J P Z | C T V Q P S W J;Z
X I P L F D G A T | G F P D T A I X;L
X D P I J M C W T | X T W D M P I C;J
F R C A P N E Q V | F P Q N E V A C;R
R H G B K F V M I | B F G M H R V I;K
I L G B A M U W N | N G I B L W U A;M
N H K G F L U R O | H R U N L K F G;O
Q Z M W F C B E H | C Z B W F E M H;Q
O M W C V A Y H D | Y V O A H M D C;W
G P Q L X K R U D | X D Q P G R L U;K
F O T W S R L M G | T M F O R L W S;G
X E J H C G A M K | A E C X M K H G;J
P C K V N Y A I U | P I C K N U Y A;V
M W P A H Q G T F | T F W M P H A Q;G
C A X U O P M Y J | M O C U P Y J X;A
A E I K S L D B H | E S A K D H I L;B
A D T K Q G S Z L | G K S Q A L D T;Z
K E I Y Z N O D M | O N I Y Z M E K;D
S F G C K Y T L Z | G K F Y Z L T S;C
K C G Z E N W F D | K G Z F W D N E;C
E S J W C T F G R | E W F G C T R J;S
