L P U O H A Z G B | U P H O Z L G A;B
O C Y U P Q G W M | Y M Q P C W G O;U
R E X S Y Z B M Q | S R Q X M Z B Y;E
U Z D K F J V Y W | J K U Z Y D V W;F
P Z H O Y Q N S M | P N M O Q S Z Y;H
F G L V J Y M B C | J Y V F C L B M;G
Y G X L F D U W E | Y G U X W L F E;D
O B E K Z M I N C | O Z E M I B K C;N
H E V U W O B M X | W E X O U M V B;H
H C B O F M T S N | T M F N H C B O;S
T X E R P N Y H Q | E N Y P T H X R;Q
G F T V C M K R Y | C R V T F Y M K;G
R Q Y V K E D O S | Y Q O D K R S E;V
R H B E Y F L X P | B F R L Y X P E;H
S M O T F H X L J | M H O T S L F X;J
Y F W M G I D L H | I Y F W L D H M;G
B T W R V I M H L | L B R H W T V M;I
T P V Z W A K G F | W Z T V A F P G;K
G B E V Y H J C M | V C Y G E B J H;M
H P S L Q X I K T | K T X H Q L I P;S
Z H R J Y M F B U | J B M Y H R Z F;U
G Y Q W B E S V D | B D V Q W Y G S;E
H K G U S X Z L I | X S Z I L K U G;H
R B V K M E N W C | W V M N R K C E;B
I B E K C J S O H | O S J K C H I B;E
U A R Q N Z B H K | R U N B Z H Q K;A
P U F X S M R Z O | M S R X U P Z O;F
C L Q U M Z I F S | U Z F L I C S M;Q
X Y V K C A H Q I | C H A I K Y X V;Q
D J A E T Y V U B | U V Y J T A D B;E
T N G I F O D J U | T I J F N D G O;U
V W G Q H L I B E | B W L G H E V I;Q
V R M K Y F G Z B | F V G Z R B M K;Y
Y J B K H W Q G Z | G W J K Z Q B Y;H
T W F V R J A C X | V T C R J X F A;W
C O Y D S P R T V | D P T C V S O R;Y
U Q X F T D M A H | D M Q F H X U A;T
K Z D M S U Q I G | G K Q D U I S Z;M
P F V Z X W N E I | X P N F E I V Z;W
J E N Y S H O X D | N J X E Y D O H;S
Q X U R S F Z K I | Z Q I R U F S X;K
L I Y K M B E W C | L M B K E C W I;Y
N B G A K U E V L | V L E G N A U B;K
Q E I P S V B U J | E B U S P J Q V;I
W L C K R Z S J Y | W Y Z S R J K L;C
K B O W P S V H A | B A P S K W H V;O
Z K X G W L F V N | N G X F L W V K;Z
T K G L P C S J V | P L C T G S V J;K
R Q G T V L O X C | C G O Q L T R V;X
E S W Z Q R N V B | E B Q V R N Z W;S
N I D X Z M K L B | K B M X N L Z I;D
P V O W R S X K E | X V O W K P E S;R
F P X S A H V C D | A H P D F V C S;X
F X S A O N M P Z | M O F X Z N P A;S
P Y U H W K B F A | K U H P F B A W;Y
H C G M E P B X J | P B J E X G C M;H
T F H D C E G L I | C D F I L E G H;T
Z E U I S B W F L | B S U L W F Z I;E
V D U R J H Q G S | D G J U S R V Q;H
V E K W M G C L S | L W K M E C S V;G
W F T N U V S Z Q | Q F W N U V S Z;T
Y I D V Q U L O N | V Q D U N L Y O;I
B W U E X C K Z P | C W B P U X E Z;K
I E T J K M O Z Y | E Z K J M T I Y;O
L Y K S C R H Z O | O H L K Y R C S;Z
U C J M K H T Y W | J T K U Y M H C;W
U Q J K V L G D E | D V U Q L E G J;K
U F L I X Z K B W | W U B F I K Z L;X
L R J T A Q U G I | A U R L T G J Q;I
H M O U P N S J T | N T J O U M H S;P
A I T G V L H J F | I V T G H J L F;A
A P D E M N Y T S | A N P E D M T S;Y
Z Y Q W E R H V I | E I H Q Y Z V W;R
F R O J E V W Q M | E R Q V F J M O;W
Z P Y G K W Q O A | O Z A W Y Q K G;P
B H D U F C J G O | B J D U G F C O;H
R W K A T N J F V | N J A T K R V W;F
Z E X C J Y A H N | N C X J E A Y H;Z
S N V R A B T X U | T A B X N V R S;U
W P T C S G K A X | P T A K S G C X;W
Z C Q Y K M I X R | C K M Q R X Y I;Z
G U H J V X F I T | G F J H X U I V;T
F C S K U M N R P | S P U R K M N C;F
G W Y P U O D A X | D G W O X A Y P;U
X I R W F B V L J | W L F B I R V J;X
N Q D W V T Z G X | V W X D Z T Q G;N
S L F K X E R Y D | E L F Y R S K D;X
Z P S L X D K H F | Z K P S F X D L;H
E G A J K Y F H L | E L F G Y H K J;A
G V H E Q D A K B | D G A H V Q K B;E
M C D W G B O K F | G W D C M O K F;B
V F I D O A T R J | O V T D A I J F;R
Y M A I R J T K W | Y W I R K A T M;J
V Z D F R Y A G Q | V G D Z A Q Y R;F
Z C Y R D Q G H A | Z A H R Q D Y G;C
Z M K H I F S C L | F I K Z L S M H;C
P Y O K W D M R B | R P K O D B M Y;W
Y Z C T I A H D N | C N A H T I Z Y;D
F R K U A J I E V | K J U V E A F R;I
F B J V E N L U I | I U B J L V E F;N
S D N X Q C A L I | X N A Q L C I D;S
K O W R E B Z G D | E G W K Z R D B;O
R V J Y G C L N O | R V C J L G Y N;O
W A G Z P T S C N | S A Z G T W N P;C
H S F B E K R T X | B R H K T E S X;F
C M O D E Y H T J | C H O J Y E T D;M
X O C D U A T K J | C D O T U A K X;J
G F S D M T L J B | L J B M D T F S;G
M F L X D W H B Y | L H D F W B X Y;M
W P I R A E L K Q | K A Q R L W P I;E
I V C Q T Z X P E | T X I Z Q C V P;E
E T U X B L C F S | U F T C E S L B;X
Z X Q O R E U M I | M U O X Z E I R;Q
B H E N D T M Y R | T M B Y R N H D;E
T Q S D M V I B P | Q V P M D S B I;T
D L V E T Q S N B | V D Q N L B E S;T
Z Y J P B T K C X | C K Z P Y X J B;T
L D F T X G P O H | D L T O H F P G;X
G E C W P D T Y V | T G W P D Y V E;C
Z H O N Y F T A K | H O A Z N F T K;Y
D F C B A L J V H | F D C L B H J A;V
B S M K P R J T O | R P B M O K J S;T
B L T Q M G J A F | G B J T F M Q L;A
D S Y O N H Z C P | P C O H D Y S Z;N
T R Y G B X F L O | R X B T G Y O F;L
G D R H T S N U Y | T H G D R U Y S;N
K R O F N Z I G X | R I G X O N Z K;F
R M T B Z E F V P | T F Z B P E M V;R
U P V C T Q K B R | C R K B T Q P V;U
Y W Q C A K U V F | Y V U K C Q F W;A
W L H K N J Z A Q | K N Z W L H Q J;A
T W S E Q M B C P | S Q E B P T M C;W
C A M N T K J Z Y | A J T Y M C K Z;N
R E N C A O D X J | N O A C J E D X;R
J S N E A C T U G | A T S U G J E C;N
E M N H I Y B J C | M Y B C E N I H;J
J C Z B U K L H V | U Z B H K V L J;C
F Z N U P V G E I | N E Z P I V F U;G
P Z Y F T S W Q A | Q P Z T S F W A;Y
V Q G E D J P M H | D M G P E V J Q;H
N B I R O U A F G | O A F N R B U I;G
I Q P V B C L G O | L P O G B Q I V;C
Q I B N L D R C Z | D R C I Q B N Z;L
C F U O L W G T X | G X W L F C T O;U
Q V F J A D L X U | V D F L X J Q U;A
P D X Q O V A B T | D Q A O V X T B;P
O K X W L R Q Y U | R U X O Q K Y L;W
I H V K U M Q C P | C M I U V K P Q;H
B Q H S U T V Y N | Q B U Y N T H S;V
Z Y D M J I V L T | Z D T Y M I L J;V
O Z S U E W I F K | Z W I U K F O E;S
D J F E C A S O M | M J S A O F D E;C
H V L R O C W T G | T L O V C W G R;H
R Y V P N B A O S | N Y O V A S P R;B
G B A D Q V M C L | B Q C L A M D V;G
I F V N Z L Q E J | I L Q Z J V F N;E
L P S E F T N U B | P B S L E N U F;T
I K J L Q T X D P | P I Q T X D L K;J
Q G N W X K P Z O | X G Z O Q N W K;P
B S C T V N Z P J | T B C N S Z P J;V
H S Y U L N M A Q | M A N U S Y H Q;L
A N O M Q F L E V | L E F O N M Q A;V
K S M C P D Z G R | S K C Z R D M G;P
H A Y K L P R S I | A P Y K R S H L;I
M J F Q E I S B V | V M I J B F Q S;E
I Z N Y E P D U B | P N I U D B Y Z;E
B L T V M J I C K | J K V L I C T B;M
L I J Z H K M B F | H M J B K F I L;Z
M J U E B R Z S O | E J S O Z R U M;B
C M W J E R B N D | R E C N M B D J;W
H E R Q J Z N A B | Z H R Q A N E B;J
N Q R C Z Y S E F | C E F Y Q N R Z;S
V S C Y G O X M L | V Y C G S O L M;X
I L Q J T G B U K | J Q T B I U L K;G
G J M K W P L D U | K D W U P J L M;G
T S M U K A J Y X | J Y X A U T M S;K
I D B G N L Z C X | X Z I L D G N C;B
F G A K Q D W C Y | F W A D K Q Y G;C
S G M F P J Y K A | A F P M K S Y G;J
D R Y W M B E X J | M D J B R W E Y;X
L W A G M B I X Y | G I W Y L A X M;B
K A Y N D M S U Z | K S M D N A Z Y;U
F G Q O Y L W Z E | F W Q O E L G Z;Y
H A G U B L K C Q | L H C B G Q U A;K
M S X E H L J O T | X J E S M O T H;L
M D J G A K Z H F | H Z K J A F G D;M
K Y J F V L W A O | L O A J F K W V;Y
S V Y J I U K M L | Y K I M L S J U;V
R S G Q B Z X N W | X R S Q B G N Z;W
A H N V J K E G U | G N H A J K V E;U
O Z B C W P S Q T | B T Z O C W P Q;S
J U N Y A F D C B | F N D Y C B A J;U
B W R S E O A U I | I E B S R U W A;O
R H Z T C I P Y A | P C R I A Y H T;Z
G X Y O C D H A F | Y H O A D X F C;G
B K O F J M V Q X | V F X M J Q B K;O
Z V W P I K Q F J | F I W P V J Q Z;K
Z I W E T N A Y O | Y A W N I Z T E;O
P S I H W J D C V | S I V C J P W H;D
Y I A F D S O G E | A E G I Y D O S;F
Q H A N L X B R Z | Q L N A B H R X;Z
J V Y O Z T A M I | Z O M I Y J T A;V
U C T X Q I S W J | J C U T Q W X I;S
F Z Y R P Q H W N | Z W N F H Y P R;Q
W Q C X O F D G A | O F A G D C X W;Q
W Z G B E O D K H | B H G O E Z K D;W
F G W A I X V R U | U R A V I W X G;F
U T H L D M W R Y | U W R Y H D L M;T
Q E B O F R W K N | B W Q E R N K O;F
U H D L Q R V C B | D L C H V B Q U;R
U M A R L O P W S | A R W P L U O S;M
Z S K Q R T X W A | A R Q S K X W T;Z
D S V M C X H K L | X L K C M S H D;V
L O C M E Z B K A | E O K Z M B C A;L
G V O Q B X U M R | Q V M G U O B X;R
Q T O L I A G X Y | G Y A O X L I Q;T
Q E D M R L I H C | C R Q H L E I M;D
H V U B F A P N M | F M B P A V U H;N
G D B J W C E M A | D B J G A M W E;C
F V G E R H D C B | H B V C G F E R;D
H A R K B J G S Y | H A S Y K R B G;J
U A D I O H G P L | D A U P G L I O;H
P S O E B N F J K | E F J K S O B N;P
D S U L E Z H T N | H S E N D U L Z;T
T G Z A E X I R F | A Z X T F I R G;E
B M H A Z S Y C L | M Z C A S Y B L;H
R G K Q U L F I N | K N Q R G U L I;F
H B T I X C M R N | H N X R T M C I;B
D V Q E K F W L U | W K D V Q U L F;E
B G E S V X K M I | B I V E M X S K;G
G D J L I P S M Z | G Z D L J P I S;M
A Q C X V R Y E T | X E R A C T Q Y;V
Z V R U Y I F A N | I F N V R U A Y;Z
D Q P R X G B M K | D G P B K Q X R;M
V E A L M T U R G | A V G L M U R E;T
M B F T X K A I D | M K X D B A F I;T
A N T K S L H B Y | H N B Y K T A L;S
J R E K L Y X V F | K Y X E V R F L;J
O Z H T J I K M Y | Z T M Y H K J O;I
H A W Z B V I T E | A W B V H I Z E;T
U L S A D I Y W Z | U A L S Z W I Y;D
E U M X O V S L N | S U N L M V O E;X
G H U O X R I J C | X U J I O H C R;G
N U J A E I W B P | B W N U I J P A;E
U H D E G B Z T Y | G H Y Z B D T U;E
F Y D Z C S W I H | H I Y S Z W C F;D
L M S X T R Q F G | Q G S F T X M R;L
X Y U I S Z B V E | I S U B X E Z Y;V
L R I U E W K M V | L K U V M I R W;E
U J P N L S V D H | S L U V N J P D;H
W C J T L Q N S U | J N W C L T S U;Q
F N Q B K L T U P | L B K T P Q F U;N
X G B Q I Y F K Z | Z B Q X Y F I K;G
B K W Y U J F Q H | Q F U Y K H B J;W
D C F O W E R Z V | V E D W C F Z O;R
T O L V U Q Z C F | O Q L T C F U Z;V
J O W S Y L N B A | S O Y L W J N B;A
D F T G L H X Q M | L F T H Q D X G;M
N U D X L G C R Y | X C Y L U G D N;R
T U M W G F B O J | U B G T F W J M;O
M Y D L N E G P X | D Y P X M L N E;G
R M V N B E U T X | B R T N X V M U;E
S N E R B A I V X | R N E X V S I B;A
W Z T I U B J E Q | W E J U Q Z I T;B
M W K V D X S B F | W M X F S K V D;B
T A I P N Y M C G | A G T C I Y N P;M
Y G N Q R D W V P | G P D W N V R Q;Y
J X S A F K O R I | A K X F R J S I;O
X Q F R D H L O C | F X Q D C O H R;L
Y A C P L I O X V | I L C A O P V X;Y
Q M F X O E D C L | C M D E X Q L O;F
Z R W V F B T K L | K B W T V L F R;Z
H X P U K D S A C | A D U K X P H C;S
S J N U Q D C G T | Q T S N C G U D;J
U I M S D V T O C | C M D T U O V S;I
C S M E U O Q Y G | U Q S E Y G M O;C
A D Z V N K Q B W | Q D Z B W K N V;A
C X R T V W B Q J | Q B J X T W C R;V
X W M E V N S U O | M E X O N S V U;W
R Q W O M H B C F | Q F W R H M C O;B
Z N Y I T J C O A | T A Z C Y O N I;J
B H D N M T I G K | I T G M K B D H;N
M Q S P N A D J B | M D S P J N B A;Q
A W P X D N J G Z | W A Z P N G J X;D
O S V Z B A E I L | V L B E O I A S;Z
F I M Q O P N E R | N M O Q P R F E;I
D S R P Z N K F A | F Z N R A P S D;K
W G C Z P Y T X S | S T Y X W Z C G;P
U L K H O I Y F G | K U I Y L H G F;O
B E L X T P O H G | O T P L X H G E;B
Z B F P D K Q X S | S F Z Q B P D X;K
P G F I Z M R O B | I B G F P O R Z;M
V D X W S R T Y C | Y T V R C X D S;W
P A Z S E Y N J C | E Y J P C A N S;Z
U H Z I K P T S Q | I K H T P Z S U;Q
Y X T J E A W B Q | A B J W Q E T X;Y
E V O G K H I R P | V G K O P H R I;E
H O A U R M J C B | R C O H M A U B;J
H W D Y R C L U B | W R B Y C L H U;D
P Q Y J G W T D C | Q Y P W C J T G;D
W E X D O U F B S | D F X E O B U S;W
V Q B R D N K O E | B K D E O V R N;Q
Z R K Q J H I O M | R O M Z K J Q I;H
H D R P S O C U B | R H O S U C D P;B
Z H C R X L F P M | X R F P H C M L;Z
H P W J F Z R N S | Z J N F S W R H;P
G A I F N E O U T | U T A I G O N F;E
P E G V H T K X A | T E G P X V A K;H
P G B L E U S F Y | U Y G P B E S F;L
B M C Z D E I V W | I B E C Z V W M;D
T Z R C N K G Q U | G C K Z U Q R T;N
W Q D V G Z T C A | G Z Q V W D A T;C
S X E T J D M W Q | S Q M E D X J T;W
J R K V X Z M E W | V X M Z W E K J;R
T D W Y Z A I H V | Z Y A D V H W I;T
H Z T W B M P C Y | P C T W M B Y H;Z
A X Y D T J I G O | X D A I G T Y J;O
S B L D E F Q G M | B S E G L Q M D;F
K U Z D S C I Q F | C F S Z Q U I K;D
T U Y E R J K G P | J Y T G K E P R;U
Z U P T A E R C G | C Z E T R P G A;U
F E T R D L C X B | C R L T E F X D;B
P R I Q M H F U O | H F U O I Q P R;M
R Z N D J M E G T | J E R M T Z G N;D
Y Z E O S G B X N | N B G E Y O S Z;X
H X K V O Y B I G | Y B G X O K I V;H
C X E U G F J Y V | X U C G E V F Y;J
T C E S F J P A H | H J A F S T P C;E
M T L B K F W S G | W S M B L F T K;G
J Q R G I E M K H | G R J I H Q E M;K
P B K L E F O I G | G I K F B O L P;E
B A Y U H Q S D E | S H Q Y A D U E;B
I Y S L F N D O X | L F Y D O I N S;X
N C V R Q U L J K | L C N U K R V J;Q
F B E R J C X G M | E C R X G F M J;B
N P Q F I K X A R | X A F R K P I Q;N
S C M N O U F E V | O C F S U E V M;N
E K I L H M R G C | H I L R C E G M;K
X G E F D B P M A | B A X M G P E F;D
E Z C R O D P H Q | Q Z D P H E O R;C
N M T U J W E X H | T M U W E X N H;J
F A Y O Q W L U S | O Y Q A W L S U;F
T L V P H W Z Q K | H Q Z K P T V L;W
Y W R I E B T J H | I T W B J E R Y;H
C U G V R S Z K W | V K S R Z C G U;W
G P W U V M F Q E | W V G E M F Q P;U
O Y L Q P H E S C | O Y P S L Q E C;H
B S H V T L E K Q | T V B S E H Q K;L
J N P S O Z M H K | M Z N H P S J O;K
H D X J U Y B K M | M U X H Y D K J;B
K T J C V X U Y H | J Y K U X H V T;C
T O Q B Y L U M S | S Y T U O M L Q;B
K F N J Q I X W P | X J P F K I Q W;N
Y S P W L C N H B | P Y L C B N W H;S
U X P D C E Z I A | U D P I A C X E;Z
D S C L W I R X A | W I C S X L R D;A
W C B Z O R H D K | R C O D H B W K;Z
T A B Z S D H G F | B H T F S D Z A;G
M O U J N R A P Z | R Z J O N P U A;M
Z C F N M O A R U | O C Z U A N M F;R
B V G Z D L Y H U | B G H U Y L V D;Z
Q Y Z S C I D M K | S K D Q C Z Y M;I
X N F B S L O E Z | F O L X Z B S E;N
V B A S M D Y R J | R D J V M Y A B;S
K R Z H V O J G I | I R O K Z J V H;G
K F D S U W Q M X | M F U Q D K X S;W
U Y H O Z R L P Q | U P O Z Q Y R H;L
C A D U L M J R S | M A J L D C R U;S
X G H U A M W B O | G H B W O M X A;U
Q N G U P R O Y X | U N Y O P G R X;Q
N D H R E V O S U | D E S N H O V U;R
K T G Z N O H L B | G K T Z O H B L;N
O K V M A E R G N | O A G K V E R M;N
H R F Z E W Q I A | F R E H I W Z A;Q
O J Y B P Z U I A | P U Y Z J B O A;I
F U S T P J O M Z | F U M J Z O T S;P
F S H L P Y A B K | H B P Y L F K A;S
P M I H B F J G C | J B G F C H M I;P
Y O X R W Q E I A | R X E A I Q W O;Y
T S N K H G V Z X | X V H N S G K Z;T
M W H V X Z N S B | N Z S H V W M X;B
K Z T H O N G Y C | Y C T G K H N Z;O
R P L X H B T W Z | L P Z X B R H T;W
S L K I W P X J N | K I S P W J X L;N
J I H F V G S T R | R G S J F T V H;I
U P G L K J Y R W | R U Y P W K G J;L
M G K I H P W F U | H I W P K F U M;G
L D C Z P V U T S | D Z S C P T U L;V
R Q G I Z B H C Y | H G R Z I C Y B;Q
Y W M A R E T F X | R X M A W E F T;Y
G Z S Y N E M T A | M E Y S Z N A G;T
T H I P K J Y O B | B T P K I O J H;Y
U Z T L C I S B J | C B Z J L S I U;T
R J M A P X O B Q | P A R B J M Q O;X
A P Y B S M N C R | A B S R C N Y P;M
K S U V H W B P M | U V P K M B S W;H
I H E S P Z A L B | I H B P S L A E;Z
S U N A E O L F K | U E K O S N L F;A
T W O M H S K R D | S H W R K M O D;T
I T A V E L Y M H | E Y V H L T M A;I
A U E V X H G F N | V N H G U X A E;F
A Q N W C H R V T | Q V R N A C W T;H
D F W K R Z V J C | D J V C K F Z R;W
Q O M I P B E J R | Q B O P I M J R;E
I P V M W K U J D | V U D W M J I P;K
Y V R J Z M D E I | M J I Y R D V Z;E
Q X G T R D O U K | K Q O G U T D R;X
S T A B M N P R K | P K T A S R B N;M
T N P M H X W A G | P G X A W H N M;T
F W Y M B S K H L | B S L F W K Y M;H
Z G N M J V S Y R | R V M N S Z Y G;J
J T Q B Z I S D R | T Z I Q B J S D;R
T K F D E J H N L | E D T J H F K L;N
C P N L J Y G D X | J L N X P Y G D;C
X Y F G J B E I L | L I E J X F Y G;B
F E V C A L Y T R | A V T F E L R Y;C
Z H W E V I U N G | G V U E I Z H N;W
W H A Z P V M N L | M P W N H V L A;Z
I Z C L B J R T P | J P I T B C L R;Z
I V J X P S G M U | P U M G V I X J;S
B D L X O U K H G | G D X O B K H L;U
K S X M J C D U T | M U D C J T S K;X
I H F D G N E Z P | E N Z G F H D P;I
Q P A J M I K Z O | Z J Q I O A K P;M
O B A L Y Q G M K | B K G O A M Y Q;L
E L G U W Y M J K | W L K Y G U M E;J
I Q B T Y C A S F | A F I T B C Q S;Y
D A C X P J E B K | C X K A P E B D;J
R Z L B I F W V K | Z B I V F L K R;W
K Q R O N H Y Z A | O A N Q Y Z K H;R
Z S O R H A J W M | M R H J S A O Z;W
Q S T R B V A W K | W K R V S A Q T;B
M J B Y T K S F R | K S F J M R T B;Y
M F V P X R H C N | F X H P C R N M;V
N K I C T Z E O G | E G Z N I T O K;C
K O P H M T R J E | T J H P O K M R;E
I V T M E C O R L | E L V O M T C R;I
P U V B G Z Y L C | C B L Y G U V P;Z
K O E Z T V R F M | O M V F T K Z E;R
D K W G F U O A P | F W D O G A K U;P
P L M T Q H A B C | B Q L H A M P C;T
Q Y S W L J B Z E | B S E Q L Y J W;Z
I U M A L F O N Q | Q M U N I A F L;O
W N O R Y G E B A | B G W A O N E Y;R
V K F D W T M U R | R U W K D F M V;T
C V H X S A Y Z E | Z C H A E X S V;Y
J S Q N E I H X L | Q E H I J S N X;L
Z Y S M G J E F I | S F I G M J Y Z;E
H K B F Q A S G W | G Q K F W H A S;B
D W K U O V R X T | O K R U V T X W;D
K X R Z A D W F Y | Y K F W D X Z R;A
T G V W C I Y P D | C D P V W G Y I;T
E V Z R J P A L X | J E P L A V X Z;R
O E J X B P A T G | X E A P G B J O;T
I C S U P G Z F E | F G Z C P U I E;S
M N C K D I Y L E | I Y M L D K E N;C
E R L Z B P H I N | R L N I B P H E;Z
Q S V L C R J T D | T S Q V D L C J;R
J O G S U F V E T | F E G U S J T V;O
E H C K L I J R N | C K H E I J R L;N
D N T Z Y M P R A | A N R Y D T M Z;P
P W M I J L C U V | M P U C L J W V;I
W R D E J H P Z X | H Z J X P D R W;E
Y W L S K V P Q U | L U V Q K Y P S;W
R N I Q X P V J A | V X R P N J A Q;I
M X K R V T Z N U | X V K Z N M T R;U
Z F O P U B L W N | W Z N O F B P L;U
C I J W M E S A B | I M W J B A S E;C
P Z K V E Q X U R | E V K X P U Q Z;R
L Q T K J W I G F | K F W J I Q L T;G
L G S Z Y D V F H | F Z G L V S D H;Y
W G I U N H Y L A | A W N G I L Y H;U
I Y O T K C E U S | E I S T O C Y U;K
J B M G V P N F T | P V J T B M G N;F
X C G E D W I P S | W P I D C S X G;E
B P L O D C A Q H | Q A L C B H O P;D
R C A F O G M Q T | T O R A M Q G F;C
E Y X T Q U P N D | Q Y T P N U E X;D
Z M W R T G H I X | Z T W M G H I R;X
I E S U Q M Z H X | E Q Z U H S I X;M
O H U M K V Y Z T | O T M V K Y H Z;U
W E R I H P A C S | E R I C P W H A;S
V B O D A Q W C S | W S A O V D B Q;C
I P O D Q U G T Y | Q O T U G D Y P;I
G A T E I J X H W | X E W T G J H A;I
L A I K X D N F U | K L N I A U X F;D
T G E X L K H B P | H B E L P K X T;G
I F D C K U P A B | C F B P K A U I;D
L J S H Z P Q E Y | Y J P Q S L Z H;E
J Z C I G L Q M S | M L J C Q G I Z;S
G M K F C P Y A U | F C U K P M A Y;G
A J L H C Y G D I | I Y G L J H D C;A
H U B R Q C F I N | N H F C U I Q R;B
D N G K V M C S R | C D R V M K N G;S
D G W H B U F L O | L O D U F G B H;W
U H O L G N B I A | B N I U H A G L;O
K N A C U T X H R | T U H N K R X A;C
J A K Q W P Y G T | W Y P J A Q T G;K
E I L M S B D K F | B I L S E K M F;D
M H Q X B N U S P | M B H N P U Q S;X
E Z A Q V X J F N | E J N X F Z V Q;A
E O H L T G Y A V | L O G T H E A Y;V
T R N I C G W S V | S I G T N R C V;W
Y O J U A Z K D N | D N Z J Y A O K;U
F Y U B L I J K Q | F K I Q U L J Y;B
I X M V L A N S R | R M X I S L N V;A
U Q R W Y N M O D | M U R D Q Y N W;O
P O D W M E B Z I | Z W O P D B M I;E
V C R I N P W G H | I G C N V W R H;P
A Q J E W I S U T | Q J A U W S T I;E
E A G T K N X S M | S X N G T E A K;M
T H E U F Q G I N | Q I F H U G N E;T
E S J X Z K I W L | S X E L K I Z W;J
N J H T B U C K O | O J U C K T B N;H
A S W L O F X I J | A O S J F I X L;W
B G C A Y W E I X | B X C E I W Y G;A
T P G X V O D Z F | O V G F X D T Z;P
Y A E Z M D X L O | D Y X O E Z A M;L
Y G F X N K P D L | L X G F K D N P;Y
E R M J Q N D X C | N D C Q E R M X;J
B T G J N X H R W | G B X H R J T N;W
E C N H F D A M B | N E D A H B F C;M
V U C H D L W B E | B H D V E U C L;W
W J D V M Y L I R | L Y J D V I W M;R
S Z E A U F L X Q | E X A S F Q U Z;L
X C U T Y Q S B N | X Q Y N T U B C;S
N M O Y P C H E B | H P N E Y O M C;B
P O A C V N J H W | O P J C H W A N;V
Q O C I W T R X J | C R I Q O X T W;J
Q I E X J D C U F | I E U J X Q F D;C
Y T W S E Z R C J | C E J T Z S W Y;R
T J N F R K X U P | K T N F U P J X;R
H R X B Q M O W D | M Q O B D R X W;H
M H L O P J B C W | O J W P B C M H;L
T R I K P Q W Y Z | R T I Q Z P Y K;W
R X I O G V N L T | T X G N R V I L;O
A F P W Z V U M T | T W A U F P Z V;M
M P D J Y O W B E | E J D Y P B W O;M
V X H K L F E Y G | K X V E Y G F L;H
D A X G W J H Z R | D W G J X H A R;Z
W P J E L N R X Q | N Q R E X P L J;W
W L Q X M U N B C | X M L W B U Q N;C
R B F X L Y T G E | F Y X R B E G L;T
E W C M A S F N L | N E A C L S M F;W
W J Y V E M R K S | E M J Y K S V R;W
N X P J H B Q I L | I J H B P X N Q;L
Z Q R I A B H L K | L H I R Q B K A;Z
J H P S B F D U I | P D I S H F U B;J
A K U T Y Z E F I | K Z E F T A U Y;I
T S Q J N B Y U C | U Y B T S N Q J;C
X F D K H N I Q P | F K N I X Q D H;P
F U V N T O W K I | O N U V W F I T;K
Z U H E I Y M L B | Y B I M L U E H;Z
J L S E F A O N M | L N E M J A O S;F
V X T B F K P L U | B X T F K U L P;V
R U H J Q N D O C | U Q O J D R C H;N
I N V C Z S X Q O | V Q I N C O S Z;X
A G S Z N W T X O | W A O T X N S Z;G
L D C B H V M J T | J M V D T C B H;L
S B R N X Y P M U | N X B M S P R U;Y
G V K Q Y T E P L | P L Q T G E K Y;V
L P T Z V W J O N | N O V T P J Z L;W
Y M D K Z W U R F | M W D R K F Z Y;U
J G E M V R N B K | R E M G N K V B;J
N X U V L M G Q I | M U G Q V X L N;I
M G T Z L F U B A | T B M F U A Z G;L
T K A Q S R B O E | S T R E Q B A K;O
P A U S H Z F I D | P D H I S A F U;Z
K I C D F N X S M | X D F N S C K M;I
J I L V O Y R Q T | L T O J Q Y R I;V
P G R F T D W N X | W X T P R D G F;N
E W G X R T S Z J | Z R E W S T X G;J
D F Z P X M G O T | M Z G T F X D O;P
T J Q Z O U G P S | Z S T Q G U J P;O
C Y O F D T A K I | C F Y I D A O K;T
V D Y T W M K U L | V L M D T Y K U;W
Z G F P E R K O U | G F P Z U E O R;K
N A C R T Y S V M | R A V C Y T S M;N
B K U J V T P X F | F T K X J P B U;V
S O V W J G U B K | B W K U S J V O;G
X W J O Z T L Q A | T W X A Q L Z J;O
D A G E Y W F V X | X V W Y G A F E;D
U T D W C P O X B | T C U W P D O B;X
D G R N S Y E L O | S N Y E G R D L;O
Q X O D K B G H F | F K D H B X O Q;G
E U C N M X Z V S | U V S X E Z N C;M
F Z K W D R P I U | D I W K F R Z P;U
R I Z Q L A J U H | A J Z R U I H Q;L
I B F M A U D W S | W B F D M I A S;U
I U E T R S Y O F | U I F R T S O Y;E
P S U K T A B V O | U O V A T B P S;K
Z A C R L E F O J | Z R F O L J A E;C
F S B J Y D M K N | F M K N B Y J S;D
Q F B M P C W L V | C Q M W F B L V;P
P M Y T N A Z Q W | Y W Z T Q A N P;M
Y S K T R C L B J | J S Y B T L R K;C
A H M V L Z S O U | L O V Z U H A M;S
N K M U W G R Z L | M U N L R Z K W;G
U O I A Y F J L S | A O S I L J U Y;F
A G X R V I W E M | X R I E A G V M;W
T H C E I S R X A | H X R I C T E A;S
C E X B I G N F Y | F C Y N B I E G;X
B W N S A X L M E | L S M E A W X N;B
H M S Y A J V N G | A Y V J H S M G;N
X F M G I H J P O | O J M X G H P I;F
Q R C T O V Y D S | C Q D T Y S V O;R
I K F B Q M D J Y | Y M I K B D J F;Q
I W P L V C S R M | C R I S P V M W;L
O L A K N U R I M | A K I M L U O R;N
O H D M B U E A Y | D M O E H U B A;Y
F Z W R E J M U O | U W F R E J O M;Z
Q D I S B P W Y H | B W S P H Y D Q;I
Z T G M F H S N W | F H N M W T Z G;S
Z V P W J A I E S | Z V S P W A J E;I
C Q A M I Y Z J H | A C Z I Q M J Y;H
E X G O Y I U B S | Y E I O X U G S;B
A X V H W E Q Y B | E B V Y A X H Q;W
Y D I V H C S P W | I H D V W C S P;Y
Q L N K M Z H W J | Z L H J N K M Q;W
O J M F X D K Z W | Z O K J D F W X;M
X I M J Y F R E N | E F M X I N Y R;J
U P W L F J N R Y | W Y R F U P N J;L
F A C K Z L W D H | W A Z L C F K H;D
L J V S B M H D E | E D S L B H V J;M
W H Q V J S C A I | I J W V Q C A H;S
W U K D O A Q N L | L Q D W O A U N;K
I D M V J T H C Z | Z C V J H I D T;M
V Z E X K N O J Q | O N V E K X Z Q;J
W L C O A T Z E B | Z C A T E L B O;W
P Q L B R H G A S | B G Q L A R P S;H
F Z D M L K S V O | O V S L Z K D F;M
L B P J M E W U Z | M J B W L P E U;Z
H P G A K F V U J | G A K H J P F V;U
B H I V P W D M X | X M W I V D B P;H
I J C G U M Z E V | G J E C V M U Z;I
P I Q O H A S F G | Q I O F G P S A;H
X L T Q E M K D B | B M X D Q L E T;K
F Z I Q C E O H G | E G F Z Q C I O;H
F U W Z E S H P M | M P E U Z H W S;F
H U X B C K I T D | B K H U T I X C;D
H L Q D C V B S X | C X Q S V L B D;H
P X I Q A C R E U | U R X I Q C P A;E
Y W A C P J K B V | P B C Y K V J W;A
D O B J C K V G T | T K J D G C V B;O
U D Z L Y M A K W | Y U W D K Z M A;L
A W U P V C Z S O | W A V P Z O U S;C
W F V P S Q G L D | P V G W L S Q D;F
Z R H D X L M N E | L Z D N R E X H;M
G U T X F N H C Y | Y X H F G U C T;N
M E W F P J U T O | P W E M F J T U;O
B R V O E Y C P L | O P Y B C V L R;E
K M W J T B G Y P | W K G P T Y J M;B
D Z C Q Y F V L T | C Q L V Z F T D;Y
C I S M G E W A J | I G E C A S M W;J
F E H Z T B V D U | D H F T B E Z V;U
G X W C L D F V Z | D L C G X F W V;Z
Y N S W X T B Z E | S T Z N B X Y E;W
G B D L W V F T A | T D B F L A G V;W
Z E T U A V Q O W | E W O V T A Z U;Q
S R V B Y Z W P D | V Z B D P S R Y;W
X S D L F G I N Y | F G D N X S I Y;L
E P Q W Y R S T F | F T S P E W Y Q;R
V R E K B M W Z G | V B R W E Z K G;M
C Z O T S E M F P | E P Z C O T S M;F
B U J F T O W I R | U B T I O J W R;F
L N T H K U B D E | L E K H N U B D;T
J X A T L D Q N E | L D A T J N Q X;E
M L Q H V P B Y F | F H V Y Q P B M;L
C U T J P B I S G | C S U I G T B P;J
S L R Z C W M G Y | R Z M W L C S Y;G
W O D R N K J L U | L D N O R U K J;W
L O H J P G Z Y N | O G Z Y H N P L;J
C B J Z R Q N V L | C Z Q V N L B R;J
I X W B P J N C V | V N W P I J C X;B
P S X N U K V C I | V S I U N C K X;P
J C P X U T A Z D | D Z U C P X T A;J
V M S H Q P Z O A | Q Z H V M A P S;O
S R W Q A P L K J | R S A Q L W K J;P
H X A I L P V Z S | L H P I X S V A;Z
S O P N J A G I K | P S O G J I A N;K
K U Y Z S P L Q O | S Z U L P O Y Q;K
J U Z T A H K S E | Z A S U E K J T;H
M D J T Q X Y O R | X T R J Y D O Q;M
G U K S X Y I D F | G Y X U D I S K;F
S V L E P X O Q T | S Q V T O P E L;X
T F M X G I Y C H | Y G X F H T M I;C
J T C K P F S M B | B J M F T C S K;P
B M F T L G K Z D | Z M F G T L D K;B
N Y E T F H C W X | W T C N H Y F E;X
F B K C W U M O H | F M H W C U K O;B
U G K O V N J F Q | G J Q V K F U O;N
W E R B J X L K V | V X E K R J W B;L
T N S H C A G K I | I H C K T G A N;S
H Q A K T Z R S B | B T K R H Z S Q;A
E D S L U M W V Z | V D L M S Z E U;W
E P M B T Z C U S | E C T Z U S M B;P
N Q L Y Z V W R P | R Q V P W L N Z;Y
Q V Z K D L A R I | I A R V D Q Z K;L
G Q O M I V X U L | G O M V L I Q U;X
S A W V C D J F R | D F W A C S R V;J
L V N D O J Y A M | L Y D M A J O N;V
W U K P R F X Y C | C K F U X P R Y;W
J N S R V D G E Q | N V S Q J E G D;R
F A N D M C W U O | A F D M N U C O;W
G F I W A Y X B J | X A G B J F I W;Y
Y N T L E K R F V | F R T L Y K N E;V
J L F V S Z W G U | G S J L W V F U;Z
T C V Y X J A K L | V J A C L X Y K;T
X J D M H N V I Z | H N I Z M V X J;D
O H U V W Y S C K | Y U C K H V W S;O
A F I P B S V X G | G B S F A V P I;X
E B Y G M A J D Z | B Y M D A E Z G;J
P K B O W F I M U | U M I F O P K B;W
E T U K W X G Q R | R E T K G Q W U;X
G C Z E D S X M B | Z C B S X E M D;G
M Z N Q I G S H P | I S Z H N P G Q;M
E N W R Z H A X V | R V N E W Z X A;H
C I W D H L U P J | L C H P W D J I;U
Z X Y L D G E F K | G K F Y Z X E D;L
B J X Z U O E L R | X O B Z L R E U;J
L Z E S F G M Q T | Q L T Z F S E G;M
O N H P G Y I U R | H Y P R N G U I;O
Y T P W Z I K F Q | Z P K Q I T F Y;W
W L Z D T R G H O | G O Z T R D W H;L
B D W G O U N M I | G U D O W M B N;I
O Z W S F G L B P | W B O L P G Z S;F
M H A J X D E N R | N H M E R X J A;D
U L V W F R J Y B | Y V W U R L F J;B
D T M C E F Y B A | T B E M D F Y C;A
C B Y M H G T P D | D B C T Y M G P;H
C H V W E G T P Z | G P Z C H V W E;T
Z S P B F V O E L | F P O S B L E Z;V
I V S L Y R X K T | S K T Y V I L X;R
Z E V S D G U P W | V U S E P G Z W;D
J D B R I Y U L V | D J R I U L V B;Y
T N U L V H E D Y | T E D U H Y N V;L
I C A N J P S M U | S J I A C M N P;U
D O E I Q F J N S | F E D J O S Q N;I
Y W T N I J K E R | E J K Y N T R W;I
Q C B Z D J L S U | L C D Z S U B J;Q
T U K W G R L M S | S K T G U R W M;L
B D N C K Z J Q F | K J B Q C F Z N;D
W F S M Q O R K X | O R X K F S W Q;M
R W G C D O A I F | A W F G C O I R;D
N Q G H A Z D Y T | Y N Q H A G D Z;T
G D W R F U B T Z | U T D R W G F Z;B
G M O A V N W T L | W G N V O L T A;M
H Z G U J D L P N | U L Z N H D G P;J
A U M B G E I L P | U I B A G E M L;P
S I N V G A Q O P | G S V A Q O I P;N
V G L R K B E M F | E B F G V R M K;L
T X U V S D N Z Y | X D T N Z Y U V;S
H X V A O Z I R T | T X H I O A Z V;R
F W Q T H J P Y I | W T P F I H Q Y;J
O P K Y T F A Q I | A F K T P Y I Q;O
S G L M K C U H A | S U A H K G L C;M
S L B C N T F Z X | B X L Z C T F N;S
R O N H J K Q I Y | N J Q O Y R K H;I
Y A D N X V U W Q | N D X U Y A Q W;V
R H T Q D K B W V | R Q B W K H D V;T
R T O Y V K C F J | F J C R T O V Y;K
I U F J T R E Y Z | Z U F R T I E Y;J
J H C W D R O Y Z | J Y C W Z D H R;O
O R B P F T N I X | T F R B O X N I;P
Q L K E M Z T S I | L E Z K Q T M S;I
B F R C D X E V G | F V E B C G D X;R
J S T G O K Z P A | J K Z S G A P T;O
R B H F V Z A S I | R Z H I B S V A;F
K G F S W E I D Q | Q G E D S I F K;W
E B G V N L K J P | E B K L P G V J;N
P W J R X S H F Z | F S Z J P R H W;X
X M U K A Y Q L B | A M U Q K Y B L;X
D G A W O C I P E | D I W A P G E O;C
P M A N L W H Z F | P A L M F N W Z;H
D V U K T G C Z X | K V X T G Z U D;C
D A I L Z P V X C | L X P I D V A C;Z
P L M H C Q J W Y | Y H J Q W C M P;L
P K V F J U N X Q | U Q P V X K N F;J
O X R Z U Q N T I | U O X N I T Q Z;R
O J K B M U C I V | O I C V B M K J;U
K H Q X A T F L B | T L K F A X Q H;B
C I T Y Z W G J F | F I Y J G T C W;Z
R Q B T G A V L H | L V A G R B H T;Q
B D V M R C O P Q | C Q R O M P D B;V
Z S X A R O N E M | X O A S R M N E;Z
P C L Q A S X N M | A L N Q S M C P;X
I E S C Z X K W A | C K X A Z S W I;E
M S H N X B O P F | F B M N H S O X;P
L H G T Y K A R E | E G Y H A K R L;T
M V J U P L Q A S | P M Q S L A U J;V
S I D Z Y V U B H | B S Y Z H I D V;U
J Q A F N I M U R | M F J I R N A U;Q
Z L O N C U T V W | O C V W L Z N U;T
N U Q G Z I Y W P | N Q U Y G W Z P;I
E X Q O W N U R V | O V E W Q N R U;X
R Q J S W K Z I N | J Z I N S W R K;Q
Q X N G I H U V B | U N I X H B V G;Q
T Y S U R A L O V | L A U T O S R V;Y
R F E X I H D S P | F E I R X D S P;H
D Q M J I S V L G | D Q J L G V S M;I
H R I B U A X M G | G M H U B X A I;R
W V B C G E Z T R | G T B V E Z C R;W
L W T K G R A Q I | I R K A Q G L W;T
Z S H Q X D P N O | O Z N Q S X H D;P
M J T A S Q P Z C | T P S C J A Q M;Z
X S N Y T M B E C | Y M C X T S E N;B
S O Q T X J B D Z | Q T O B X S Z J;D
X G S H Q U K E J | E J G X K H U S;Q
L H T U E G X Z C | C U L X Z G H T;E
C Q L F O K T B H | H Q T B C L K O;F
C R L I Y O Z G Q | O I Z C R L G Q;Y
V M T G L P N J B | B G T P M J N V;L
U N R M Z O K T J | M Z R K O T J N;U
N W I C O L Z U B | B L Z O I W U C;N
E Q R P K D Z I C | I R Q K Z E C P;D
A H Q J E G Y W O | Y J E H W Q A O;G
W J E N X F Y V S | Y J X S N W V F;E
O H Z C A R W X S | A S R X H Z W O;C
J S B T U G A D W | B A S G W U D T;J
V C S M F W J Q N | C S W J N M F Q;V
C P Z R X O V J D | P X Z D C J V R;O
U G Y B D R H I K | D R G Y I K U B;H
B L A X E Y S J O | J A Y X O L E S;B
J K C Z H P F W L | W C K F P Z L H;J
V E Q L S T H X R | R Q L S T E H V;X
F D G K Q X H O U | O D K G F Q X U;H
S Q H A J W F O B | J Q B H A W O F;S
F Q O I Z M P B C | O M I Q Z C B P;F
E A M Y H W R U L | E U M W R Y H L;A
L C H Z V I S X Q | H Z S C I L X V;Q
B S F P X T I G W | G S F P T B I W;X
Q D F O X W G H P | W H G X P D F Q;O
T N O H R Z Q E G | Q T R G N E H Z;O
C J Q P B E A S O | O S Q B P E C A;J
I K V R Q P G C J | C I V R Q K P J;G
S F X M A U D Y O | O X A D M U F S;Y
S O Z N D K A M Y | Z N M K D A Y S;O
C B O Q P N M U H | B O U H P N M Q;C
A Y B K D F P M C | A B Y D C K F P;M
L W K D R S G T J | T L G D J K R W;S
F C V X T D L G Q | T F C D Q V L G;X
H U I B L W D G M | D W B H I G U L;M
Q C N V U Z R H O | N Z Q H C U O V;R
R P J N V F Z D L | J D R L P N F Z;V
R A C N E F P L I | R C A N I L F P;E
I M W Q S P D U Y | S W U P D Q M I;Y
R S Z J V Y G U T | G T Z J S V U Y;R
U B S G Y J V R H | H B J V R U S G;Y
Y P E Q B F D A N | B D A F Y E P N;Q
C P B D V O I G N | D C G P B V N O;I
Z G O N X V E F Y | O G F X V N Y Z;E
W I E V S P T C N | S N V C P W I T;E
C X T H E Z I V B | I C B Z T H E X;V
J S N G M F Q L C | J N G S F Q C L;M
P C W V O M I Z N | N C O V I M W P;Z
F H G U S Z V C R | U R Z H C S F G;V
Z G R N S L K X V | V Z S X N L G K;R
O E N H X L T S U | O E U X S N H L;T
W T D R S P L M H | R W D M P H L S;T
S N Q R D W T K X | K W N X Q D T S;R
X C L K Y N P H M | L H X M P N C Y;K
T N O W B R J F G | J F W T B G N R;O
Z E G P W R Q L N | Z W Q G R N P L;E
M B N W Z U V G H | M V G U Z B N W;H
C L M E H G Y B W | E Y B H G W C M;L
C P I O Q J E R K | R P E I Q J K C;O
Q U E B X J H O L | U Q L O J B H E;X
X F T M W Y B H U | M X U B T W Y H;F
R U Q V D F G S T | F T R D S U G Q;V
X H S M Q W V T D | H V D M W T Q S;X
T A D X K U F B Y | Y U A K T X F B;D
W Q X R A V M C D | M A R D V W C Q;X
D R T H S Q G U F | G D R T H Q U F;S
W S U E V D R C F | V F S W C U E R;D
W J C P X H Q G F | J Q H F W G C P;X
N O L G B T J E X | O N T E L B X J;G
Z N O E W V F I Q | Q O N Z F W E I;V
U V B M T W F O L | V W U O F T M B;L
R N U H I A G X Q | X Q U H R G I N;A
X Q H Z B P N G E | G Q P N E X H Z;B
J Y X I Q C K U N | Y I U N J C Q X;K
R M B I G O Q Y Z | Q G Y R I M O Z;B
G V B Y J M A R C | M C A V R Y J G;B
E I N L M Z F O Q | M E F N L Z O I;Q
R P U T L M I J E | P R U L E T I M;J
T F H N W Y R Q V | F T N V Q R Y H;W
S E Z B U D H K I | I E K D B S Z U;H
D F Z C V L M K R | R F C K D Z V M;L
I N S Y D G V E K | E S G K V N I D;Y
I T B S V W Z E J | S E V W B J T Z;I
Q G V E D L I U W | I D G E L Q V W;U
Q X T H P O W D L | X W H P Q L D T;O
I J S L M O B A C | I C S J B O L A;M
Z K Q B E F S U T | Q F E T K U S Z;B
C G R F Z Y S A K | Y F G A C R K S;Z
H E W M U J Q K Z | E H W J M K Q U;Z
Q B X J F M P C T | B C M T F J X Q;P
X S B A F H G V J | G B A H X V F S;J
N F S J T R O A W | O S A W F R N T;J
A N O W U L R J I | O J W U N L I A;R
H P N T E Y Q V B | E H T P Y V N B;Q
G I X U N M A J Y | I A M N Y U G X;J
Q L T M Z A W S C | Z M T S W A C Q;L
U E A O H W S Y Q | S Y W Q H A O U;E
J A R E Z Y F L G | F J L Z A G R E;Y
O H V F Q W Z S J | J S Q Z F O V H;W
Z D V C I M E N O | E D C V I Z O N;M
D W L O S H Y X K | S L Y K D X H O;W
R L C Z M G X P B | Z G M X B P C R;L
A Z U K G J I H C | Z A K H J I U C;G
V G O C W F B R H | R H V O C G B F;W
D G X N M L A S Q | S A M G D N X Q;L
B Q E G C X Y U Z | C X G B Z Y E Q;U
R N D Q Z O B F K | Z B D Q F K O R;N
S V R H G D U Y T | G S U R V D H Y;T
G Y Q O C L D A S | A D Q G O C L Y;S
K Y M B H Q P G T | T B K P G M H Q;Y
R Z N Y H W M G C | Z C N M W G R Y;H
T F H I J U Z N K | J N Z U H I F K;T
E H Q B W N A G Z | H E Z G B A N Q;W
Z G X L U J F M O | M O L G J X F Z;U
E R B S Z C V J N | E N J Z S C R B;V
G S P D R I A X B | G R P X I S A D;B
N D Y T Q B A W R | Y N T A W Q B R;D
U O C D F S K P M | M K D F U C P S;O
Y A K Q M N R H Z | R K H A Y Q M Z;N
N O S I Y P V J D | O D N V J S I P;Y
F Q J T E V K O M | J K V T Q F E O;M
W Q M R J V D A Z | A D V W J Q Z M;R
E V N U K A G C J | G N U A C K E J;V
W Q J S K D R H Z | Q W R D S H J Z;K
B P J O S F G Y A | P B F G J A Y O;S
I G U J E A V Q M | U E M V G A I Q;J
U W Q F Y T I L C | F T W Y L U I Q;C
Q J W R M U T F Y | M T W Q U R F J;Y
L W Q H D O C T V | L W D O C V Q T;H
I K U T A R E Z F | U T E I A K F Z;R
I G K F C U A X Y | Y K C G U I F A;X
G X J P U Y R M F | M G J R Y F X P;U
X Q V S H M G J C | J Q H X C G M S;V
X W G L V M I P J | V I M P W G L J;X
H Q L D A S E C B | Q D L H A E S C;B
W Z V X B J P U D | X J D V W P B Z;U
E J H B V Q O L T | Q J B T H O V L;E
E T B P L K H N D | B P L N K D E T;H
G W Q Y O U K R C | G K W O Y C R U;Q
U Z X J W Y D G C | G X Z J Y W C D;U
Q K I S B G V X H | H S I V K X G B;Q
F Z K B P M H U C | K P H M F U C B;Z
E X S N L T O M U | M L S T N U O X;E
O T E Q X V S L C | O S V X E C L Q;T
T J M K W B R G X | J W G X B R T M;K
L N X I P O A Z U | A O I X U N Z L;P
U N T V W Z F P A | N U F V W P Z A;T
I C J V G U B E W | I C U V B J G E;W
M F W G B Y E J X | B X Y E J M W G;F
P L V R N I A B Y | V N R L P B A I;Y
P I H E V M R K N | K N M R E V P I;H
W S V E H A J X Z | A H S W Z V E X;J
L E M T G Q W P B | P M B T E L Q G;W
E W F Z Y C T I L | T F W Z E I L C;Y
P T Y O Q L B D H | O D P B H Q Y T;L
G J O Q X S C H Y | C J Y H G O Q X;S
O W J D R Y T C A | J Y W C A O T R;D
M L Q G T P F K I | T K M I P F L G;Q
V R L Z H B K G I | K Z H B I G L V;R
E B Q C M S A F G | B Q G M A C F E;S
O B M H F C D V R | H D B O R C V F;M
C X Z I T G N E V | N I E T C X Z V;G
Z T P U R E W I X | W R U P I Z X T;E
A T X J Y L G R Z | Y J X G T Z R L;A
Z X J F R M V W E | E M Z V J X R W;F
Y R S Q W T J X L | Q R L X T S W Y;J
L S X A M Q H T D | M Q A D H L S T;X
P O B E U K Y Z S | B S Z K Y O P U;E
S P K X B E Y Z L | K Z Y L S X B P;E
I A B S X P N R W | B A P S N R I W;X
V R E I Z G C Y F | F G Z R E Y I V;C
R J Q F E G U I H | I E R H F G Q J;U
J Z N T Y B K H P | Z Y P J N T B H;K
S M H T E A U P C | A C M P H U E T;S
X Q D Y W K Z A B | W K Q A D X Y B;Z
H K G Q N S O T W | N W S Q H K T O;G
C W U T Z X R V I | V U C T X I W R;Z
K S B H X Z F Y D | Y F Z H S B K D;X
Y E H S A T V R W | Y V W S H R E A;T
Q P M U N A W R H | R N W H Q U P M;A
S K E A O N J P H | E P A J H S O K;N
I P F T X Y C S D | T P X I Y S C F;D
G R Y A C X Z V D | Z C V R G Y A X;D
J R Y Z B N L K I | J L K N R I B Y;Z
V J H F K B G C P | C K F G V J P B;H
F D L B S K Y P A | L F D K S B A Y;P
K P T R H A B Q I | T B R I H P Q A;K
B Z C J M N A E D | D C Z M A J N B;E
O W L U A Z Q G R | O Z W G R Q U L;A
S I U X B M K L P | I X S B M L P K;U
K J B P V L R G O | P O V L B J K G;R
C M A E R B F K G | B A F K R C M G;E
A K S E N T Y F M | T M Y E F K A S;N
U W A F Q B H X I | Q U F I B A H W;X
N D O P V Y R T B | O Y B R D V N P;T
A K X Q U T V G P | K U V X A G T Q;P
K R F D X H W I S | X S D R W H I K;F
X H F C R G P I L | P X C H I G F R;L
H C L U Y P I A J | U J P C L Y I A;H
M I O Y R U F K A | M K Y A O F I U;R
I Y N F S Q B O X | I S Q B O X Y N;F
K T D Z Y A O H I | I T K D Y H Z O;A
H X N F P B C W O | X N H P W F O C;B
C B Q Y O F R V N | N C F O V B Q Y;R
D V K P O C Z S N | Z P N O V S K C;D
T B J E S F Q I O | F B E O S T I Q;J
C L E P A R T F Y | A L Y C E T F R;P
B A S C M X N V K | N S M V A B X K;C
S L U C Y X Z Q B | B S Y L C U X Z;Q
C U I H J Z O M Y | Z C U J Y M H I;O
S D Y H Z M X K L | Z H S D Y X K L;M
F B U L H G A C V | L F A V C G H B;U
H S C P A O M J R | P R J S O A H C;M
V O D M R K I J A | D A J R M V I K;O
T V L U O M Y H B | T O B U H Y M L;V
B D P A M Q U Y N | Y N U A Q P B M;D
U C X J E Z P Q Y | U P Y X C Z Q E;J
E X D J W Q T I O | W J O E X D Q I;T
I Q L H Z X N O Y | N I X L O Z H Q;Y
P B E H L I V Z W | B W V H I E L Z;P
G J K E Z Y Q R O | E Q O Z Y R G J;K
R X H K G E D Y J | K Y G R D E J X;H
Q E U Z J Y N L F | U E Q L J N Z Y;F
Z F U L P V D G E | U L Z F P E D G;V
S B E M A U H Y V | U H Y A E M B V;S
Q Z T E M X N D P | Z E N X D M P T;Q
X D Q E C Y I J G | G I J Y D X E C;Q
J M V Q W Z C I A | W A Z Q J M V I;C
B V N F P O L J T | T L F B J O N V;P
O V L K F G C A Z | A K G C O F Z V;L
W I S H E P D M C | C I M S E D P W;H
V I G T O P J Y Z | V O J Y Z G T P;I
G I D P Z N W R Y | D Z I N G W R P;Y
A I W Q K R M C X | R X Q W A I M C;K
U A M H N W V L Z | Z N U A M V W L;H
V G K T B X E C U | V X C G E B T K;U
C D S L P W B Q U | B L C W Q D U S;P
V R O A H N G E Z | G V Z O E R H A;N
U B I R G A K F P | I A G P R U K F;B
W D V S B E M I N | W S I V D B M N;E
G M K E F B C O N | M K E C G O F N;B
S M O D H Z U W B | U S B D H W Z O;M
L S W Z J N X Y D | Z S J Y N D X W;L
Z L R G E F J X I | L E I G X F Z R;J
Z K O U P B Q J H | B O K Q Z H P J;U
L F Z T K M S A E | T L A E Z K F S;M
C F Z V T X U S I | V C Z U F X S T;I
H Q B J W Y S U C | B U C J Q S Y H;W
X H D I J Q V U O | D U V H O Q I J;X
O F X Q H K R T A | O K T F X R H Q;A
Q F H E A B S V K | E Q V H F K A S;B
H Y N G L E M F V | G Y N V L M H F;E
U O G H S C V A K | S A C H U G O V;K
A V B G C D L P E | C L D P G E A B;V
U K V X E W M P T | U W P M E X T K;V
W K F B X J L C G | J C L K W B X G;F
E R I S L B W Q A | W I E Q L S A R;B
Z M N D F C S B J | Z N S J M C D B;F
K Q S V Z O J R H | K R Z J S H O V;Q
T X W E J S Z L G | J E G L X Z W T;S
A G C K D Y H O B | D A Y H O B G K;C
I V W M X P K C N | K N M V P X W C;I
B T V J E W L X P | V W P J L X B T;E
V O Y M S L C A F | C L V S M A F Y;O
Z P Y T F M X L U | X U P F L M Y Z;T
F L A T K W D E Y | F E W L T Y K A;D
Q Z Y C A G M J I | Q M I J Z C A G;Y
N O D L I R K B T | T N D K B O R L;I
X W Z N S Q I C B | W X C S B N I Q;Z
D J U B P H S Z X | S J D Z X H B P;U
N H G P M C V O X | H M N O P C G X;V
G X V D R T O C Z | C Z V O T D G X;R
I P K Y W L X S G | S L W K P I G X;Y
A X T U D M V S G | U D A V G T X S;M
W P O I X S Y D A | X W Y O D A S P;I
B T S P W O F C K | K B W T C O F S;P
R H W E J K S A D | K E J W S H R D;A
A B F C D X Q N G | X B F G Q C A D;N
Y F T U X D S M J | X F U Y J T M D;S
Q M E Z P R N T C | P C R N E M T Z;Q
Q P C H K N Z D T | K C H Z N T D P;Q
I M Y A N P V L Q | M Q A L I P V N;Y
Y X S D H N Z F R | F Y X S D H N R;Z
U Y B K H Z E X R | B H Z K X E R U;Y
J B O Y R C E P T | B R T P C Y J O;E
K W U V S Z B Q Y | Q U W B Z Y S K;V
N W J U V P E T A | T J V U P W N A;E
Y W D O N V T H M | D V T M Y H W N;O
R N J L F P S M W | F P J S R M N L;W
F R Y K J P I H X | X H K F J I R Y;P
N K I M F X R J T | T K M I N X R F;J
M Z G F R H E Y N | E Z Y N F R H M;G
C D A Y U R O Z E | Z D A R O C Y E;U
H I U A K Q J N B | N A Q B K U H J;I
U R Z H K X Y O B | R Z O Y X K B H;U
Y Q J N D G V I C | G C Y I Q D N J;V
L H D I F O G B U | H G F I U O B L;D
B A I W C O N S H | N W S B H C O A;I
O J V R Y T P K E | R E Y P V K O J;T
R P K U V F D T S | P D K V T S F R;U
N P Q V R U I D E | V P N I D E U Q;R
T P W Z F R M I J | M R T W I P J Z;F
A V L D M Q G N C | Q G C N D V A M;L
U X Z S T B K M W | X B T Z K U M S;W
A V C M G J Z D W | J V A C M G W D;Z
Q T G W K C X B F | B C W T Q K F X;G
P H B F D U R S X | S X R F U H P B;D
S E V U F B Q N C | V E U Q N F B C;S
P M J D O F U Z C | M Z U J D C P O;F
N W J O H S R U C | U R O W C J S N;H
Q L K Z A C Y O X | A O C L K Z Q Y;X
E M I N L U P O A | A I M U P E N O;L
P I R K E H T Q A | I T Q K P H A R;E
A P J Q R W D S O | D W S A R P O Q;J
L S T U Q I B W H | U T W H Q I L S;B
A R Q P B C K D J | P K C R Q J A D;B
C O N K G I Z S P | N S K C O P Z G;I
S M C Q R J E A I | Q E I C S R A J;M
O Y I P H Z N M G | H N Y Z O G P I;M
V S O N W E L R A | E W A N L S V R;O
A W U E V X T M H | V A W T U M X E;H
F K N C T G E I R | N F K T R I E C;G
N A X C F O R G B | R C N X A F B G;O
I J G E D R A Y U | J Y A G D R U I;E
B N O I D L A M X | D A L I M N B O;X
Z S W T N H E I V | E V T H W S I Z;N
B F C Z L S J R H | J S B L Z C R F;H
M P Y X J Z N B U | M U P J X N Y Z;B
L P K A F W S Q D | S Q D P F W A L;K
B V Q O W E I S K | B E K W Q O V S;I
E B I K D P A V O | O B P V E A D K;I
G Z J F V H C E L | G C H F E J L V;Z
L V I H W A S M J | S J L W M V H I;A
A K E W V Q O J G | J O K W V Q E G;A
W O B U L K P N R | P L K O W B R U;N
R T A K Q D B I J | D A J I T B Q R;K
R O Y J C H I K F | J F C R O I Y H;K
Z K A E Q L M F X | A Q M F X L E K;Z
P W I V G O Q D Z | I Z Q V W G P D;O
J W U M E I T B Q | T M E B Q U J I;W
X R N W C O E A Q | C E N O X W Q R;A
V I N O P D M X B | D M O V X N B P;I
U J D L K M S Y E | K U S E L J D Y;M
D E S B U V Y L H | V L B U Y D E H;S
Z H M R O Y V Q W | O H Q M Y R W V;Z
J H C M T E Y X S | Y H X E T S M J;C
R Q V X G N D J Y | Q J Y X V N G D;R
S G R L W H C A J | S H R W L C A J;G
A V E X G W P R Z | R E V A X Z W P;G
A P K C I J X H Z | A P H C Z K X J;I
P F J R Q T G O C | Q R J G P C F O;T
G W X N J O U P E | X N W P E J U G;O
E U P G D M L S B | G L D M B E P S;U
V M O Z T C E N R | Z O C N T V E R;M
O E L R K V Y A S | S E V Y K O L A;R
T H Y D G Q F O P | D O Y H F P G T;Q
D S T Y R O X A U | Y D X A S R U O;T
N G E B A H I Y O | G B N O Y I H E;A
R H U C P I E N L | P H R E U N L I;C
V U S W F L M A P | V U L P M F A W;S
I B V Y W G X C M | Y M C I X V B G;W
H E I X M N Z U D | E I N M Z X D U;H
X H D K Z A G M V | M D G K Z V X H;A
B W P T J A Y C X | X A B J C W Y T;P
D Y I E U H C X P | Y C E D X I H P;U
Z C A U F R D S B | Z A D S R C B F;U
R X F K W U S Z G | K X G Z F R U S;W
C E M G X W R D T | G W D M E X R C;T
R M O C L K Q T X | C R M O L T K Q;X
H B K U P A J V N | H P N B V A J K;U
S U F W P Y Q R D | F P D S W U Y R;Q
R J S E T I F L W | L I R T W J S F;E
C Z N B L R S Q X | B C Z L Q N R X;S
N D S B Y C K J X | X J N C K D B Y;S
X Y N A J P C T V | T J N V A X P Y;C
A U B M V J S T X | B V M S A U T X;J
B X J T M K R N S | K R M B S X N J;T
C G V B F E I S U | F C E B G I V U;S
H I Q U P L T Z O | Q Z H P U T I O;L
P R O V D U N K B | V U B O P K R D;N
I C F V H T B O P | I F H O P T C V;B
I Y T J V Z Q W K | I Z Q K V W J Y;T
G P X I H W M U O | H X U W G P I M;O
Z V L A B E U Y D | D V B A Z U Y E;L
J N H D Y B V W Z | J V B N Z Y D W;H
M S J U C L V Z P | V M C Z U P J S;L
T O R F J P I Z E | Z P F R J E I T;O
N H I C Q X O M G | X O Q N G M C I;H
G T C E H F X K V | V H G K F E C X;T
L M Z H U N Y V D | M Y N H D V L U;Z
C Y N Q J T R O S | Y O R J S T Q C;N
Y W B K D J L E P | Y K J W D B P E;L
N V I X D C K Y S | N D V K C X I S;Y
O K T M Y Q E F R | Y R F M K E Q O;T
L C U H Y S G K X | C H K S U Y L G;X
J E V A Q K G L O | J G L V O K E A;Q
S A M E K G C I X | X C S K E A G M;I
J G Q K N L D Z M | L Q J Z K N G D;M
Y J H K S E I B C | I E C B Y K H S;J
Z S N E M D W O V | S M D E V Z W O;N
S Y V B M T A F D | D V T A B F M Y;S
F A I Y X B Z N H | H Z I A B F N Y;X
R A U O K V X C Z | V U X O K A R Z;C
N L M T V E G X S | G M E N S T X L;V
R G W C H D F Y N | R G H W Y N D C;F
X G Q N Y F C H S | N F Y C H Q G X;S
I A M P T J G U N | G N T A I U M P;J
D K Y O C A W Z G | C O K A G Z D W;Y
I V H E Y C N U G | V H I G N Y U C;E
A V P B I G T X D | V T D G X B P A;I
C O N D E A W R U | R C A W O U N D;E
I B K O Z Q N D C | D N C K Z O I B;Q
B U Q F T P H I K | P K I Q B U H T;F
A W J T C E I P K | W K P T E A I C;J
Q L I D N M C T R | D N R I T Q M L;C
M K L P C T I W O | O K T P C W L M;I
Z Y O I A E M K X | O Z X E A I K M;Y
F I U T G O P W Q | G I Q P W O F T;U
P U G R O M Q B J | O R P Q B U J G;M
O Y U W R A K F N | O U F K A R Y W;N
Z B L V W N T O X | W T X L Z O V N;B
C J O B T R E Z G | J R E G C Z T O;B
Z U V C M D O E J | C E O J M Z V D;U
E P B D W O Y T I | O Y W D P B T E;I
G J W V T Y Z D H | T J D Y V H W G;Z
R G S Q N U O P K | S P O G Q N R K;U
L A Y B G I W F M | G F Y B W L M A;I
W N U A X H O P E | U A H E P X N W;O
L N Y A G H P E O | G N L P O A Y E;H
O Y Q G D Z K W U | Q G Z K U D W Y;O
V M P E Y I Q U B | U Q V I M B P Y;E
X Z K C J L B V D | K B L C V J Z D;X
F G N P C Y B W D | W B F D P N C G;Y
H I U B X S W Z O | Z O S H X W U I;B
G P D R Z Q V L E | R E Q L P Z V G;D
M Y N B D I F O L | Y N O B D F I M;L
P Y X F S W Z D C | P S C X Y F W D;Z
F C W L A U R O M | U M A C R W O L;F
T O D R C A I B M | O M A I D R T C;B
P X H J S T U Q G | P G U J H X T Q;S
C U F G M O J A N | N O A J M G C F;U
R P Y W I D N J V | N I P Y V J D R;W
Y V X T I R G J Z | Z T J Y I R X V;G
M J G A K Q X Z D | J D A Q M K Z G;X
B A R L J Q P H T | H P T B R L A J;Q
Z R B L J F G X V | Z X B V F R L J;G
U R T M Y A F W S | U R S Y A F M T;W
W K J D H R X O N | O R X N D J W K;H
X U L R Y C D B O | R B O U C D X L;Y
I K N T C O P Q V | V T N I O Q C K;P
A B R E I T M Z F | I B F R M E A Z;T
R V P B D A M N X | P B X D V N R M;A
S L K M Z T I P V | V L Z S P T I K;M
H V P G M Z N B F | N V H G P F M Z;B
L Z J V Y O E U A | J V Z O U Y A E;L
K X D Z W I L G E | G W D L I K E X;Z
B E K U P F D W Q | P F Q W D U K E;B
D F W Q K Z A S O | K D F A Q Z O S;W
P N T Y D R K Z E | E N Y P K T Z D;R
E R J Q M A D K Z | D R Z Q E J A M;K
A P U J Y Z T O N | N J Y U P O T A;Z
V G Q A D P I K R | V I G A K D R Q;P
N U E O L X C K R | K L U R E X O N;C
F T C H V I A P E | F E V C I T P H;A
A M G Z Q K T W F | K G T M Q A W F;Z
F Q S V Z L U O T | U L V Z S O F T;Q
M H F Y E K A Z P | Z A E P H K Y M;F
O Q H X W L J F C | X C F O H W L Q;J
R Q A Y C V U G K | U V Y K G A Q R;C
L M Z J N B P K C | N P L M K Z C B;J
C M R T Y E G F B | C F E Y B R M T;G
G T P J L X Q O R | L R Q P T J G O;X
U I X W G L K O A | W K U L G O I X;A
M E V T R C Q N I | R C E V M T I N;Q
Z Y J I G X T F K | I F T X Y J G K;Z
O B K N J E A W C | E C K N O A J W;B
M O R W H Y A U E | M A O U E R H W;Y
D L Q B C H E N X | E Q B D C L N X;H
R O L J B V W A D | O V D J B R W L;A
B Q F X V H O S E | Q B H X S O F E;V
Z A L P J N I G F | Z I J F G L A N;P
D G U B O R Y N P | B R P D G N O U;Y
N J T G F D O P K | D K N G F J P T;O
V S G K O C F P W | V G O S K C W F;P
X Z D L V E F B M | D V B F E X L M;Z
I S Q L O T P C U | U I O P S T Q C;L
T V Z A N F L R J | R N L Z A F J T;V
X E U C N A L P J | L A N X E J U P;C
M D T A R U G F L | U T R D L F A M;G
R N V Y K B I Z J | R I Z N V J Y K;B
J P Z M O K T U C | C M K P J Z T U;O
B P J D H Y C N Z | C D B H P N Z J;Y
G P R B A K Q D Z | G B R P K Q A Z;D
J O S T B G H Y A | B A O S H Y T G;J
J Y F W O R C A Q | O R W A Q C J Y;F
U T B C V S Y G J | J S T U G B V Y;C
Z S A Y W C D V U | W S U Z D Y C V;A
X C B E N U H R P | P E C R H U N B;X
P H A D Z J U M T | H P U M Z T J D;A
K F O C H E D Z B | H C D B K Z E O;F
M N B P G E T K C | C M N E P K B G;T
Q A H S Z M U E R | Q R H M Z A U E;S
O Z L A D E C Q S | C D S O A Z Q E;L
S F R J D X G U B | S R B G X J U F;D
S G E V T U L Q K | Q S K L V G U E;T
N K W U A X E D I | N W X D K A E I;U
G C W U J R V O K | W K V J O G C R;U
Y S E H N T P W X | S H W N P T X Y;E
A F Y L U T N V I | A F T N V Y L U;I
B P I H T M V L A | A V I P M B H L;T
B E I D H A M J F | A M E B I J D F;H
I O R W T C N P X | N R X I C P W T;O
E G C N W J R M I | C E I J M N W G;R
R V K T X J L P E | L J V T X E P K;R
Y P X L D H A I V | L H P I X D V Y;A
A E V D Q T F G N | T V N A Q F G E;D
Y X A V J M L Z P | Z L V A X P Y J;M
R Y X O A Z G C W | G Y R W A O C Z;X
H Z R F O S M U D | F M S D U R Z H;O
Y V I M T R X G H | T Y G I V H M X;R
O R L U H K C J D | J C L U H K R O;D
L F U A V B W Q G | B Q G F L U A V;W
Q F S Y K P A G Z | S P A Y K F G Q;Z
G A N T B J Q I S | Q T G A S J B I;N
C U D R L M O E W | O R W L U C M D;E
X B O F N M Z Y K | B X K F M N Y Z;O
D F K I A E Z J T | I J Z F A E K T;D
H J I Q F L M V E | V F Q J I E L M;H
Y X N H B I J E P | I J N Y X P E H;B
F J H S U X V W P | W P J H X F V S;U
M K Q W J Y C G B | M W C K Q J B Y;G
Q A J H W R L M T | L T R A Q M J W;H
J G O S E D K B C | C J G O S D E K;B
R S T A C M O H F | O F T C A H M S;R
O D H M J G E K T | O E T J K D M G;H
I M N H E R V F C | I C M V H F R N;E
E M V J Y Q H L D | D Q H M E V Y L;J
W O D U P K A H X | A U O X K P W D;H
Q X H R U Z S Y P | Z H X P R U S Q;Y
U L Q O D X Y N G | X Y U O L N D G;Q
K V T R N F O U S | N S F U K R V T;O
G F Z D V X J C L | J V L Z G X F C;D
Y B T Q Z I R A K | A Q B I R Z Y T;K
L H M S I U V D C | D H V C L I U M;S
M G U N C X Z O V | Z G M O C X V U;N
R H F B I K Q V J | F Q B I H R V J;K
J N Y K M R G U V | J V Y K G M N U;R
R O A F C V Y H K | H F Y C V R O A;K
V M J A Z W O Q I | O Z J Q A W M I;V
C E P Q N D U W Z | W Q N E Z P C U;D
C I A G X E P W O | G A P E C X W O;I
I C P F X E Z A L | P A L C I Z X E;F
I L R Q A O W S X | S R I L O X A W;Q
M I H A Z E X R P | Z E R P I H X M;A
D V J G M Q X Y P | J V Y X G D Q M;P
F M Y A S Z L K R | A K Y R Z M F L;S
G I C P T S V O M | S C M G V I P O;T
E G V C Q U T H A | T Q V H E U A G;C
R V Z T A J K U L | R U L J K T Z V;A
T N V B L C Q D I | I N D C Q B L V;T
S A E B P Y Z N L | Y Z L N E A B P;S
H Q J G B P S E M | H B M S E P Q J;G
D S J Z Y F T X R | T J S Z R X D Y;F
J V M F H Q R K X | R M H Q X F K J;V
W P K E B N T R D | R E T K W B N D;P
K Z X N I J A V Q | X V J Q A N K I;Z
K H B Y C L R E I | E B R Y K C I L;H
S O J A U R L K E | S A U K J E L R;O
S D O A Q R B G M | G M R D A O S Q;B
J N W B T U I R X | I J N T X B W R;U
O T P J U F L W Z | U J Z O F T P L;W
X V U S A Q N W I | X S A U Q N W V;I
F W O Z S U M Q E | S Z M U O Q E F;W
L Y G R Q N X B V | V Y L G B Q X N;R
T X J Z W F Y B M | J Y W X Z F B T;M
F S N D M I X C B | F B I D N S X C;M
M R D F H Q T S Z | H S Q T D R M F;Z
T X E F L Z K I P | I F L X T P K Z;E
T W K J E Z U Y D | T J W Y E D Z K;U
Y U T P M I B Q G | T U Q Y I M B G;P
K N F X U Y W S L | N L F K X Y S W;U
I C T U D W V M S | C U W T V S M D;I
I F G V X H T S Z | F T G S Z H X I;V
P R A S C M Q F Z | C F S Z P Q R A;M
T U B A X P V C R | B U C X R V P A;T
M Y K E U B N Z O | N U Y M K O B E;Z
M U H I K B J T Y | K J Y M U H T B;I
G N R B M F D H P | F H R D N G B M;P
N D P U R J B L F | P N D L J F B U;R
R L K G W O I U S | R W S G O I U L;K
K T X R Z F U N O | F X Z O U K N T;R
F C H Y Q V X N L | X L H N Q Y V C;F
D H Q C T K R B L | C K L T D H R Q;B
R T J I Y X O G V | X Y V I J T O G;R
Z L H T F I G P J | I F T J H Z L P;G
U K Y R J C O L A | A K R J U L Y C;O
W K D B M C A Y N | W K Y D N M A B;C
B T M E S F J G X | X J S M G F E T;B
Z T N Y O U S I Q | I O Z U S T Q N;Y
E R C V Z I F K Q | Z I V K Q F E C;R
J W F H C I D Z S | Z I J D S W F C;H
D W O X G I E S R | R G X E O W D I;S
R S D F Q Y M A J | R J Q A S F M Y;D
H E X R M G C A T | E R X A H M C G;T
R Z J G Y C U Q A | U R C J Z Q G Y;A
J L Q M E R T Y K | L K T E Y J M R;Q
X S T A J M B Y Q | X B J T Y Q M S;A
R A F U I P J N W | J P F I R N U W;A
L Y V O E N Q C G | Q N C G O E V Y;L
G P M K D C Q Y V | Q K C D Y M P G;V
T D O Z G U S I C | D T G C S O Z U;I
E G N S R A P O T | A R T O E S N P;G
O R K A L D M U X | M K L O R X U A;D
P M B Z E G X W O | M Z X O B P E W;G
M J Z S D C L V E | L S M Z D V C J;E
R Q P A B Z C D N | D N A P R C Q Z;B
O D A P M G T F H | T M D O F H G P;A
C U K G X Z J O Q | C K U O Q G X J;Z
A C Z F Q U W H X | Q U H A W Z C F;X
H B E W L P F X Z | F W P E B L H Z;X
O K J E H A Z S Q | A K Q S Z J O E;H
F B V S H P R G W | R G V F H P S W;B
D E G B X C R N U | X N R D U G C B;E
B G I M U K N Y A | N U M A G I K B;Y
Q C A P Y O W G J | A Y O J P G W C;Q
D B J C X W Q R S | W J S Q C X D B;R
T G S N M W F L E | L F E S M N G W;T
S D I L A N Z C X | X Z A C L S N D;I
D N R E U L C W X | R U C E L D X N;W
E B X J Y G D L V | B L G E D J V Y;X
E I G F K D S N C | N S D G E F K C;I
C O I A M E B Z T | T O C I E B Z A;M
M C I K R F S D N | N C D K F M R S;I
L H Z U J O Y M S | H M J O Y U Z L;S
D T V U C N M L Y | M C T Y V N D U;L
R U V G C B P S M | V G B M P S C U;R
L S A D H G X V C | D S G H C A X V;L
O Z C V N Y S B M | Z Y S B V M N O;C
H E T Y L R I N C | C R H N E L I Y;T
C N Y V R M K Q I | N M I C Q Y V K;R
W E Y I N F M D B | E Y I W B N M F;D
W C B S Q H O J K | O J Q S K C W H;B
B J I O T M C A H | B M O T A C I H;J
C A R E L V G O Q | O A V R G E C Q;L
Y Z Q V J D B G H | J Y H B Z G D V;Q
Z L Q D M B X V Y | D Z M Y L X B Q;V
J C F G O I P V R | C G R J I V F O;P
M J D S G C Y N V | M G V N Y S C D;J
A M Z D I B J V S | B S V A M J Z I;D
L K A B D C R N F | B F L C A R N K;D
L N Q X T U E Y M | N T M L X Q Y U;E
J T M S Y O V D N | O N S D M J Y T;V
V A G Y W I J L T | G Y L J W V A T;I
D A R N H P I J F | F N J I H P D R;A
K J L Q E G X B V | L J E K X B V G;Q
D F V Z L C M G B | M F C V D G L B;Z
E D T J Q S Z Y K | D T E S Z K J Y;Q
O B Q E N H I J X | B J Q X O E H N;I
D B L I E W K J Y | Y B K E D I L W;J
I X P C U T W S A | T U S W P C A X;I
R H U X N I T O Q | R X N I O H T Q;U
K D O A Y X H T V | V A X K O T Y H;D
G J U V Y K E P H | P E U K V J Y G;H
O J F H V L I M Q | M L I F H O J V;Q
V Q N J D F P I M | Q M I P F D V N;J
E Q X Y J H D Z T | Q H Z X E J T D;Y
R D B A U K P N Y | N Y K D R A P B;U
P U K X B T M N H | K X M H B U P N;T
F Y B Q D O A I R | B D R Q F A Y I;O
K Z F C A B G Y R | Y R B K F G C Z;A
E M Q T B F Y J I | I E J Q B T F M;Y
A E U Q B T J O L | T J B U O L E A;Q
E S G C L B Q F H | E H L B Q C F S;G
K F E P R S N X V | K X S V R N E P;F
P U Y B T A Q O E | Q B E O A P U Y;T
G V U H O Z S K I | S Z H G I K U O;V
D F K M J W U Q L | M U W L K Q J F;D
E F H C M G Y B S | S F B M E C G H;Y
F L S J H I Z R W | R F L W I S Z H;J
P B R H Y G T K Z | Z B T Y G R K P;H
O M C T F B S A G | S A C T G B F M;O
D X N A J V M I O | D A M V N J I O;X
C L A T N E K P W | C A T K W N L E;P
P Y W X C Z I B A | W B X A C Y I Z;P
Y G I S B Q R J U | Q I Y B S G U R;J
T W R V Q H K D G | R D G Q V T K H;W
D G I F H W S B R | B D I F G S W H;R
T U R E V N K F C | V E N R K F U C;T
W N E K H R S X Q | E K Q H S X R N;W
W V Y M K X P S T | S K Y X V P T W;M
Q O H A L C S V Y | Q H S V O A C L;Y
R T D Z V H O J N | R T D J Z V O H;N
W O Y H J K B R V | J K V O B R H Y;W
E H G Q K R M Z N | R G E K M H Z N;Q
X S Z E I M K F T | I T Z E S X F M;K
R M O Z S H I D U | O R Z S D I H U;M
H B Q A W X S O R | Q B A O X H W S;R
B C T D G L M N S | S C L G T N M D;B
H N P S Q L W R I | H P I N L W R Q;S
C S Z Q M D E R H | S Q C E D H R Z;M
Y K H N W T S L E | L S N E W Y H K;T
Q W K F C Z G E O | C W G F O E K Q;Z
M C R D B Z J H X | Z B R M H X C D;J
B C R A J L X G P | A R G X P J L C;B
C N S U Q E T H A | A S C E N H U Q;T
T W V H J Y R P O | R V Y J H T W O;P
T P H O E Z Q J D | Z T Q H E J D P;O
M G X D A B V L R | R L A V X B D G;M
H C P B F Y Z M V | C B Y M V P F H;Z
J Y M N S D W Q P | W S Y J N Q P D;M
U D L T C Z S W B | C Z L B S W D T;U
L N X Q M I R H T | X Q H N I M T R;L
Q E T X M C H B V | E V C M Q B X H;T
S Z C W T I A G X | W S I Z X C T G;A
W N O A D E S T J | A T W S N E O D;J
A X E V H B J R K | H K E J X A V B;R
J L B X V S A T F | X L S F V A J T;B
B P E J X A V I G | J B A E P I X G;V
K L R O E G H C Y | C H O R G L Y E;K
G C V M R Q K J O | V M Q R C G K O;J
W X L Y M E I S F | I S Y E F X L W;M
Z O N X A D V G U | U A X G N Z O D;V
Z H A B M O R E P | E H M B R P O A;Z
Y Z G N O U M D R | O U G D Z Y M N;R
G Z A R C U W S D | R W C U G Z A S;D
L P U J E I D O W | D U W J E I P L;O
M Q T Y H A E Z N | Z Q T H Y A E M;N
L Y K G C T R X A | R K X A C G L T;Y
S A V O M T R G K | V M G S R K T A;O
F U R Z J X Y H Q | F J Y Q X H U R;Z
D Y N H C J L O K | Y J D O K C H L;N
F L M Z Y C T G X | C Z L M F T Y X;G
C T Z M F X S K N | X N M S T Z F K;C
S J X C P R L D A | A P R D X C J L;S
R L K D O T A Q J | Q J L D A K T R;O
K D Q Y S Z L B I | K D S Q Y Z L I;B
O T P D Y Q U X S | D Y U Q X S T O;P
A B M Z O I E J T | B M O T J Z A I;E
F H Y S Q C G A I | Q Y F S A I G C;H
Z N Y A L P O F W | N P Y W O L F Z;A
V R X F E P W G I | X V P G I F R E;W
S D Q T C X E I F | I T Q S D E X C;F
D S V Y R A O Z U | A U D V Y S O R;Z
B W R O U V Z A K | V Z K U A O B W;R
D N I F H G T J Z | G Z D J F I N H;T
K Q D S O I N Y B | Y K N I O S D Q;B
N S M G J E K O B | O N J K S M G B;E
O I Y M D A H K R | I A D R K M Y O;H
O D H L X B I E K | B H L K I O D E;X
G C A T Z Y P V D | V T P G Y A D C;Z
C D O F H V E Y L | D F Y L E V H O;C
D S O P Z Y N X F | X F P O D S Y N;Z
Z X B H V K O R L | R Z X L K V O H;B
T D J Y N W G L R | W T G N Y J D L;R
C X Y J S O M E F | Y J O M F X C S;E
A P R F D H E Z S | Z S F D P H E A;R
K G T D E A L W U | K D T E U A W G;L
U K A D G Q L Z F | A F Z K G L Q D;U
X T H P R D W L Y | H X D Y R L T P;W
B I A S M F X H Y | S Y I M A F B H;X
V I C F D Y T B U | D I V C T F Y B;U
K R Z D F P I C E | P C F I K E R Z;D
R X K V I Y G A B | X V K I A Y B G;R
V S I A Q G C K H | V I K Q C H G A;S
J E I X R O Q P F | P R O E I F Q X;J
O S L Q W U N K Z | K Q L Z S O W U;N
C E T B U G Z D V | U D C E T G V Z;B
M D L C F N R B Q | C B N L D R Q F;M
J I U Y H F G A L | Y G J A L F U I;H
Q A P S J E Z X U | U A J X S Z P Q;E
F K W E T X U L P | W F E X L T P K;U
B U G P J N Z O R | G U P R B N J Z;O
K B M H E Y W G V | M E K V B H Y G;W
S K H Z G L E P R | H R P Z S L K E;G
B Y J T U O A N G | T N U O G A Y J;B
S B N M W D Q K X | D X B Q W M K N;S
Q A Y F X W I L H | F Q Y X H A W L;I
I Q W A U S E R L | A L Q E U W I S;R
C P J H V L W I F | W P J V I C L H;F
H J X U O A K Y Z | J H U A O X Z Y;K
H D X L G B J Z V | Z X V B H G J L;D
X H Q R U E W L Y | Q H L R E X W U;Y
C O W I V L S Q F | C Q O S V L I F;W
P W T Z I G F M H | G W F P H M Z T;I
C A Y Z J Q M I N | C Z M J Q N A I;Y
W F O S K B A Y N | K B Y A O S F N;W
U V E A O Z H M T | O V M Z H T U E;A
I T P N Z O Q R D | N I D O Z Q P R;T
S J U K D L E Y G | L Y D J G E U K;S
O N Z U Q S I J X | X N J O Q I U Z;S
Z H A X N J P M Y | N Z A P H X J Y;M
D H S Q J Z A F Y | S J H Z D F Y Q;A
G K X N A W H O Q | W H N Q O A X G;K
I G W X D T L S F | S L D F I T W X;G
Q A N X B C I D E | B I E D N C Q X;A
I Q T S W K X C F | I C F S X K W T;Q
J S W A N O H U G | A U S W O H G N;J
P J S D R U H B Z | B H J S R U D P;Z
E R D L Z S O U M | E Z D L O U R S;M
P T Z O E L J K M | Z P T O E M L J;K
W N Y I J E B K Z | K E Z W J N Y I;B
N S H F Y W O D X | X Y D N H W S O;F
A K Y M Z U T S X | Z U M X T Y K A;S
S B Y G O W J U M | M U O S G W Y B;J
Y V R X G O T D P | T D G X V O P Y;R
Q G S Y N E R A L | S A L G N Y R E;Q
Z U M W L F C O E | M C Z U W O F E;L
D P B O A W K M H | P H M W A B D K;O
N D F E J Z O S H | Z F J N O D H S;E
J O E W V M U N A | N E M V A J O U;W
A T B V J Y I C H | B T H Y I J C A;V
R T J E F Z N A X | T F A N X Z E J;R
R V W O H G D N S | D V N R S W O G;H
A P E S F K V Y Z | Z S P V E Y K A;F
S U Q K V F A T C | T U C V A F K S;Q
V E I Y U N R Q T | I Q R T E V U Y;N
P M S V J N Y F Z | P F S Y M N J Z;V
G K C Q M Z N I F | K Q N Z F G M I;C
E B X I H U R T Q | R B Q H U T X E;I
C B P I D R A Z S | B P D S A Z C I;R
V O G J I K E A Y | J I Y K A G O V;E
F W G S A H Y K D | Y A S K G F W H;D
H E N Q X R F G L | E R X N F G H Q;L
L S A D B F J O Q | Q A O L F D S B;J
S X H M Z Q N G D | G S D H Z M Q X;N
X W H E O Q K D R | D O X H E Q R W;K
B T R U N E O I A | I U T E B A R O;N
B S Q O J N G H E | O B G N S J Q H;E
S Q H E B W C D P | S D C Q H W B P;E
J P F H B K E X U | H J X P F K E B;U
F P E X D Z Q R H | Z F P X E Q D H;R
F H G D B S R K W | B R S K G W F H;D
Z K V M D S B H L | S M Z V L D K H;B
O N I L U Q B X V | B Q L V O I U X;N
M E W F B J L U O | J B F W E U M L;O
U Y P E T V W L Z | P E Y L V Z T W;U
P X Q I G E A S M | Q A M E P S G I;X
Q P O D L S J X I | L D Q I P S J X;O
I Y O K N J U E X | J O I U N K E Y;X
G W J N T B V L A | B N W L G A J T;V
P Y Z J X T M A W | P M X Y A J Z W;T
D P M J E O S X N | J D O S M N X P;E
N Z A H Y O P V E | H Y A V O P E N;Z
S D G W I F B U Y | F G S I W D U Y;B
N H Q Z T K R X F | Q N Z H T K X F;R
O B H M A E D W X | B E W X D O H M;A
R S W T Q X B A Z | R B Z T W A Q S;X
R Z V K B D A E P | A E K R V P B D;Z
G S R J E C N I U | R I U N E C J G;S
X H I T B V A Z U | U H T X V A B I;Z
J A P T B M F V R | M J P T F R A B;V
X U M D P E V B A | E M X U V D A P;B
C L K I W Q Z A N | L N A K I C Q W;Z
I D G N J U A L T | I A G N J T D L;U
E V X H P Z O S F | E S H X P Z O V;F
B A M Q L J K X D | K M X L D A B Q;J
C F L S W Q I E R | Q S E C L R F I;W
W S D H Y L J E I | S L Y E W J H D;I
B F L E U R G M T | E G F U T M B L;R
K X C O U Q E Y R | X K R E U Y Q O;C
V F X R H S L E C | R V E F L C S H;X
N V H O Z D Y K U | Y H O V U K Z N;D
H P Z Q E M V U G | P E V Q G M U H;Z
G W Z Y A S C J X | J W A X Z C S Y;G
Y J L I V C N S P | Y J C L P I S V;N
M P A D B W J C S | C J B M D W P S;A
P C X B W J A U S | B A C S X W U J;P
V Y U L T Z O P N | Z L U P N T O Y;V
Z C B P I A X J G | A I X J B G C Z;P
A K N Z R I M X D | X A I K N Z R M;D
H Y K G M P W B C | K G C Y H M P W;B
U A H J L C S Y M | L Y S C M U H A;J
A S M L J O K U I | I S J L U O K M;A
J L W K B M R O A | J M K A O W R B;L
O K T L Y A J R P | L O Y P K R T A;J
V R J G E U I N X | I X U J G V R N;E
E B P X G Y O L K | X G E B O K Y L;P
I Y M X U C G Q H | Y X I H U C M Q;G
Z L K V F X S A T | Z X V A L S T F;K
D F K M Z P T I A | K Z T M F P D A;I
L S Z H A I E M D | Z I L S H D A M;E
F V Z Y Q P B W N | Y P V B F N Q Z;W
R F H Z J L U X W | X F R H L Z J U;W
R Z N Y D F E I K | E D Z I N K R F;Y
R Z B H V S D X T | H T R S Z D X V;B
A U R Z Y E M O X | M R X A Y E Z O;U
X W M N H B S F P | M B W F X S P H;N
E R P B Q F V X M | E P V B R Q F X;M
T H M Z F K B X W | W H X B T M F Z;K
L E D P Q N U V Y | Y V D N L Q E U;P
J G O U Z C D H Y | C J G U Z Y H D;O
W V E N M Y U K A | A U K N W M E V;Y
F T C N R Y D P B | F Y B D C T R P;N
H B C K T S G F U | G H U B K S F T;C
H D G Q X N M U J | G M H X U N Q J;D
H P C Z U A S E B | E S Z A H U C P;B
W Q A Z L U C B X | U L W C A B X Z;Q
W K Y L T P R X V | P R T V W K L X;Y
C Q G M R O J N B | C M Q B G O R N;J
Q P N H R T Y I O | H O T P Q I R Y;N
I O T A K L B D M | I T D A B K M L;O
W H E J L O X Q G | H X O Q E L W G;J
M A R P E G B O I | E G A O R B P I;M
U D Z L M G V Q A | L A Z U D G Q M;V
A U P Y Z R X S E | Y R U A P E X Z;S
X H A Y J R P K D | K A P J X D R H;Y
B X C M U A V P E | M U C V A X P B;E
B M N T Y V S D Z | T Z M D V S Y B;N
H D W S T U A V E | E T H W A U V D;S
J Q K I G H L B T | I J B Q K T L G;H
J S W K L U N M A | K N L A S W U J;M
N R S Y I D K A B | B A R K N I S Y;D
R N G U E A O P X | A N P R E O U X;G
R I W D T P F G Y | I F Y D P G R W;T
K S U P H Q O T X | K P O T S Q H U;X
E F A D O W Y C V | E F W D V Y O C;A
N Z A R P Q F C L | R Q N F A L P C;Z
W L S Z F I J T Y | T S Z J W L I Y;F
T U N K P X M Q O | U T X Q N O K P;M
I J C S G E K R M | J G I C S R K E;M
O W B K R M X G Y | Y K G X R O B M;W
J H C T N Z E M K | K N Z M C J H T;E
O U S I M L B J P | I O J P M L B U;S
V D X K H S J F Q | F S X K H Q V J;D
C G X Y H B R A N | H G R C Y B N X;A
D U W B X Y H K O | U H D X O B W Y;K
X Q Y N D L U G C | Y D Q N G L C X;U
C L Y I U P G W K | W I G U C Y P K;L
E B Q T P V N S W | S E T P V W B Q;N
B F V N U Q C J R | F C V J B N U R;Q
C O S Z P V G L J | O J C Z S V P L;G
W S P E X J A R Z | W P A X E R J S;Z
Y N P A W M X V I | P A N V I Y X W;M
W C J X S F Z G K | K G F C Z J W S;X
S P K N B J H W A | K S B N W H J A;P
P V Y O Z S N M L | P N O L Y V S Z;M
P O J X W C U D S | P O W U J X C S;D
X E F B U L G M H | F L U G B X H E;M
S H L Y O N W M J | N Y O W L S M J;H
N R A J Z E V W C | J R A N V C Z E;W
G P I E H V D M C | D P M G V C I H;E
I N G E O T K Y L | Y O T G N E L K;I
O Y Z L R P U T E | E T R U O Z P L;Y
V R L U X A E F G | F E A V L R G U;X
C N Y Z R F E B H | Y C N Z R H B F;E
N X E Z L C T J V | T E C J Z L N V;X
R L I E H J B M K | B R K I J H M L;E
W O D C R F Q M H | R C D Q O W F M;H
W P U S V F G K A | U W A P G K F V;S
L B J K G H D Z C | J L G C B Z D K;H
F P Q O G N L A T | O L P Q T N A G;F
O Y U S R D T B I | I D R U B O S Y;T
M J R B Z N D U X | M R U D J B X N;Z
R U G V Z K P Q J | R P K J Z V U G;Q
Q R U J V T M G K | K J M T U V Q G;R
K H J W B S U X Y | B W J H Y X K S;U
J K M C G P U E X | E P G J U C K M;X
W K P B L C Z J F | B K P C J W Z L;F
A P X O D S Y J V | A S V D P X J O;Y
I F J C O N W R D | W I O N R D C J;F
A G U D T Q Y H F | H T G D Y A Q U;F
B G M Q R I W V K | R V W I B Q K G;M
H Z I L P R J E B | H B I E J R Z L;P
A Q D F B S H C K | K S F A D B Q C;H
Z C K Y R X N W P | K C P R X Z W N;Y
C H K F J B D R V | B C H R K J F V;D
I J K X E Y Q O D | J X O Q E I Y D;K
I F O Y S G Q A W | Q Y W A O F G S;I
C K Y H G N E O X | H C Y K X E O G;N
B J N D O A C I Z | J A B Z I C D N;O
L I D Q X K U E C | I L U K X Q C D;E
R L Z M B W F D U | D R M F W U B Z;L
U E Y R V M D T P | E M T D V U R P;Y
P A M U H J K D B | D U B P A M J K;H
A K H I N E O W Q | Q K H I O A N W;E
I E L T N F A K W | E F W K L N T A;I
T A G Q O N Z S V | Z V G S O N A T;Q
J Z C K T S W V Q | W V S J Z Q C T;K
J H Q R L O B T F | B F H T J Q L O;R
F O Q W P S Z E U | U W S Z P E O F;Q
F O L S E P V W H | S H F W O P E L;V
D B X U Z E G J S | G D S X E B U J;Z
F T E M D X R K O | D F K R O E T M;X
N A U F K L W V P | N A L P V F U W;K
Q S N E G X J I R | X J Q E S I R G;N
X S T Q G P C A N | P T X S Q C A G;N
X P I R V O W U Y | R O Y V P U I X;W
M R O H V T N U F | N F U R H T M V;O
L K D S F V J N X | F L J K S N D V;X
N O D E J Q K U P | U O E J N K P D;Q
D G B I W P Y L Q | L P I B D G W Y;Q
B F U R Q P S G L | G F P L Q B S R;U
Z N F G Y K D A X | X F Y K N Z G D;A
K V U J Y Z W R E | J Y Z V E R W K;U
H P G Z T O A Y I | H G I Z Y T P O;A
R C U A D Q M S P | U S R P Q A D C;M
F O J K W P L Y S | W F Y J K P L S;O
L Q N C F H S R E | R Q E S H N F C;L
W F S L Z Y K I E | W E S I F Y L Z;K
Z K T R M X C L Y | C Z R T X Y K M;L
T X R B W U Z S V | S Z V U R W X B;T
L R K S I P C X J | J X I P R K L C;S
X H Y D Z R K M Q | Y R Q H K X Z M;D
X K W P Q Y M S R | S R W K X P M Q;Y
T K V H Z U B O J | K T Z B O U V J;H
U X N F W T M Z P | W U N X Z M P F;T
P B C H Y S N F U | N S Y B U P C F;H
J B D K Z Q F L T | Q T D B F L Z J;K
W R C Z B U L M E | W C M U B L E Z;R
Z X T W E H O N L | E T L W X Z H N;O
D E R F C A B T U | C B A U T E D F;R
W J E F X V P R Q | R F E P Q V X J;W
R Y N O C K T I F | T F N R K Y C I;O
E W L C D G H M V | H M L D E V W C;G
M U A B L K Z I D | M D K A Z B L I;U
R Q H M F Z K W N | F Q K N M W R Z;H
M B I K E W S Y U | W E M I U K B S;Y
H E N F M X P Y A | X H Y A F N P M;E
J I Y O Z L D A X | I D X L O A Y Z;J
N E Y T P X I J Q | J P I N E X Y Q;T
K P D R H S I G Y | H I K G D Y P S;R
N P H Q K E Y V L | P Q Y N K E L V;H
Q Z O B V W P X L | W Q P Z V X B L;O
K L O R D E J N B | R L O D K B E J;N
C E O W Y Q B J X | C J W Y O E B Q;X
U W O V Z S Q J Y | O W Q Y S J V Z;U
N X B U D K J P M | B X M P J K U N;D
G U Q B K R H C J | J B R Q H C G K;U
F A Y S L X G E Q | S L A G X Q E F;Y
Z B M A L G H V O | O M A L Z V G B;H
J X Z K I S A V M | I X Z S K A M J;V
Y G F A N H R J B | J G B H A N R Y;F
E L C P J V R A Q | V R P A Q E J L;C
K V S O B A C X Q | S X C B Q K A O;V
E Q C M G I L V U | C M V I E L U Q;G
P O V Y I D E Q F | O V Y D F I P Q;E
J C O E V Q Z L S | E L Q O J S Z V;C
G Z O J P Y Q T N | Y T Q Z P N G J;O
X Z F W E G H J U | U G E J H W X Z;F
W B E A V Y F H N | V F E B H N Y A;W
L S E V G T P I X | G T E I V S P L;X
E X S O J W K D P | P S E O X K J W;D
P E U D H T Y X R | U X R E P D H T;Y
B D V S R N J K E | E J S K V N D R;B
H R L C T S J U G | S H R C L J G U;T
O M Y G U W K V B | M U K Y G V W B;O
W P F G S U N H Q | N P Q U W S G F;H
U O Q V L I A R E | Q I V L E O A R;U
Q I R Z T X V O L | T V L I R O Q X;Z
P N W L J O K A U | J U P O K L N W;A
P K R G O C M T L | O M P L C R T K;G
A L V M J X Z C H | A V X J C L Z M;H
H O B S V G Z F K | Z B O F G V K H;S
J A B H T U S R M | M T R U S H J B;A
W X R J D G Z L E | W L X J D Z G E;R
T U S M E C X O A | U M C S X E A O;T
B S X R C I M L U | M U B I S L C R;X
A B C L J V T U K | C J V U B K T A;L
Q J F O M S D T N | N F T M J Q O S;D
I D L O A W S X B | W B X A I S L O;D
Y S A N R Q V P M | N V P Q Y M A S;R
H O Z U I V B P S | V H Z I B U O P;S
C S N B F U R T X | T N F B S U R X;C
N B U P Z S I E G | U P I G E Z S N;B
J U Z A X O D Q H | Q O U H X D J A;Z
U Y J D Z F H G V | H Z D G J Y U V;F
K P Z N Y Q T B C | C N B K Q P Y T;Z
Q K X B D G O W A | B D K W G X A O;Q
J W U G Y K N T O | O G K U Y J T W;N
D W F O R A J X C | W D J X R C O A;F
O N T Z Q D I P B | D O T P Z Q I N;B
U K W Q E Z N R G | G Z W N R K Q E;U
S O J Y Q H D G R | J Q G D S Y O R;H
P L E F Y C G M B | B F P G Y C L M;E
Y Z G V O N H R K | R K Y O N H V G;Z
N Y G H J A L F S | S Y H A G F L J;N
D K T N L Z X B Y | K B T Z L X D Y;N
X T K E S R M J Z | X R M Z S K T E;J
W V C X A K T M Y | X C V Y W A K T;M
C X G R Q B D O Z | X O Q Z B R D C;G
P E U W M N S I Z | N M E Z P W I S;U
X P M U J Y W I O | Y I X M W U J P;O
T G C U S X M H P | X H P T M G S U;C
I N R J G T W E O | O E J R T N W G;I
E B I X D Y J U V | E V J U I X Y B;D
U V D M G E W K L | K G U V E W M D;L
L M Z E D V F B Y | M L Y Z E F V D;B
G H K J W Y F N P | G N P J F H Y K;W
M A N P D L Y F V | F P A M Y V D N;L
F V K E C P J T U | T J K V F U C P;E
B U I S W D Q Z F | B F Z Q I U W D;S
B G L U V W J C M | W J L G M U V B;C
R A X C H E W L D | X L H W A R C E;D
G N I H O R A M C | G H M I C A N O;R
O X H S D E N R Q | H S E O R Q D N;X
P C Z J T X V K Y | X Y T K P C V J;Z
Y P O L A T G Z I | T I O L P G Z A;Y
N U C J P S V K O | N V J K C S U O;P
W K N X H T O D U | X D K W U O H T;N
X Q J F Y S L E Z | J Y X S E Q F L;Z
K V J E F R W Z C | V F E J W K R C;Z
B M L Y V J Z P N | N M Y Z B J L V;P
C Z Q A G K L E O | A K G L Z E O Q;C
Q Z B U V F K C O | O K C B Z V U Q;F
G L P M F H U O Z | U L H Z M O F P;G
T F S C O I Y X A | X F O I C S A Y;T
Y I A F O X C E T | F X A I O T E Y;C
C P L X D T K O W | C T D K O P W L;X
S Z D J E R H L B | L J S H Z E D R;B
I F N Y E K X M H | N F H E X I M K;Y
A W J O M G Y H U | W O U Y A H J G;M
Q O T G I L H B V | L Q H V T G O B;I
F G U K Y X S W V | S W U V F G K X;Y
O M I P E X V B T | T M O X E B P V;I
Z O L R K T B P V | L O P T R Z V K;B
N E R D J C P T A | P T E J R C D A;N
T D O B Z I Q S P | Z Q P S B I D T;O
Y G Q J O V P I L | P I V J O Y Q L;G
Q Y T J K S E N F | K J S T F Q Y E;N
L O F P X Q Y T G | Q L O T F P X Y;G
R B D Y J M I G A | G I M A Y R J B;D
C T Q Z S J H O A | A S J H T Q O C;Z
G E N V Y K J B O | N K G J E Y O B;V
G Z A B O F S T Y | Z Y F O S T A B;G
X K Q A O M I R W | O X Q I M A W R;K
L I R D T U Y B Z | R B Z I T U L Y;D
V H G Q B W U J I | W H U G B J V Q;I
L V H W T X G Y B | G V B L H T W Y;X
R I W N G T D A X | D N R G X A I W;T
N B K U C R I F Y | U B I Y N R C F;K
N O X F B G K H E | F O E X N K B H;G
G C N D P R X U L | L D N G U X C R;P
H G C S N T B M Y | S H B G N C T Y;M
H U T Y R F O Q M | H Q R M Y U T F;O
Z J G E F B A W L | A F W E L J Z B;G
T N O C W B E G U | W T E O U C N G;B
L O V U D Z Y S A | Y D V S L A U Z;O
L N W X F J Q V H | W X Q L N J H F;V
W Q I G T D R U K | R Q K U D W I G;T
B W I G X Y J U N | Y N X U I W G J;B
D M W L E T R Y A | E D A L Y T M R;W
C Q O M I D N G V | N C M O D V G Q;I
K R O C Y Q X B M | O M K Q Y X B R;C
V I F Z S L R O Q | L Q I Z V O F S;R
A X O Q H R L T J | H Q T X R L J O;A
U N A X C V Z T K | N V C K T U X Z;A
X D M V K N P I F | P X F N V I M D;K
N Q B X I T J D U | D Q U N T X J B;I
M Q D H E L G Z X | X G M H L Q Z E;D
G X I J R N E Y K | K I N E X J G Y;R
H R W Z F B O Y J | H B O W F J Z R;Y
X A R Q Z F N M K | X Q K R F A N Z;M
D G C M T Y O B R | D Y G R B T M O;C
O B F J V D I Y A | V D B J F O A I;Y
P J Q N E R X K W | R J K Q W P E X;N
M Z V A J U Q N H | Q Z N V H A M J;U
P V O R U W B Y L | U R W Y L V P O;B
O M G F B H A X L | X H A G B M L F;O
T K S D X H M O R | K M O D S H R T;X
Y H T W I D E Z C | D C H W Z I E Y;T
Y Z W F G I V O B | G Y F W V B Z I;O
A P U S C J Q L K | C U P S L A Q K;J
X A P E B W Q O Y | A P E O Q X W B;Y
N U P Q X B L A I | X B L P N Q U A;I
Z N T C G O D S K | N T G Z S O C D;K
D O J V C Y T M I | I M V O J C D Y;T
M N O F A W Y T C | W T O M Y C A N;F
U T K W V N I X S | S T I N W V K U;X
J F G I T B Y P C | F I T Y J B C P;G
J C G M W D P Z R | C W G Z J R P D;M
E F K D C U S Z V | Z K D E C S F U;V
V N E Y U Z W P H | Y H E Z V P N W;U
Z F B X N S Q I W | N W F Z Q I S X;B
F T Q E C J A Y D | C F A Q E D Y T;J
I C F Y D J S R E | E F R C S J Y D;I
N T L Z K W S C O | N S Z C K L O T;W
H A Q S J N Z Y T | A J T N Z H Q S;Y
E O Z V T X I W U | X T W Z O I U V;E
Z H Y D W V K T G | H W K G T D Z V;Y
K V L H S R W G O | V G O W R H K S;L
J L E Y R I W H F | R Y F H E W I J;L
N O B G L Q U Z H | H Q B Z N U G O;L
I H X W F K V R B | V R X B K I W H;F
E A I X Z W H Y R | A X I H Z R E Y;W
F I J P W C Q B N | F I W J N C B P;Q
R Y H B G Z V Q F | F Y V G B Z H Q;R
K B Z P I T E X U | Z U X K I T B E;P
J U K H V D L A B | U L A K J B V H;D
I U H M K O D F G | H U G O K F M I;D
A M F N H X E T S | M S A N X E T F;H
Q Y U S E L J A V | V Y L E Q S A J;U
H Z E Y P L S W R | L Z H Y P W E S;R
D E B C F K I X Q | X Q K C E I D F;B
X O N S G P V A J | V S N A J O G P;X
Q T G N O Y H F L | O T Y L F N H Q;G
S O M U C R T I G | T R I C M G O S;U
N K J G H T X Z E | T K G E J H Z N;X
G W J O F I M U H | I M G O U J H F;W
L Q G H M S A Y W | G W Y Q L H M S;A
Y H M D C K W X Q | W K C Q H X D M;Y
M A W Q Y G Z J K | G A Y Q K J W M;Z
I X P E N R L H T | N R X I H E T L;P
Y R U W T O S B J | U R Y W B J O T;S
P W H I O F V E J | F J I V W H P E;O
G Y H N E K R S V | V S E G R H K N;Y
G W T J Z D A I R | T J W A R D I G;Z
E V N U I B X H Q | E B H U I Q N V;X
M U F X O J R H B | M F B R O J U H;X
F Q D J G W X M O | X D F J M Q G W;O
M H Q E L Z W O I | H Q M L E O Z W;I
I S E D O W Y A P | E W I P A S D O;Y
N Z Y D A Q V B M | A Z D Y B V N M;Q
O Q E Z Y D X T W | T E Y D W Q O X;Z
J W X M O Q D P E | Q J M W P D E X;O
M A E T Z Y X W L | E L M Z X A T Y;W
Y Z N V R C B F K | V R C K B F Y N;Z
O J D B F V Y H K | K F V O B H Y J;D
Z X C G P S D F K | F P Z C G S K X;D
B C F Z R H Y Q E | H Q Z F B R E C;Y
O H G L S U Z C B | O L B G Z C H S;U
T R E W N O I K C | E W I R N T O C;K
E C S O M L R K T | M O S E C R L T;K
X O F G P V H Y C | P X H C V Y O G;F
N F M A X Y S Q D | M X Y N S Q A F;D
O L H P I G Y B Q | P O I B G Y H Q;L
M F G P U W Y N B | U F P M G B Y W;N
M L D Y T C S E X | L T S C X Y M D;E
L G C Z J A S X K | C S L G K A Z X;J
D T Y L M R K A X | K M A X T L R D;Y
N O H W R D C A B | W A B C D R O N;H
M Z Y C S G K Q X | S K Z Y X C Q M;G
O L E B V R G X S | O X G B R S E V;L
U B A C L E I Z Q | Z L C U E A Q I;B
F U R W P E G C J | P G J C F E U R;W
G J X R O N K I A | A R X O I N J K;G
K V N D Q B Y I Z | Y Z D K Q N B V;I
C Q H Z O U F V X | X Q C O H U Z V;F
W H Q R I M B P Y | W I Y M H B P Q;R
Y O U X W R J B C | U J R C O B Y W;X
W C G L T Y O X S | L C T S W X Y O;G
P M S E K I O J C | O S I P E K J C;M
T U H S F P O N I | S H N U F P O T;I
M D V Z R C U E K | K E C D R U V M;Z
L H E Q P I K T D | Q K T D P E H L;I
O J G S P L H R T | T S R O H G J P;L
X M J N R Y A Z T | N J Z T A R X M;Y
B T H I U W C A F | H A U T W F C I;B
U M C H Q R E V T | C H M R V Q E T;U
B W M K U C Y S F | M C B W F S U K;Y
M W Y P I Z V F A | Y M I P W F V A;Z
Q N O I Z W F K S | W Z I F Q O K S;N
T C M L X Q U P J | X M J C T L P Q;U
A G N O W Y D J F | G A F Y W N D O;J
Y R A Q K P G Z L | Y P K G Q A L R;Z
M R U X I L B Q F | I X M L Q B F U;R
Y C O Q F X H L U | U X F Y O C Q H;L
Q G J T X N L S C | G L Q S N X T C;J
L I H S Q G A U D | G Q S I A L H D;U
A F N O J P R H D | R F N O A D H J;P
U D X B L W E C J | J U D W C E X B;L
Z K J I R M G A U | J R A G U Z K M;I
S K Y H O N F Q V | H V N S K F O Y;Q
V W R M Z S X P U | S W U X M R P V;Z
Q M F W A X P L T | F P W A L Q X T;M
P E R T B X H Y L | X H T P R Y B E;L
C B O R D Q G F N | Q N B R C O D G;F
X Z V M A S J H U | H S A Z X U V J;M
C R I V Z F D H W | D Z I R V F H C;W
R G A C N L U J T | U N A L C T R J;G
G D A R K P U Y I | K P A G U I Y R;D
T G F P Z W O N U | G U O P N F Z T;W
J N Z H S P B Q W | W Z Q N H S B P;J
U O X H F N T L D | N D H X F U T O;L
X K D N U H T S Y | H X T K N Y D S;U
X R K Q E T F P Y | P E R K X Y T Q;F
D G H B W P Q L U | G D U L P W Q H;B
W I D A K J N B O | N I A O B K J D;W
C U E N X V J H G | H G X N J V C U;E
Q F K J M S N E G | K F M N E S J Q;G
E V P J I Q B O W | Q B W O I E J V;P
T P H B A Y L M R | P M H T B L Y R;A
O J N D S R C Q M | J Q N R D S O M;C
X J I Q R H E F K | J E X H I Q R K;F
F J N A X Y S Z B | B S Z N F A X J;Y
O W N A B R K I U | W I K B A U O R;N
I P S Z E B U F M | B M U E Z S P F;I
E L B U C M D V F | B M L V F D E C;U
K M T Z E J L C V | C T V Z K M L E;J
M J O X S P K Z D | D J X P O K M S;Z
M W L R D E Y P T | P W E Y R L M T;D
B Q P I U D J C R | I P D Q B R C U;J
E V R C A H T B Y | B T V A Y E C H;R
W J L I K G Q T X | J T G I Q L K X;W
F W R E U Y J Z S | J U W R S Z Y E;F
W U J Q I P H R Z | W P U H R Z I Q;J
N O S I G D K R Y | D S G I Y N R K;O
A Q V T J W H I O | T I W A H V J Q;O
L C P I F E H X U | H U X E P C F L;I
Y K S Z T Q A P D | Y A T Q S Z K D;P
X A N G B R Z O P | P B R X Z O N A;G
Q B M P V C A L G | C V P G M Q B A;L
Z W Q X Y J L D P | L W Y X Z J D P;Q
J F Y Q N L X M T | M T L J Y N F Q;X
X B V W Q O I J A | B Q V W J O X A;I
M O V D Y E F K Q | Q Y K E V D O F;M
C D H J O U E Q P | U Q J D E C O H;P
V E C M I P W A L | P C A L I E V M;W
T M Z C N D U E I | N U Z M E C T D;I
D B K A Q E Y U F | A K Y U E B F Q;D
U W I L O Z A G P | G A L O Z W U I;P
U Z Y H B I F S G | I S Z G H U F B;Y
W J F B S D O I E | E B O D I S F J;W
T O A Z B K H C Y | C K A T H B Y Z;O
Q I K O Y A W R D | Y K A D O W I R;Q
R Z G T U P Y J C | U G Y P Z T J R;C
J A M H C N D I G | A N C D J M I H;G
U Y V Z A S P M W | P W A M U V Z Y;S
A T B F Y K M Q I | B T A Q F I M Y;K
F H K X N Z C I P | C F X N Z I H P;K
Z J I P W N Y M B | J M Y I Z P N B;W
T K E F J R A U N | J A E U T N R F;K
M W T N I H X Y Z | I X Y W T M Z N;H
S T C D H A R L Z | A L D H Z S C T;R
Q S G Y D X T H B | Q X S T H G D Y;B
K U L P Y J B F H | H J U Y L K F P;B
W X Z Y O J I F G | O I F X J W Z G;Y
X L D M O Z F P W | Z W O M D L F X;P
V P Z J D S B T I | T S D V J B I Z;P
X D Q E U C Y P F | Y X Q C U F E D;P
V H X K Y J Z I L | X Z K J I V H Y;L
B M J F A C S E D | J E D B S A F C;M
J C T N W I M P L | W P N I L J C M;T
J Q W O C N V Y F | F J O V C W Q N;Y
O X U Q K E C A M | U C M A K O Q X;E
B L G S A J W Y E | J W L S B Y G E;A
Z Y P K O I Q G W | O Z I P Q K G Y;W
V A F T G Y Q O H | H Y A V Q O G F;T
U J I C T D Y L R | C L I D Y R T J;U
A E G S R V T J F | F T S V R J G E;A
K B I T U W O M R | K I W M T O R B;U
L U C D P Z I M T | I L P T M U D C;Z
E M N C A R S T W | W T R S E N C M;A
X G U E N M I J C | M N C I E G U X;J
H A T O X J Q P V | Q A J V X T O H;P
W L K B A T Q Z P | B P A Z W Q K L;T
C T Y Z E W M R N | Y R M Z T E W C;N
L D G I P C B W K | I C G W P K D B;L
K A L X M F V R B | K R M B L V A F;X
Q F S D B X R H G | D S Q F B H R X;G
N W L X U K E A F | U X A K L E F N;W
B L M X E J O P G | M O P B E J L X;G
R C F E Z X M Y Q | Z E M Y F C R X;Q
U A Z W G N R S Q | N W U G R A Z Q;S
R J V A F D N L S | L A R N D F S J;V
J G E I C Z L O X | C Z E I X L G J;O
P O M R B J K Z E | O R P J Z M B E;K
J U Y H B A Z X W | B A Z J W X U Y;H
J D T G U Y H B X | D Y J G T X H U;B
V S I G L U J E O | G U I O E S V L;J
U T K Z R I X N D | D R Z K N X I U;T
C T H B A G Y W I | A C I T Y G W H;B
W I A P C K E V U | K U E W C P V A;I
T G J N A B K O L | L O N T G A K J;B
Q J L O C F S X A | X S F A C L Q O;J
I U L W P N Z B Q | Z Q U B W I L N;P
L D U Q G X Z N F | U X F N Q G Z D;L
D R J S F E L Y K | K D Y S F R E J;L
U A E W Q Y G H T | Q U W A T Y H E;G
X M F Q U K G D R | F Q R K D G U X;M
Q S K R A G L Z J | A L S G R J Z K;Q
S D M Q N O R C P | R S D C M P O Q;N
V C B Y Q E Z J K | K J B Z Y C Q E;V
Z O Q M J T X G A | T A Q G J Z O M;X
M O U L B A J T F | O F B U A M J T;L
R J O A V Q P I X | O X R P V A Q I;J
G A B M Z K R E H | Z K E A M R G B;H
T D B Y J L K M Q | L T K Y Q D M B;J
Q R Z W A O E D J | Z D J O A Q E W;R
H M T R Q F O U B | B T H F U M R O;Q
E K S M W G N R I | N I R E W K S M;G
X S U W D V O B T | U B V S X D O T;W
B T C X Y W L Z M | X B Y M T W Z L;C
U L D M X T I F P | T P M U I X D F;L
K F X W V I E U G | K U X I V E F G;W
U N E W H D A G Q | U D A W G E N H;Q
S D C Q V G P W Y | S Y C D P V W G;Q
K P L F B W J G A | A W P K L F J B;G
X E P R U F Z A W | F X R Z W E A P;U
V A S X W H B M T | B T S V M X A H;W
P M L W I F C N D | L W P M D I F C;N
J W X H E R C P U | E C P H W R U J;X
B S F K M Q P R N | R Q N M P F K S;B
R Z O N I M C P A | C N M R P O A I;Z
C T P R L F A B Y | R L C P Y F T A;B
V C L X Y N T H A | C N A T H X V L;Y
U B L K P D J H V | V U J D K B L P;H
Q I E P G Y U F T | P E G Y F Q T I;U
R J O B G E Y L D | R O B Y E L J G;D
N V E O R F Q T U | V F N Q U O R T;E
D P T O F X N B E | B O P X F E N D;T
G S R M Q K C H D | C Q H K G S D M;R
X L G A H N S J Y | A G H S J L X N;Y
F U N O L R T B A | A L N R O T F B;U
I J G R F L H Y O | H L I F O G J R;Y
B W V Q A Y O J U | U B Q Y V W J A;O
A K R Y L G Z X D | X D K G Y Z L A;R
K Q O R H A Z B F | Q K B R A O F Z;H
J V L Y N Q R B O | O B N J Y V Q L;R
O S B F C Q I K R | F I K O S R C Q;B
W M I R X V Q C A | Q V A C R M W I;X
Y T F O W V I G M | O W F M V G I T;Y
W D B L K S U T F | W B L F T K U S;D
H F R W C Y E I G | R F H C G I Y E;W
F R V Q W B D O I | B Q O F V I W R;D
F D L H G Y A R W | D W R G H L Y F;A
M S B U X G I R K | I K X R U G M B;S
G Y R Z J F C N S | F C Y Z G S R J;N
D Q I V T P G C K | I V T Q C K D G;P
J Q D V N R E H K | E R N H D J K Q;V
S U X R G K A H Z | K U X H A R G Z;S
Q E S R C U W L J | S L E J R U W Q;C
B H Y P E S J D L | B Y D P J S L H;E
Z P Q E X N H G C | G P H Z E Q N X;C
H C O T Y B J A G | B J G H A C Y T;O
A G D O P Q N Z Y | O G A D N Y Z P;Q
O I V F G C X M B | M C B F X V I O;G
F R E T N J B V H | B F E N H R J T;V
B H O X G V Z Y D | X V B Z D O H Y;G
L A G B F K X U M | G B X K F A U L;M
U Y C A Q O V S M | U C A V Y S Q M;O
Z U R B J C S L X | R J L C U S Z B;X
U T Q W G K E F N | T G N F E K Q U;W
W H P Y N T K F R | H R N T F P Y W;K
G N L H K Y P O D | G P O H L N D K;Y
E B U H K M P L Q | H L E M Q K P B;U
V E M O J L H C K | V K L C J H O E;M
E G O I W C F X A | G C E O A X W F;I
Y B K P X E C R Q | K B P E Q Y R C;X
Y Z Q E J W I R B | I Z W E Q J R Y;B
O L J Q X G K E T | L G O T J E Q X;K
X H W Z C D V R N | D N C V H Z R X;W
M X A S R W I E Y | E Y R X W S M A;I
L A G Z M U E S Q | Q E S Z M L A G;U
L Y M O K G T E X | Y T E O K G L M;X
S Y Q C D V I O M | V I Y D O C S M;Q
Y W S F R J C M P | W R P F S Y M J;C
K A D F U R P B W | W P K D F A R B;U
W E C U R F O Z L | E U R L C F O Z;W
C Y U Z B D M J N | D Z M U C J B Y;N
V R M S X Y P D Q | X Q M Y S D V R;P
M P S J I B Y Q R | I Q J B R S M P;Y
E A Y G X D H K B | Y B G K H D A E;X
Q M V E W K T S O | Q W S T V E K O;M
M I Q N L K C B Y | M L Q B K Y C I;N
G L T B C R K U E | L K B E C U T R;G
V R U E A L X J D | L V J U E D A X;R
W R E X S K O Y Q | K E Y S R O Q W;X
W S A Y R P B J N | B P N J W R S Y;A
S L I D R C V N Q | S R V C Q I D L;N
U H K M E Q X I D | I H M Q E U D K;X
J R N H B D V A M | D B J A M H V N;R
H Z P B D Q T V R | T V Q H Z D R B;P
U S P H V R D O L | S D V O H P L U;R
I S V N F R Q Y H | H Y V Q S I F R;N
K Q Z A U W D I P | Z D Q A U K I W;P
C X N H O K V R B | B V K N R O C X;H
S U R Q I N J P D | R D I Q J U P N;S
C T K Y Q L S D H | K S Q H Y L T C;D
R N W E X B T D O | W B X R O D E N;T
Z N B Y K D A X F | Y K A X F D B Z;N
G T M K L Y Z S A | A Y K T M Z G S;L
C X P F W I U E G | P F X E G C U W;I
U B L S A I Y K Q | I K A Q L U B S;Y
W A C F Z L B G X | L W A Z X C F G;B
Z L C M A Q H I K | L Z K Q I A H C;M
P V I S W C T K M | K W T S V C I P;M
O H T G X P N B F | G N H X O F P B;T
Y T P I C B V G J | C B V G J I T Y;P
N T E J V U D G I | T N G J V U E D;I
K T Y W F H C U D | W T F C Y D K H;U
W X Z A F B H O I | F O W B H X Z I;A
U L V T J D K O E | D V O E L K U T;J
R L M I F D E C W | D L E M I F W R;C
S A X W Q C J U K | A J X K S U Q C;W
M U R E F L S V Y | M V R L E U S Y;F
N D Z C G O Q I U | Z N U O D I C Q;G
K T Z H I V B G D | Z B H I K V D T;G
Z K O A V T M U S | K A O U T M V Z;S
F N Z K M U W Y P | N M F Z Y P U K;W
I L X C J Q F A R | J F X A C I L Q;R
C F O T N H U P A | A H C U O P T N;F
I R M X H K C T U | K X R C H M U T;I
T D W J M B Z X H | D Z T M J W B H;X
S L Y T P G E Q K | Q K L T E S Y P;G
I D X P R E O V S | D V E I P X S O;R
X E Q K Y W M J Z | Y J Q W X Z M E;K
K A T X B Z V H I | Z A I X T K B H;V
D Z I M O G E J A | G D J M Z E I A;O
G X O P L U B V S | X B S L U G V O;P
B W K G O M H D J | J B W H D G M K;O
U P R H Y D X L G | H U R X P G D L;Y
Q M W L D E X V B | D W E M X L B Q;V
I F G T L V A D R | D F A L V R T I;G
I F D Z S P B K U | D I U F K B P Z;S
F N D J H P V Z Y | V Y J D Z P F H;N
L V K O Q F Y N X | K F Q V X L Y N;O
W M U O Q C V F R | F W R Q M O C U;V
T P E F O R N Q B | B P R O T F N Q;E
L O C T G Z R Y D | Y C Z R L T G D;O
V Q M R Y H T O K | M H V Y T O K R;Q
R B P G U E J S C | J B U C E G P S;R
B Z Q G D K A P L | D P A Q L B K G;Z
E A N R B K L Z W | B A N L W R E Z;K
U T M W V F C Y R | Y F M V T U W R;C
J K P A U C B W Q | C J Q K W B U A;P
V Y G D K J B C A | Y V K C G B J D;A
G A J D E T I H P | H A P E I G D T;J
H U T A B O E Y C | B C U E O T Y H;A
C P R U J O Q E W | O C J U Q W E P;R
C Z M J O U A S Q | Q U A J C O M Z;S
H T M G Q V J O I | G O T H I M V J;Q
N U D Y B X L S R | U S R D X N B Y;L
G Z D N Q R J T M | Q T Z N G R M J;D
E H R N K Z C I M | C H M E N Z R I;K
J V M Q U H R A Y | U Y J M Q R H V;A
F Q P A Y Z W K H | A Z Y P K H Q W;F
G P F S A Q T K J | S J F T K P G Q;A
C U Z R E Y H P I | U E H Z C Y P R;I
O L B M I F P N Y | L Y P M I B O F;N
C T B Y K J O Z P | P B T C J K O Y;Z
Y H J S D Q C I K | D S H Y C J Q K;I
Y T A G W H N K Q | T G A H K Y N W;Q
C N Y E Z B U Q J | N E Q J Y B C Z;U
W L R J S D O V F | S O D V F L W J;R
N J H D I A K Q Y | Y Q K D A N J I;H
N X W F Y C A S R | Y N W X A C R S;F
O W Z S B T Y L A | T Y W S Z B A O;L
W T C F R S B K I | S I B F R W C T;K
Y V C I S K W G J | G W J S I Y K C;V
C O A M X D S U L | A L O X C U S M;D
F I V J O T L W G | F V G L W O J I;T
H X F I S Y T U C | H U F C S T I X;Y
H Q N Y T L K G W | T N W H Y L G K;Q
Y C A K F B X S U | F C B S X U Y A;K
N Z M I G R S B H | H B I R N G S M;Z
G O A F L C D P B | P G L C B D F O;A
S W L E F P C M R | W F M S R E L C;P
Q N C G J P O M F | G M N F Q P C J;O
L T D Z R M X S B | D X S R Z T M L;B
V G F N Z O K A R | G R O F Z N K A;V
M O R Y U S A V Q | Q S O Y U R M A;V
W G F D Z M T O P | M W O F G Z D T;P
Z L K X B W Q M P | W Q L P B Z M K;X
B U I Q J W M C T | I M W C B J T U;Q
V K L P Y R N U B | R P K V L B Y U;N
K J E A T P Q V R | R A V J Q E T K;P
X P Q V G A S W J | G P S J A W X Q;V
D U Z E F R G Y P | G R P Y D E F Z;U
T M V X Z G L R C | G V L R X T Z C;M
Z H A B R V F S D | A Z R B F S H D;V
T K N V A L B D C | N D B A T V K L;C
D F J H N G Z W X | N W F J X H G D;Z
P D K E Y J I G H | K D P Y I H G J;E
X I J H Q L W O S | X J W L S H O Q;I
G K M N Q H A V Z | K H Z N A V M G;Q
N Y M R O J C P Z | C O P M J R Z Y;N
Z I K T M E P D J | D M I T J K P E;Z
E G L C K X M U B | L G C U B X E K;M
Z M P E A D J Q I | M J Z I E D A P;Q
Y V A Z H Q B T P | V Z A P H B Y Q;T
X E T Y C M N S W | M X C W N E T S;Y
W J C L S P K Z O | O C S K P J L W;Z
M C I T L B S P Y | L S T I P M Y C;B
Z X A B D Q P U C | A X D B C U Q Z;P
A J Z Q W S L I U | W L Q J A I S Z;U
D W K Z C H F J X | Z D X W K F C H;J
C Q F L W H O M P | L Q M P C H O F;W
L G A N W E J F H | G F N J E W L A;H
T Q F I W G R V O | G I O Q W F R V;T
T O L R P V F N Z | P O Z R V F T L;N
W S I B Y U T G E | G Y I S W E T U;B
B F V O Q X C S W | C W X V S O B F;Q
Y W U B T S E C L | W E U C B T Y S;L
P R Y Z Q X W D G | D R Q Z P G W X;Y
L D R F S O N U W | R L D S O F U W;N
E F A T S O C R L | F T A L C R S O;E
D K F V Z P M L X | K V M L F X P D;Z
A I Z P V T L Y M | Z A I L M Y T P;V
Z T G C R F D Y L | T D R Z F L Y C;G
K M E V P G H F N | N E P M G H F V;K
H W Q N D I P K M | K I N H P Q M W;D
V G Q U C D S N K | U N S K V G D Q;C
K O R W C N P Z Y | Z R N O Y K W P;C
J Q L Z B V O D F | J Q O Z B L F D;V
V A F R P B E W Q | P E A B Q R W V;F
G N E P D S J T B | P S E G B D J N;T
I Y O R C A L B Z | L A I Y O C R B;Z
N X I R F V M Q U | M F Q X R V N I;U
A Y D F R S H X M | H X F A Y M R D;S
K C F J R D T H X | K X J D F R H T;C
T K B E X P S I C | C K X B S E P I;T
S O B U I R D C Z | I B R D U O C S;Z
F Z N S A K E H C | S K F E A H Z C;N
E P J T H C R W K | P R H E C J W T;K
Z W V B J L S M R | Z M V B J L S W;R
H G T J L M Q X N | N G M T Q J H X;L
C X J I O K E F U | X C K I J E U F;O
E J S Z V T W U B | B E V T W U S J;Z
C Y K A B L E F T | Y L A T C F E B;K
P J G T V A U O E | A T V G E P O U;J
B I M X A H Q N D | D I H X B Q A M;N
Z W J L C G V O A | A G C W O V L Z;J
X B W P F Y Z T I | F P T W Y I B Z;X
U I D S Z L T R C | Z C R D I U S T;L
Y O A E H V R T Z | R T H Z A Y O E;V
O S A Z J E Q T Y | T Z Q O E A S J;Y
P H M G T D C Z O | D P O C T H G Z;M
V L K Q U T Y F G | U Y K V F G L Q;T
P H Y X O K B Z T | T K O P X Y B Z;H
C W U A F P R L Z | A Z F R U W P C;L
E S N C G K O B P | C G B E N P O K;S
T W F U L V O B M | B T M L W U O V;F
A H B X J Z N M Y | Y M A N Z B X J;H
O B W A U H T N Z | O U N W T B H A;Z
E P V X F D I L C | F C E D V X L I;P
S Y I A X Z O J L | X L S A J O I Z;Y
E R Y S O J I G W | S W O R G E I J;Y
P A H B I E W Y U | H I P U B E A W;Y
H T G P O Z X I Q | O Q T X I H G P;Z
H M C J G D B L O | J C D L M H B O;G
T W V S R P N C Y | P W V S N T R Y;C
S R A N C H D V Q | R C N D S H Q A;V
W A P D S O V X Q | O X Q V S P W A;D
Y Z C A E V I D G | C E A G D Z Y I;V
F G A C Z D W M S | G S D A Z W C F;M
F S N U B T P W L | W P S F T B L U;N
H A G Q S K N Z R | S Z Q G N H R A;K
V K E O W M X R G | R K X O W M G V;E
I B Y E Z L J P S | S L E I B Z J P;Y
G Z D O I W J B H | I D G H O J B W;Z
E S U H J Z K Q A | U A Z K S J H E;Q
I F T H O S W E G | E G T W F H S O;I
C U G J H I Q S A | G A I C Q U J S;H
Q Y C S J O H F X | H J S O C Q F X;Y
X S C Q W Z F K J | C Q K F J Z S W;X
D I V M Q W Z T X | D X Z W Q M T V;I
M T G I Q J N F H | N J G T Q M I F;H
Z D M C O A X G T | D C M T X A Z G;O
Z A P U G B K T D | K T G Z D U A B;P
C V W H J S Q B E | S H B E Q J C W;V
M C P T F V I Y O | I T C O P V Y F;M
P U Q J Z G E T R | G T Z J U P E R;Q
B Q X V S A O R L | O X V R A S Q L;B
L W U N D K Z R Q | L U Z D R Q N W;K
I M P L X V A D B | D I X M L B P V;A
D E I G N Y W A P | I A G Y P E D W;N
B D I H Y R N P Q | Y N R B I H P Q;D
A P W S Y E J I X | X E I Y S A W J;P
L W N T C Z R K F | F T N K W Z L R;C
V R T P B L U H C | B R U L H C V P;T
L X Z Q C P F K W | W X P Z Q L F C;K
Z P U T G R B J O | B G P J O T Z R;U
N R O Q F K B X H | N H O B R F X Q;K
Y U Z N V M Q I E | V Z U Y I E N M;Q
K U Q A I F V Y B | B F Q V I A Y U;K
B N Q C S J D O E | J O N D Q S B C;E
U E F X K V Z J I | F Z V K U J X E;I
U Z Y Q S R M J I | U J S Z Y M I R;Q
T E N P L D C M W | C T D P E W N L;M
U O X Q L D J S F | D S O Q U J X F;L
K M X Z C L J F T | L J X F T M C Z;K
O A W J S U D F Z | F W O D Z J A U;S
C M U J T V G Q N | N M T Q U J C G;V
P Q S C J W F L A | P F W Q L C J S;A
Q K M A D S P V G | K Q A S M P V D;G
W L D V M X R F S | D W M L S F R V;X
F Y Q R Z U T X W | U Z W T R Y X F;Q
H E V L G D I Y X | I E V Y H D L G;X
U F K P M A R L N | A R L M F U K P;N
Y W H B I A S G X | W S B X I H Y G;A
R U Y W O M P J C | O R U J C Y W P;M
I J R G D Z O K W | J R D Z K I O W;G
K E Q B I W U D C | D C E K Q U I W;B
M X E G O R H Z N | O Z R H E X N G;M
M Y A S N I T G H | I Y A M S N T G;H
A I Y H U G Z T E | E U H Z T I G A;Y
W O Z H T K C X Y | O H X C K Y W Z;T
U P I S O B A C E | C I A S B U O E;P
E P A Z J U Q H G | U A G E Z J P Q;H
U S V M Z N L X J | S V U N L M J X;Z
F K N X J A W T P | A P J X T K W F;N
D P B V Q R I Z E | Z B I P E D V R;Q
I W Y T L E Z P H | T I P H L Z E W;Y
D U E F H Q S G I | S Q U H I E G D;F
P A K Z U G R V I | U G A R Z P K I;V
C R I V G Z Q Y A | R A Z V C Y I Q;G
C J A G H S T W X | J G S H T X A C;W
N D T V B Y A O H | Y A T D V B O H;N
N T Q X O K C F Y | O Q T F K Y X N;C
A J Y F W Z H V D | V J H F D A Y W;Z
Y O A U Q N Z K J | N K Q Z J O A U;Y
M Q I X Y F D W S | I Y X S F W D M;Q
L D T B E X M I O | I L X D O B E M;T
M R G J X Y Z O S | S J M X R G Z O;Y
K F J Q U S R Z V | U R V Z S K J Q;F
Z T J I S M E Q G | S T Q Z I G J M;E
B L X R P W O F Z | L O W Z X B F R;P
H F U N V B C A J | V B H A J C F U;N
B J L H Y U M Q S | B Q J L H U S Y;M
F R Z S A G W O U | S A U W R F O Z;G
E Z A B P H M O T | A O B E T P H M;Z
R D E I U L C V N | I L C D R V N E;U
K C I H P G Z M A | M K H P Z C G I;A
Z M Y G W B C X U | G X Y C M Z U W;B
U H J O K G Z B Q | G J Q H U B Z K;O
L P J Q H E D T U | J P U Q E L D T;H
O T W D F K S H A | O S H F A K W T;D
K D I A O H N V R | I V A D O K H R;N
Z S G K T Q I N M | T I M K Z S G N;Q
L C F V K I T Y O | C L O I F T K V;Y
A F H J W C Q Z L | L W Q H Z J A F;C
Y J F W N X A Q C | A F W J Q N X Y;C
P U W I Y D H L M | I M L H Y W U D;P
L G D C W Y V Z P | Z C V G L Y P W;D
W U L S E Z O Y P | P S Z L E O W Y;U
Y P L F J E M Z R | Y Z M L R P F E;J
Q R D X P Y E U G | D E U R Q X P G;Y
L M U C N J Q G Z | G M U J Z C N L;Q
J N Q H R E O C S | Q C N S E R H O;J
I M F H T O Z D J | I T Z O H F J M;D
A G Z O T I F Q V | A I F O Z G T V;Q
T W X P Z F O V D | W Z O D P V T F;X
T X C H I R E K V | C I T E H R V K;X
I R V A O B Q P Z | O Z B V P I R A;Q
L R K C Q E G P U | L R Q U G C K E;P
G C K N T O X J A | O X K G T C A N;J
I P H U G S A D O | O U G P D I H S;A
Z F A N I U K P H | A U I H F P N K;Z
P M G K I R U E J | E U G K R J M P;I
K H J B I E X P R | I X H J P K E B;R
Y B O G N L S X Q | O Y L B Q N X S;G
N Q O P E F G X V | N E X P O G F V;Q
R C B G F D N M T | B N F R G M C T;D
V G A F R I S B O | O R F B I G S V;A
P U X E I W Q V M | U V I E Q X P W;M
X K R M S U L Q A | K Q X A L R U S;M
M Q U Y S E J K B | S E U B Q M Y J;K
V M P I J R D Y A | A M V D P I R J;Y
O K W Z S D M T V | V Z K S T O M D;W
Y F Z W M S O A D | A S D O Z W F Y;M
V K F D W E G S R | G W K D R V F S;E
C J L X D T G Y I | T Y G X I L C J;D
P F U O H G N C M | G U N H C O P F;M
G O M H W Y T X Z | Z T Y G O X M H;W
H T D K A Y L G R | D Y A R L H K T;G
O J H Z E G M F I | F H E G Z O J M;I
B M X P R H I U D | H I M P R U X B;D
U T A F Z E B K G | T A U E F Z B G;K
F J K O S N U H Z | Z N S H U K F J;O
G E P F O M U K S | M F O K G U P E;S
L V G T I J W A O | T G A J W I O V;L
E Y U A I L K X M | K E I M X A Y L;U
H K I U E W J D Z | W D K I H Z U E;J
A Y D S T N Q P B | P B T Q A S D Y;N
X B V L K W J Z P | L Z J P X W V K;B
A J V B T P R K H | H R J V K A T B;P
G J Y Z E M Q L S | Z Y M G E J L S;Q
V B C Q A R M Y H | C Q M R B V A H;Y
W F H S L M X V I | S X W L M V F H;I
O H C S J W D X K | X H D J K O W S;C
B A K W Z R F G I | R I W F G K A Z;B
R Y B O G C H L D | G R H O L B Y D;C
V K T O M I R H W | M I H V T W O K;R
J R L F Z N V K M | F V M N L J Z K;R
F Q J R O H K C M | O M Q F K J C R;H
R J N C E H Q Y A | Q N C H Y A E J;R
Y C N H B F R K Z | N Y Z K C F B H;R
H O K J D T E G Z | K Z G T E H J D;O
Y Z O M X L P H Q | Y X M Q L Z O P;H
U R P C M T I J Y | R M I J C Y T U;P
A P X I O F B C M | C A F P B X M O;I
G U S B J R K N D | N S U G R B J D;K
N Q R B I P C F M | I F N C R B M Q;P
T U G Y W B L X R | G T W L Y B R U;X
S C E F U O M R D | D E S F C U O R;M
A X V R M C T B G | V T M C X A G B;R
J R Q H F D M K I | M J H R K Q F D;I
Y K A O N J X Q E | Y J A X E K Q N;O
C A E D H L W Y P | L P W A H C E D;Y
W D I K J F U N Q | J U W D K N F Q;I
I W C R D U G F J | I R W U J F D C;G
N R I M S K U G E | K E I N S M G R;U
X Y V L O W H P B | P H L O B W Y X;V
Z M T D S J I U K | M J Z T S I K D;U
M B S E W D F Y I | E B I F W Y S M;D
W H D L J B K G Q | J Q L W D K H B;G
V X Y Z D U W L G | X G V Y D W L U;Z
W B Q C X H U L J | B J C Q W X H U;L
R I Z L O E F Y V | I L E R V Z Y O;F
Z X P S R E M I L | R I X E P S Z L;M
B S W X M T R H N | X S T N M R H B;W
T P J G Z B F Q L | P B Z J F L Q G;T
C L T I F O W N S | N O F T W S L I;C
E K J L T S W M I | W M K S I J T E;L
Z X F S M V Q H U | M S H X Q Z F U;V
W D I Z V F C X S | X D I F V W C S;Z
R Q O M T K U X I | Q O R T U K M X;I
X S V K W I G M U | S U K M G I X V;W
M P B R A K F U C | M B U P C K F A;R
U K V Q M R J Y D | Q U D Y J M R K;V
N M F G Q Z T J R | T G J N M F Z R;Q
Q V P S F I N L A | A V I F S Q L P;N
K M Z B J O W R C | Z C W M J O K R;B
L G S U H P V O R | G H S R O U P V;L
Z C R V O G M F I | R I M F V Z C G;O
B T W F N V K L Z | K T B N Z F W L;V
S L H N O C F B J | F O B C L H J N;S
V O Y F Z X M I T | M Z F X O I T V;Y
W R A S P J D Z G | A J W G Z R D S;P
T M C Y H V S I R | H C V M S Y T I;R
Z U C Q V D X P I | P I Q C Z D V X;U
L X W H Q T I D B | W H Q D L I T B;X
J V W R X Q Y P Z | J P X R Z W Q V;Y
Z F A D S M L H O | A H L S O M F Z;D
L D G B X H Q Z E | E L X Z H B D Q;G
T I K Q C B Z H E | H I C K Z Q E B;T
A Y C R N S M W U | U N M C W S A Y;R
M Z I P Q N W R D | P Q N D W R I M;Z
T U S L C H X Z R | R U Z S L X C T;H
C Q P N F H E I K | H Q N I F E K C;P
K E I V X P Z U M | P X E M Z I K V;U
E Z Y J A X I M H | H A J Y M Z E X;I
G R K S B N F E X | S G R E F N B X;K
G H O S Q K N X M | S G H X N K O Q;M
R F Z G X Y W J C | F G W C R Y Z X;J
I B Q P H V Y U G | B I U P H Y Q G;V
J H P K S B L I Y | S Y K I L J B H;P
Z Y T B F X R K J | X B J T Z Y R F;K
C D Y P B N K I S | N K C D Y I B P;S
X H R G Y S F U E | X H R G F S E U;Y
P V E T J L W M Q | E V J Q M P W L;T
E K X R W T F S C | C E R F K X S T;W
W F J D N V I X K | F N V W X D J I;K
T N B J I O C M R | O M I T R J N B;C
E A K U J S G Y F | U S A J K G Y F;E
D Z C H A J M N P | D A H Z P M C J;N
J K N V Y C P T I | T C V I K Y N P;J
R U E W T G H Q D | Q G T H R E W U;D
B N F W X S C R T | N C X W S F T B;R
D W K Y X J Q R E | K W D X J Y R Q;E
X I N R M C Z D W | N Z M X D W I C;R
P I W A C O F D E | D F W O I C P A;E
E X M S L J H K T | J K S E X M H L;T
C I F R V G K E D | D E G K I V F C;R
O Z B P X Q Y D E | Q P D E B Y X Z;O
Y D S M T H I R L | I H S D Y L M R;T
K Z P O F B I V T | P F V O K T Z B;I
W P J S Z I A R Y | R J Y Z A S P I;W
V Q E B M J C R L | J L E R M C V Q;B
X A M Y N K B V O | X V Y O K A B N;M
H T A W E K F P X | A P K E W T H X;F
X M N Z T V B U G | B G T M X Z V N;U
H M D G U V K N I | G I H V U N K D;M
W J S I H T U O X | J X W T O I S H;U
V Y T K I X Q C F | I V F X K C Y T;Q
D S Z N H W L E I | W H D I E N L Z;S
G P B C K Z Q F A | K Q G C Z A F P;B
K V A D N E B X Y | D V X K Y A B E;N
L H F Z R Y T G O | Z O L F H Y R G;T
T G N V J W F M L | J V N T M F W L;G
O V H Z K E C L P | E L O H V Z K P;C
I E L W B P A D U | U A D E I L P B;W
G F I U O T R K W | R W U O K I F G;T
Z S A N M T K Q P | K N S Z M T Q P;A
W V Q S N J B H D | V S W J D B N Q;H
A Q S B N F R K I | I A Q K N B F R;S
H N C L E X B Z I | Z E X H B L I C;N
S E X H Z N O A P | P H E N O S X A;Z
G E Z P R H T Y A | T P H Y A R E G;Z
V W N P R J M Q E | N M P E Q R W V;J
L C A N E F Y B S | B S F N L E A C;Y
K B T J Q R M V Y | K T V B J Q M Y;R
U M X N R Y D B E | Y D R U N X B E;M
Z D V U K Q O F I | K U Q F D Z I V;O
S B F T U K L V M | M L T F K V S U;B
D X N P S F H U C | F N P H U C X S;D
Q N P L J K B O R | O N J Q P L K R;B
E I Z T K V N G F | F K T I N G Z V;E
X G W E S B H L M | G L W B M E X S;H
B R T M G P E C D | G B T M C D R E;P
L G H D J C W A F | W A J F H D C L;G
Y Z Q H K O W C S | K Y Q S W O C H;Z
E X M T S J H F G | G H S X E J T F;M
O S D B Q X Z M W | D Q M O W Z X B;S
Q K S I A D M Y T | D K Y S Q A I M;T
G I X U M Q H C S | X C M U H I Q G;S
M N R P W K Y F I | R K I F P N W Y;M
X L F A B G C V K | L G A B K X F V;C
J Y S T H Z E R X | R Z T X J S E H;Y
A W Z Y R C D T U | Z D T C W Y R U;A
G E A M F W K R L | M E G R A W L F;K
L J M Y F B Z P G | Z J B F G P Y M;L
D S Y L C U A I K | C L K D A Y I U;S
S Z O C B W N Y L | Z W B C L N O Y;S
Q N O Y S M L I K | N S Q M K L Y I;O
G Z X T C M F Q J | Q X C F G Z M J;T
T D H F M Y Q R A | D M A T H F Q R;Y
I R T X A D U C F | U T C F X D I A;R
B S E M D R C J O | S E C R J B M O;D
N W B U E A H L J | N B W A E L H J;U
O K G I N E Q P T | N E P O T Q G K;I
M V G S R A E W J | J R W A E G V M;S
Q B Y M J W L O V | M Y B Q O L V W;J
N K U G L H Q W J | K L W G U H Q J;N
R L N Y F E M T G | Y F G R M L E T;N
Z Q P U L W T V O | L P O T Q V W U;Z
Z M K N H C T A S | A S T M N Z K C;H
B D Z W F H I O U | Z F D B O W U H;I
J Y S Q G L N C T | C S J N Q G Y T;L
C S Y E Q H M V X | Y S C X V Q M E;H
H E U D V Z X N W | V E D W H X Z N;U
O J B P Q R T F S | R F T O J B S P;Q
M R Q Y K D G S F | Y K Q G M R F D;S
Y G A M H P E W N | E H N A G P W M;Y
B N Z U Q K E F A | K E N F U Q B A;Z
B V F P X S A O C | O S B F V A P X;C
C J Y R Q P S W T | R Q J T C Y S P;W
T H N P F I Z B X | B F I H X T Z P;N
D W P T G I A E Y | A Y I G D E W P;T
L J V W G I X R T | I J T R G W V X;L
B D A Y X U H P V | U V B D H P A X;Y
J A N K Z F M S I | Z K F M A I N J;S
W Z A B Y E R Q L | Z W R A Y L Q E;B
T O A X Y J Q L S | L X O Y T J Q A;S
D O N P X T I Y K | T K O P I D Y X;N
F E W Q P S J U C | C J Q S E W F P;U
R Q Z N I U T F W | Z Q W I R U F T;N
O B Z Q Y T E N H | N O H Q T Y Z B;E
G C V U A N R B W | G W V N C U B R;A
F L H U S Z E D X | U H X F L S Z E;D
B W T C F U H G Q | Q C U W B H G T;F
W T O U R Q A L H | Q H T R A U L W;O
H R X W C O K G B | C K X H O B G R;W
R M U F A C G O Q | F O U Q M G C R;A
Y S M H T W Q V O | H M Q S W Y O V;T
W K L G D B J Y O | J W Y K G O B L;D
L C G H A M Q W Z | C G Q L M A Z W;H
U Q E T I B F G W | F T I U W G Q E;B
E F Z Y J W M R T | E R J Z F M Y T;W
R Z M Y V L K S N | K R N V Y L S Z;M
K A M J O B Y C V | V M A C Y B J O;K
H I F P L Z O T M | Z M I L F T H P;O
L A N U O B F G W | B L F N G A U O;W
E N Q Z M C S U O | C S O M Q E Z U;N
R N E L T U Y J O | Y N T O U E J L;R
U E H Z R O V I A | I Z O R H U V A;E
T X I N K G W L Y | I T X L G N Y W;K
W Q B A U L K D F | W Q B A F D L K;U
G R C H L W O Y M | C W M Y O L R G;H
L K G B Z W T M Q | G L T Z K Q M W;B
G S U K T O Y Q F | S G O F K U Q T;Y
I V O T G X W Q B | I G X T W O Q B;V
F G M R P H W C J | C R P J W G M F;H
M B F V C R D Z W | C W M V D Z B F;R
V L P F K C E G D | P D K E L V F C;G
H R Q J U B D Y L | D Y H B L R Q J;U
P A H O L N W F B | W N H L A B F O;P
N S W H X P O E I | E S W I P O N X;H
F W K D Q A Y O G | F W Q O K G A D;Y
L J H B Z D Y N U | D J L Y B U N Z;H
V S Y R O M F N T | F M Y R O S N V;T
I R K G E S H N W | S G E W I K N H;R
I D F M S N Z O E | D I O N M E S Z;F
M I E X T Y H K C | C H K Y E I T X;M
R E J P U T Z Q N | E J Q N T R U Z;P
C O X M F P T Q G | P X O Q T F C M;G
G Z W J Y L A U O | L Y A U Z J G O;W
U W T H L S I Z Y | W L I Z Y U H S;T
L V C K Z F D I N | I C Z N V D L K;F
B N G Z I Y C F V | F Z I G V Y C B;N
U J O P Z Y D G W | Y U J Z P G O D;W
I M J K S L V A X | M K A I S V L X;J
T I Q S G C J A F | A T F S Q I G J;C
K E D S J Z V G H | H S E D V G K Z;J
K A Q T V D E C X | C Q A X E D V T;K
Z B U N C E D A Y | E A C N D Z U B;Y
T F L Y Z A C H P | C F Z P L A T Y;H
W P X U B N S Z G | Z B X U S P G W;N
W N K C V J L S Z | Z K J L V C W S;N
C W O Y D G X R N | N Y X G W R D O;C
Y W O C B E U X M | C E M X B W U Y;O
A Y W I R P U V Q | Q I P V U R A Y;W
M I K C E U D R A | C E K M D U R A;I
N H D E X F Y J G | G E J N D H Y X;F
S A T G C X R L E | C A E S R T X G;L
G Z F O Y P U I A | U Y Z P A F O G;I
C X B G Q N A W Z | B W X G Q C Z A;N
V L O Z W P U F Y | V U F W Y O Z L;P
Q S L H K I B V R | K Q V L S H I B;R
Z D A P H L U J E | A P L E U Z D H;J
B M Y F H J S W R | M Y B F J H W S;R
V N B L G S Z D Y | L Z G Y V S N D;B
D P H A Z Y M S G | Y P A H M S D G;Z
F E P D Y V Q K A | K D P Q A E Y F;V
N Q V M U C Y I B | V Q B I C M U Y;N
W N A U R D K Z G | R U D A K G N W;Z
W G T F K Y R D S | D K Y F S R W T;G
P L V D A I F U E | I A U E V P D F;L
R E F T G W C V K | K C V R T G F W;E
T E A H J X B F Y | F E A T X J H B;Y
E W V I A R O X D | O A I V E W X R;D
T K G O F U Z W P | O F K Z T P U G;W
S W R A T F P M I | F S R A M W I T;P
E D T Y O Q C F M | T Q C M F O Y D;E
Y L I J W Z H R V | J H R Z V W I Y;L
T A W F N O M B J | J B A N T F M W;O
A Q N I E W P F D | I E P N A W D F;Q
C N P E W Y A U H | N U P Y W E C A;H
I H M N E Q C R U | C M R Q E U N I;H
Y C O A U T G K Z | G T A U O Y C K;Z
L V X J I R A H F | V A I F J R H X;L
Q W V S K X N R U | W X Q K S N R U;V
U V C W F B Z E Q | B C F U Q E Z W;V
N M U W J G V C S | J V W M S U N G;C
R B P G C X V F O | G P O B C R X F;V
Z B I U L W K P G | G K B U Z P W I;L
U N O L C K W V X | K X N O C W L V;U
A N J R D P B T U | P U J R A N D T;B
M R U Z S W H F P | S M P R W H Z U;F
O T A Y C M E Q J | A E J Q Y T M O;C
K V D I U X F Y O | V X K O D I U Y;F
J A G X H V P K F | V X P A F G K J;H
I C W R V O J Z K | R J Z I W K C O;V
P H C Y E D V B K | C B Y K H V P E;D
H E M G I J Z K C | Z K C E H J M G;I
P W C M E B K T Z | E T C Z M P B K;W
S B U D H M Y A E | B A U E M Y S H;D
S I F B X J C Z M | F S J Z B X M C;I
B L N I X P U E R | R U X E L N I B;P
B Y Q L X M N A I | L I Y Q A B N X;M
L B D M W A U I V | I V U A B W D M;L
I P J S O X Z C Y | I C X Z S Y O J;P
E V F Q O N Y L C | L N Y C V E F O;Q
N G Z A C K F R L | L R C A K F G N;Z
L V C M W O T E S | T M L C V W S E;O
X A O E P G V S K | P G K E V O X S;A
R L B Q T Y F D X | B Q T Y L D X F;R
Z V M N C Y T O A | O V M Y Z N A T;C
F V E H W M A D X | H E A V M D F X;W
M H Z K F A D U V | D Z V H M F A K;U
R L T D J O B G Y | J B Y G D R O T;L
O D B M G H K I A | O G M A K B D H;I
N S V O M R Y W I | N R Y W M I S O;V
S V O H F N X W Y | S Y W V X N H F;O
N M C J G O R K Q | R G N C O J K M;Q
D V F J G N T S X | F X G D J S T N;V
A B H Z Q S V O E | B Z A V Q H E S;O
H Q S R F X T G K | K X S F G Q H R;T
E D H A N L F O S | A F H O L D S E;N
B R U Z H S J G I | J I B G Z R S H;U
W T F H O L A Y E | O F H Y E L T A;W
Z S N R P C X I E | C S P R E N X Z;I
E O S Q Y L K U I | K O L E I S U Y;Q
L Y V K R B P Q S | S Y P B Q L K V;R
K O L V U T C H N | K T O N H U V C;L
C S L I E Y X U J | I C S Y U J X L;E
R B N W T H Z D P | B N Z R H P T W;D
F Q G P Y C Z X L | G Q P F C Y X Z;L
E S U D M G F K I | I M E U K G S F;D
T M W N L A G U B | N G L W T A U B;M
M Y J C T H G V F | V F Y G J M T C;H
A Q T F L P J O H | P Q F H O T L J;A
N X O F H S P Y C | F S C X P N H Y;O
E G U J Y A B X V | V X A U J Y G B;E
S M I W C K F N L | C M K S I L N F;W
V P M J H A K F Y | Y M F V A P J H;K
Z B K W C F D M T | T W F M C Z D K;B
T M X Z S F K O G | G Z M K O T X S;F
R L N Y M V C J F | V R L Y M F C N;J
F P T H Y D M X B | P H Y X D F M T;B
E R I D M H O F Y | O D M Y F H I E;R
Q V T N Y U K B R | T Q Y U K V R N;B
S H F P I N G M D | N I F H G P M S;D
F J M A O S D P H | S D P H M J O A;F
C V M T W P Z H S | C T W V M H S Z;P
S Y J H K X A Z P | X H P Y K J A S;Z
D P J U Q K C O V | Q K V U O D P C;J
A R B Y V H D U L | A D Y B H V L R;U
S F I O W Y Q L U | L I Q U O Y W F;S
S P X Z F E Q U D | S D X P Q U F Z;E
F O T I L Q X S W | O Q T X F L I S;W
Z S O A H C L D V | O A Z S C V L D;H
A V Q J M Z F Y G | G Y M J F Z Q V;A
D E U V I R S K F | F S U V K E I R;D
V K O D Q L W U M | L D V O U K W Q;M
L Q E D T V O M U | O D E T V Q L M;U
M G H Z E R B K D | M K R Z E G D B;H
Y D T O W G U I E | U O W T E Y D I;G
Q O K A M L Z F W | Z K A Q O M W L;F
U F Y B K Z N C I | C B Y Z K I N U;F
F J E K T X Q N C | Q N K X E J C F;T
B J W I O Y E C X | Y E I J C W O B;X
O C H X L F D Z W | C H W D L O X F;Z
G H X J R N E B S | G S X H N E B R;J
H X P Y C N M T K | T K X H M C P Y;N
I A X Z P C V N F | P V A I X N F Z;C
B G Z D Q K J S L | Z G J D Q L K B;S
A H B C G W Z I V | G W B Z I C A H;V
L U I R X S Q V Z | L X S R Z I U Q;V
P S K M O J C I H | I P K H C J M O;S
X B P L Z J C O V | L P C J O V Z B;X
E S H K U T N F D | H F S U T D E N;K
D O N L F A T P I | A T L I N P O F;D
V N W S A I F O L | W V F O L A N I;S
M F U E R I A D G | M D E R F U G A;I
S B I H K C Q W L | I Q W B L C H S;K
X D P B S Y U A F | P D F A X B U Y;S
D K J V O E Y C P | Y E D O K J C V;P
Y R O G H T J Q D | Q Y H G J O R D;T
R S C B W A E Z O | S B Z O E A W R;C
C U B T E L I S J | J B L S C I U T;E
I T D S F Q O R V | D S Q V I F R T;O
J M T Z C A R H S | S H J M Z R T A;C
C D Z M S Q L T G | M L S Q D G C Z;T
R X H U W V G L O | G V R W L H O X;U
I O N H T C L B K | K L T B N O H I;C
P C X L F R E H V | H R E X F P C V;L
A Y J V C S O X R | A Y J X V O C S;R
T W V N H O U D F | H W T V U D O N;F
B H V M Q C N P A | N H M V C Q A P;B
A K O W V M I Q B | K O M A W B I Q;V
U S R B W O Z D H | W U S O D B Z R;H
Z T C J P K Y Q L | K Y T C Q J L Z;P
L Z J V D H Y F R | Y D V J F H L Z;R
M W V O R B E D Z | B D W V O E Z R;M
X I Y R N H S G L | S L I G R H Y N;X
E A I M B Z Y P V | Z P A I B V Y M;E
L Y E T K A B I M | M B K A Y T L E;I
W N P S H G A B Z | W S A Z H B N G;P
J O V E C M G L X | X E M J O C G V;L
O B A M G Z H Y L | Z A B L O Y M G;H
V O L C Z Q F B R | B L C O R Q V F;Z
O C H S N B Y E V | B H Y S V O E C;N
L C S U Y H Z A P | H Y C P A L U Z;S
Y T Q U V F W M A | Y T U Q M V W A;F
O G K C Z M P T W | T K C W O M P Z;G
Q T J S U A G V L | J T U L Q V A G;S
X D A O Q W Z V K | W X Z D Q K A V;O
K S A M B W Q V C | M C Q K S V W A;B
E T Z S W X O U Q | T Q O W E S Z U;X
D B Q A G Y V E P | V A G D B Q E Y;P
U X D R L M T C G | R D G X T U M L;C
M C U Y A I R H T | I H A C M Y T U;R
Q Y A B T V M L E | E Y M V L T Q B;A
V M R X Z F H U G | G M R F H Z V X;U
M E N P V H U J F | N U F P V M H J;E
D Z S R Y G P F X | P F Z G R D Y S;X
Y P I M N Z K U A | N Y K U P I Z M;A
G F Z S E T D U C | S Z G D E C T F;U
K M A Q D B Z P E | B M Q D E A Z K;P
C E O I K M W U T | M U W C K T I O;E
K G U X O E Z I A | I G X K O E A U;Z
P Q W H N Y D V G | Q W H G V Y P D;N
I Q C H S N O Z M | I C N O H M Q S;Z
V H K L T C O P Y | P Y H L V C T K;O
D W N Z J G A P B | B J G W A P D Z;N
V Y F P T Q X S U | U T Q Y P S X F;V
K Y S F G R W T Q | K G F Y W Q R T;S
K D I O P Q X G B | D K P I B G O X;Q
T Q J U B F G Z X | Z T B X F Q J G;U
V O Z E W R M N B | N O E V M Z R B;W
Y N Z E J D O U F | E O Y F N U Z D;J
L P U J N C V R Y | Y U C R J L N P;V
V J A F S H P K Z | J Z V K S H A P;F
P V R Y I H M F D | H V P Y F I D M;R
M U K J A L D O R | K J A R M L D O;U
R M V T K Y W A E | K E R V M W Y T;A
T H E N X B O R L | N E L H T O B X;R
R Z L D P T S O J | Z J R S D T L O;P
J Z A T B P S M D | M B S T Z D P J;A
W I O X L H M E Q | M Q W E I X O H;L
V K Z W Y T L M U | T V W Z L M K U;Y
V Z S G H E W Q B | E W B V G Z H Q;S
K L G S X W Y H V | W G X L S H V Y;K
I R S C H K M X A | A M I K R C X H;S
W J H Z B P M X A | A P Z J H M B W;X
P D Q J V W H R N | V N H Q P W J R;D
E W V X S R L C M | M C X S V R E L;W
M F I T N V Y H C | T V F C I M Y H;N
T X J Q L R E G I | J X I T G R L E;Q
P R H U T X I D E | X I H R T D U E;P
N Y K X O D B W G | K Y N O X D B G;W
D J S G R Z T K B | K B J R D T Z S;G
H Q F R I D V A X | H X A I F Q V D;R
D L K T Y W I X Z | X D K Z I L Y T;W
T W A J P Z Q D I | W I Z J Q P T D;A
M Z H I V X Q S C | H S V M Z C X I;Q
M Y P G X A D U O | X O A G Y P D M;U
S N L T D A R X E | A T L X R N S E;D
N J Z X T W Q P B | N X J T Z Q W B;P
U V N J P B D K C | D J C V B N K U;P
G W U J R X C B Q | Q G X W B R U C;J
S R C K P H D U M | H R D S K C P U;M
O N X D Z T J E R | N D R T J X Z E;O
C S U I M B D H N | H D I S N C B U;M
R A G K Y F J Q Z | J K A Q Z Y R G;F
I E X K S O V R G | O R X K I E V S;G
B G O X N Y I S C | B C S Y O I G N;X
Q V X O L Y N R F | X V O F Y Q L N;R
U T P A F C Q H I | U Q P T F C H A;I
X K I N E Z W G F | I E F G X K Z W;N
U E P J N O S I L | N O L E S U J I;P
E B D K A C M F H | E D H K A C F M;B
B C L S F E K M X | L X K F C B S E;M
U G X I Y W T N S | S N T I X G U W;Y
C W M Y Z L E X A | C Z Y W A E L M;X
W X V S I O A N J | J V A O I W N S;X
S Y M D Z G F A U | M Y Z G D S A F;U
J U Y R A D C M O | U Y M J D C O A;R
L Q Y T P X O B G | G Y P T L X Q O;B
W N I A H L X Y C | X H C A W L N I;Y
B W R H M K L N A | B L K R N W A H;M
Z Y E N L B D R A | N E Z L D B R Y;A
G Q V H M L S J B | V Q M G H J S B;L
W I H D N G S C M | M N W C D S I G;H
K Q O L V N S A X | S K L Q O V N X;A
Y O M Q K C R S B | S B Q R M O C K;Y
S E W V X A K O M | O X M A K V S W;E
B P E G F C V U J | J U B P C F V G;E
F Q R N X H Y J U | J N R Y H Q F U;X
K S X N O U M D T | T U O X D M S K;N
O L P D W F M Z A | W P O A L F D M;Z
R P Y Q I M G K S | K R Y I P M S G;Q
U V Q L D W R Z J | J L Z U V Q W R;D
V P M D N U I B O | D U B I O P V N;M
Y M O U J P S E I | S J M O E P Y I;U
B A O N F U X S K | F N X B K O A S;U
Y L I V X F N W A | X I A V Y N W L;F
T X M W R Y G V I | G R M V T Y W I;X
C H Z S P U R Q B | U Q S Z B H R C;P
F N Z U G I A X P | Z F U G P N X A;I
N I G Z M T Y K R | K M Y R T Z I N;G
U Z A F B E T W D | D B T Z U A F E;W
D V T M I Q G K H | K G T D Q I V M;H
B R D Q M F X O W | D R B W Q O M F;X
R C P F X K N S H | F N K S R P H C;X
Z I P L A Y F T W | W Y L T P Z A I;F
R K N V G M Z Y W | R N Z K M Y V W;G
I V C F Z U M N R | V R U I M N C F;Z
G O W E F Q R V N | Q O N V E F W G;R
Z J T R Y K L Q M | M R Z K J Y T L;Q
A U I H B S V O G | I O S G V H B A;U
K L U M G Z E T O | Z E O G T K M L;U
L W B K D Q V J I | K I Q L V B W D;J
U F Y C N H S Q W | S U H F Y W Q N;C
A W P I E L R G D | P I E G D L R W;A
Z P R H D X E W L | P E X R W D Z L;H
Z D S E Y G C R K | Y R C Z S G D K;E
V W E Y B G S N D | V W E G D Y B S;N
M Z X R N K F G A | Z M N R F A K G;X
L J M I P N Q D E | P D E N L Q J I;M
I T A P G L O B W | G O T A B W L P;I
S Z E Y F I C G A | S A G C I Y E Z;F
Q T F R W P Y U S | T S Q U P W R F;Y
M L O A D W U R G | D A O W G L R U;M
F H I S B G Z J U | S J I H Z F U B;G
X M Z Q L V C N I | X L Z I M Q V C;N
H G U W N F S J C | F W S J G H C N;U
A U M R D H Q F Y | D Y H F U M A Q;R
U X N E Y M O S Z | X E M Y N O U S;Z
D F Z O W R T K N | D K Z T R W O F;N
R K Y L T H E B M | H M K B Y L T R;E
J Y A Z S V U D W | Z D U J Y W V A;S
I K V Y O Z R P H | Y P I R Z K O H;V
J T K H G U Q X M | J K X G U T Q M;H
H Y T D L X Z S E | T E H D X Y S Z;L
S U Y G Q Z I M D | Y M S G Q D I Z;U
W Z R G M L U K I | L M R K W U Z G;I
X U L G H K C R D | U G H L K R D C;X
Y T E J S B F K X | Y B E T F S X K;J
M I S N V R G X W | G V R W S M X I;N
M V J P E H X K A | V H X J A M P E;K
F M W K N B T S J | J M N W S B F T;K
Y T L N P K J W Z | Y W K J L P T Z;N
A B D E N T L V U | A U E T L D B N;V
A H F S D G W R M | A F W R S M D G;H
S F J G C V D Q B | Q S F J C B V D;G
A N K V J O Q Z I | J A Q Z O I N V;K
Y S W R B A E H M | A H M W B R Y S;E
W X U C V H P N J | V U W N X J C P;H
Q I U N B J X V S | S B N X J I U V;Q
N W T M Z D X J A | A X Z J N D W M;T
Q V Z F S T A X G | Z A V F G T S Q;X
B C L A P F S T W | B L S A P W F C;T
O B F G E A S I M | O G B S A F M E;I
D B C A M N T X H | N T X D B H M C;A
N L O C P K X F J | X L C P O J F K;N
U I L D S K E P A | K U P D A L S I;E
F P G O W S K R E | S R F W P K G O;E
F D L B W X J G C | J W G C X F L D;B
K W I L Y F A T C | I Y C A L W T K;F
G H O J F A X L W | F O H W X J L A;G
A M X H U N J Q Y | U M X H A N J Y;Q
J V G C B Q R T K | K Q T B V C J G;R
C G K E V Z A X L | E C L K V X Z G;A
I M G Y O F J S P | J O Y I G F M S;P
H D T Z X E S Y O | D S E Y T O X Z;H
M E N D A G C P W | A G M C P N E D;W
R K N P M V Z C Y | Y Z V R P N C M;K
E Y P V S F C R I | V S P C F R Y E;I
F I V O K Q B Y E | E F O Q K V I B;Y
U P M A O X S Q E | A P E O X Q U M;S
U W Z B Y M Q D F | Y M D W U Z F Q;B
Q U I L F Y R V P | P I Q L U Y R V;F
Z T N O B V X C W | V W O Z C X T N;B
B F D P Z G L S A | Z F P A L D S G;B
P D S Q M B N L J | S Q N J P D L M;B
W L B N M J X I Z | M B Z I L W N X;J
S C E J I Y H A G | S A I E G Y H J;C
F C E B A W M V H | M A H C F B W E;V
X Z R J Q O N C U | Q C N Z J U X R;O
M V G K E R P S H | R S E K G P H V;M
S B Q Z I Y E V R | E Z R V B I Q S;Y
L T O P Y G M E Q | E G Q L Y T M P;O
R Q T H X N C B V | B R Q N H C X T;V
G Y V S L F B E Q | Q E B G V Y S L;F
K X Z D Q I G W N | X D Z I W N G Q;K
Q G L X S H P N J | G J H X L P Q N;S
Z N U J X P B E Y | U P J N Y E X B;Z
G O Q R A D N T B | Q R D N T O A B;G
P K R O H X V J F | O H J P K F V X;R
W H Q Y I P D V X | V Y X Q D P W I;H
H Q K L S E J A U | H S A E K J L Q;U
P J A N T B G V Q | P T Q J A G V B;N
L F A N U J G B R | A U G R F B L N;J
I B T E C R L H K | B T R I L C E K;H
S L U Q B P Z D X | S U D X Z B Q P;L
N B P E I U F H O | H U I O N B E F;P
W T R J V B H P K | V H B J W P T K;R
I N A W T Q Z L M | L M T Z N Q A I;W
A L J H W X K U Q | H K L X A J W Q;U
C W I Y X B D T F | D F T X I W Y B;C
G I U J E X Y L P | Y P J E I G L X;U
U S H J E M N F I | F H M I N E U J;S
A K T B R G D I Q | R Q I G T B D A;K
L O J Q K F Z W S | Z J F Q L S O W;K
C R U X B T O N D | C R T X U O D N;B
A T I F O R V Z K | K R A V T F Z I;O
F Q Z J A U V R H | A H J U F Q R V;Z
P Y M K D T H W R | R Y P D W H T K;M
O P Z H G F Q A K | Q H Z K A G P O;F
T F V M O G B W H | V B O G F M T W;H
L P A U M W K T E | T L K A M W U P;E
E R Z W N M A B Q | R E A Q M Z W B;N
O U W B H F L D Z | W Z D B L O F U;H
O S G X C R U D L | C S R U D L O G;X
D O K F H C Y X B | F Y H K O B X D;C
G S V Z Y K B F U | F Z G U K V S Y;B
O W Y U J Q M D L | U Y D M O L Q J;W
D L Q X B M I F Y | D X Q F B M Y I;L
Y I N Q R L W T B | N Y I B R L T W;Q
A M L K X G H C S | S K A C X G L H;M
F C Y A D K G Z S | D G F A K S C Z;Y
F T Y X C Z P L O | L C F Z P T X Y;O
C I S Y P F G U N | S U Y G N I C F;P
M O C U Z Q H I R | R I Z H O U Q C;M
H N D R V I M S G | R D V G H I M N;S
M U Z S Y P W V B | S V U B Y Z W M;P
L R M H E Q C X G | M L G H R E Q X;C
S Y V O J I W U K | O K S I W Y V J;U
U X L K O B S Q D | Q S D B K X O U;L
S D O P G K A H N | P H D O G A K S;N
E F G K Q N T U S | E T S K F N Q U;G
Y C T U J Z R F K | R F C J Z T U Y;K
V A T M K L Y J R | T R K Y J V L A;M
R F Z S J V M Y G | S Z J M R G V Y;F
S O F R K H I N G | G S F O K I H N;R
C D Y F V J P Q X | Y D C Q V X P J;F
Z N O C T D S W U | W D T N S Z U O;C
C R A H N S Q U P | H U P N Q C A R;S
B I A D W G X R Z | R Z D W G B A I;X
F S Q G H R N Z M | Z N H S F R M G;Q
S L E F Z U Q C K | Z U F S E L K Q;C
O Z L Y A R Q K J | Q Y A K R O J L;Z
G P V X Z M U Q J | J X U P V Q Z M;G
V T W O F E R G H | G W O T R F H V;E
N I Y Q P T D F E | F E N P I T Q D;Y
E W V F X J L D S | L W V X E S D F;J
A V I F J C B R Z | J F C V B I Z A;R
M D I U F Q B Y H | I H Q Y M U F B;D
O G J D A X V W Q | O A D X J Q G W;V
L X Y S I A Z C F | L F A Z I C Y S;X
V Y C T G E N I Q | N Q V G T Y E C;I
H B Z Q R M U S D | M U S H Q D B Z;R
F B U R D L Q T O | R F U T Q O L D;B
V J H I M T N S W | I S N H V W T M;J
G R K D B C W P O | B O G K D R P W;C
T Y E A W R D Z L | Z T Y A W R D L;E
M J U F C X Z L O | C M U L Z X F J;O
A V X B K N M Z R | K A Z M X B N V;R
L Z B N S F J R K | S R L Z N F B K;J
U I L M X A D B G | D A X L I B U G;M
S T R V O A H Z B | A Z S R V O H B;T
L G N M V W E J S | E J W S G V L N;M
G Q B F C E P U R | B G R F P E U Q;C
P O C N U W R K L | L N U R P C K W;O
X A B T D C H V R | T H V X D B C R;A
Q M D I E B R X O | D I M O X E Q B;R
U V H W R L G Q M | L W H M G R U V;Q
C O J G F V A R Q | Q C R J A F V G;O
B D E Q N H R W U | W H R B N D Q E;U
P K T M V G W D O | K V T G W P D O;M
I A Z O R G K M B | R G A Z O B I K;M
R P H V Z D K S C | Z P S K D V R C;H
Q B J I K Y M P H | H I J K Q B M Y;P
F Q C L S O G W N | N W C Q S L G F;O
F E P C S Z Y O N | Z E P N O C Y S;F
Q G V C Y R J U P | R V C Y U J Q P;G
Z Y B L J U E A V | Z B U L J A Y V;E
R Q S H U N P K M | H Q K P U S R N;M
V E Z D F T G M R | M R D T G V Z E;F
F O B L Z P H W A | B Z A H P O L F;W
W G J Y K B A V D | Y V W D J A B G;K
K R U D E G C Z B | Z B G E K D C U;R
B V C X S L U H G | H G X B V U L C;S
R U B X P O S H G | U H R S X B O G;P
D J W X R S K L E | W X L K E J R D;S
F I Q C L D X M B | C M F D Q I B X;L
K B Y M A O G V I | O K A Y V M B G;I
X E N V P W R Q D | E Q R X V N D P;W
I V Y L A Z O T J | A O J T I Z L V;Y
Q L A J Y F H Z M | Q H F Y Z J L A;M
E K T Q H O L B V | K H T B E L O V;Q
T Z U K B G A P O | B O A G T K Z P;U
A S K E P N C J H | C S E P H J K A;N
Y H S C D P M O B | M Y S C O D H P;B
Q O B N L D Z I P | B D Z O P L I Q;N
F G T Z M I X D H | T G I X Z H F M;D
K N R M Y C X B S | S R C M N K B Y;X
T R X D C K H U E | H K T R E X D U;C
E N D P C Q M H I | C D N H P M Q E;I
X T F E C O J L U | C E X L J O U T;F
G O T B V C X H I | I T O X H G V C;B
I W M N J U G X Y | G M X J N I U W;Y
O V M E F T H K L | L F M E T V O H;K
F B G Y W H I R J | Y I F G H W R B;J
M E A V W P Y Z F | P F W M E V Z A;Y
N G S C P F W H A | F H A N G P S C;W
Z N Q F W D Y M R | Q N D R M W Y F;Z
B M N Z W Q I R U | I B W M Q Z R U;N
T J L O X D F C Z | L D X J T O C Z;F
I T B O S Y D L W | D Y I S L W T O;B
L T F W H G C A X | H T G X L F A C;W
E O K M P J L R C | K J P M O R L C;E
P H A F L Q Z X N | Q P L H X N F Z;A
X F Z O B Y N R K | O F B Y N Z X K;R
J T L F I N U W S | I S L J N T F W;U
L V W X T C R Q D | L W C Q T R V X;D
H C G V J Z F L Q | F G V L H C Q Z;J
V Y S O E W T N I | W T N O I S Y V;E
O R U C S J X M T | M C U T J R S X;O
A Q H Z K V D M R | A M Q H V K Z D;R
L R I A O Q C W Y | I L C A W R Y O;Q
M Q V Z I K R H G | I Q G K V H Z M;R
B H O M I P R Q W | R B I Q M P H O;W
A H K V G X T C E | T V C X A E H K;G
R J T S E A O P N | P R T S J O E N;A
S N B C E J K I V | V J S I E B N K;C
R M D I V B A S T | R T M A I V B D;S
H I T A Z V E G S | G T S A Z E H I;V
W J Q M A Y R C O | C W Y R J O A Q;M
Z L I H Q Y O R N | H Z I L O Q R N;Y
Y O Q N T D J A G | N G D T Y Q O A;J
S Y M A F B Z G T | A B G T M S F Y;Z
N U K R E V P Z G | N G U R P K V E;Z
Q U E Y J A C R T | R T J Q U A C E;Y
A P J F R H X G K | G H A R J K F P;X
A I Q C M U N G L | Q C L G U A I M;N
I D F W B R M O A | M O F A I B W D;R
E W Z R M A T P U | E U A W R Z M T;P
D Q V G R N L Y T | R L N Y V D G Q;T
S X D W P V Q T E | E X T P Q D W V;S
C Y A K Z J Q M S | Q C K Y A S J Z;M
K R S C I A U X B | K U R X B S I C;A
Z J N Y I B Q C D | C I Y Z J D Q N;B
F O S B L N A K Y | A S B L N K O Y;F
D W S F Q V L I E | I L S F W Q E D;V
M D K I E X Z W O | W O I Z M X D E;K
I X S O W B J H R | O R I J X W H B;S
V O S A H J K B I | A J H K O V I S;B
U G M D X N R J O | U M G R O J D N;X
H D R I B Q A F J | A H B F I Q R J;D
J L X T U G V K R | K X G L J T V U;R
L K Y D G J N Z H | D L Z Y G H J N;K
O F H W I C Q A N | A H O C Q W I F;N
Y E F M Z N K P C | P K E F Z N M C;Y
A U G E K D L I H | E U L A D I G H;K
B M O S F V G Y E | M S G F E V B Y;O
R B J U E I M S N | B J E S M N U I;R
F W P A H G B S N | P F W S N G H A;B
J L B M W P Q K D | D M J W Q K L P;B
D V N K R Z T G B | T K D V N G R B;Z
T Q S W G Z E I R | G W Z S E Q I R;T
U X R I O W Y A N | W I X A U Y O N;R
I C D A K U V H F | K U I H V D F A;C
Q U D C R F T V K | R V D Q F K C U;T
Z C Q U O F H S A | F U Q A Z C H O;S
S N A G H Z U T P | H Z A G N S T P;U
O M X W C R I Y V | V Y X C M R O W;I
B S Y F L M A D V | V D B S M L A Y;F
Y G T F C O L Z H | F L T Y O Z G C;H
A S P K H E N T V | T E P H K V S A;N
Z M H C R B I O V | M Z V O I C B R;H
D S G F M Z Y V R | F Y G M D Z S V;R
K V U N S I M X W | N X U V M S K I;W
B H F G W D J X P | G J W D X P H F;B
J V M E O F H K B | B E M K J F H V;O
D K M S Z I A W H | A M D H I W K Z;S
G P H E U X L W I | U P G H X I L W;E
D K N Q C H T L J | N D H C Q J T K;L
O E D N J C H Y X | H Y E C O J X N;D
A M K B G W H Z Y | Y M W B K A H G;Z
F G E U B D C Z V | V D Z C U E B F;G
H B I K S G Q O W | H S B G K O Q W;I
C E Z T F U R J L | T F L J Z U R C;E
J H O W P X V T N | H X T W V J O N;P
C W E L Q J Y H B | Q W Y J H C B E;L
H C E Z N F R P X | F X R E P C H N;Z
L B Y F Q N R S U | B S F R N L Q Y;U
E L J B W A C I F | J W L B A I C F;E
O T S X K W F Z L | L T Z O K F S X;W
M H T Z O U N J A | M N A U O H J Z;T
C P N H W S R T I | T N P W S C R I;H
Q T F K D M N Z B | K F Q Z B M N T;D
H G N U I S T B F | U I T N F G H S;B
H L M N S T Y V Q | N V Q H Y M T L;S
L M A I O V C N X | C V M I N L O A;X
S W D R N J P Q M | P Q S J R M D N;W
T P J Z G U Q D I | I P T U G J Q D;Z
G N D J Y S T X R | Y T J G R X S N;D
I N M Q K B V Y O | V K M Y N O I Q;B
K R P A G O Y C N | K O G N R P A C;Y
E U C G M I O T R | T U G R O M E I;C
T L R U G I Z X B | B L G Z I T X R;U
W B U O E J R P F | J R W E P F U B;O
Q D U W M B A H C | H B A D U W Q C;M
Z N T H S C D G M | G Z N T C D H M;S
A O W Z B F K U V | V Z B U O W A F;K
L P Y N R S V J I | V J S P N L R Y;I
O D V R E J F U G | F G V O D J U R;E
Z K G L B W X Y O | B X L O W Y K G;Z
S W D O V J F M I | F I D S M V W O;J
A Y J M B K O R W | Y J R M W B K A;O
G U Y Q Z O L F A | U F A Y G O Z L;Q
B R O L Y A V D K | K B A L R V D O;Y
M O L P E U R B V | R E M O L U V B;P
V I H Y W P N Z O | O N P W Y V H I;Z
T W J D H A N Q L | L H T D N J W Q;A
N O L F M E S D Z | M Z L N F E O D;S
U K A N D M F G E | N U D A G M F E;K
O E W A F Q U L D | L W O U Q E F A;D
M A F V B T Z H C | A H F M B V Z C;T
L W H A Y E B M I | L Y B H M I W A;E
F E Y T V R Q J G | F V J Y T G E Q;R
A H S E W I Y D O | S O A D I W H Y;E
H I L O A N J D B | L J D B I H N O;A
C B W M I U O J F | J M U O I W B F;C
R T K D N F E U X | K U X D N F T E;R
G N Q F K I P J C | F N Q P K J C I;G
A Q U Z R T I C X | A Q Z X C T R I;U
I F W T Y P C H A | W T C A H P F I;Y
Y U A K D F C N P | D U F A Y C P K;N
R V O A F W E N B | B E W O R F V A;N
T B X R Y L N F Z | T R L F Y Z X B;N
S N E A U P Y O G | S Y E P N A G O;U
R H D Y E O P N L | H L O E Y R P D;N
F A V U X S B R H | A B R H S V X F;U
M E X F A C O R N | R O E X F C N A;M
I G R C W A Y K X | Y A G K R C X W;I
Z M I H V Y Q E W | E V I H W Z Q M;Y
R L A Y K M G Z P | R Z M P A G Y K;L
K X B R C T L F J | L R X B T J F K;C
R B S J I V T G Z | J S Z V B T I G;R
X R L D I F K G B | K F L B G X R D;I
Z U O X M T J Y N | N X T J M Z O Y;U
I X A V H O M J N | A X I H N O V J;M
W T H S Q J M G X | X H M S W Q G T;J
G Z L P X J Q A S | S P X Q A J G L;Z
F A S Z Y T W M H | T Z A W H M S F;Y
E G S P J R M A T | M T R J E A S P;G
H M F T O U Y W C | H Y O T U W M F;C
O A R S J I B X U | O U X J S R I B;A
O G E F M X I V C | G C E X F M O I;V
U Z T G K B V O X | T V X K O B U G;Z
E A W S X K C B J | C J A B K W S E;X
W L Q S U A H B M | S B A H W Q M L;U
I W U H P Y L X O | L I Y O P U X H;W
I J D P E W K C N | E N I K D C W J;P
Y U K P Q R A E T | Y U A E K Q P T;R
V C T B D M F N L | F N B D C T L V;M
Y X O P M I L G D | M O L D G P Y I;X
K A I U X F M S Q | Q U X F K M I S;A
C D Z W K J L O T | K W J Z O D L T;C
F D U H L P R C V | L V D F R P U C;H
R D K Z M U L F E | E L R K M Z D U;F
C K I J H S G M Q | M K I S J C G Q;H
Y F M G W I P V A | F G M A W P I Y;V
X Y D Z V P J M K | Y D M V Z P X K;J
D A S Y V X G L B | X L V B S A Y G;D
O R M B K W S D X | D W X R O S M K;B
C A V K X J L P I | I J P C L X V K;A
E M R F U Y W J I | E F Y R U M J W;I
B I Y D T Q A L O | D A T L O I Q Y;B
Y S X Z J E B V C | C Y J Z X S E B;V
H W I A F L J R B | F H B R J L I W;A
E V J G O M K H B | V K G E M B O H;J
S L Q Z X T B M K | L K M Z Q X T S;B
Q A I V M Z N P K | P K M N A V Z I;Q
P L U K O B S H M | P S L B O K M U;H
L U W O B E R T V | R B U E W O V L;T
U N R X L W Y H B | X U N R W H L Y;B
Y O C M R E G I W | Y R E W M G C O;I
A C N U P L O T I | C I A O N P U L;T
N T F S K I Y O X | S O I T N K F X;Y
M Z N D R A T Q P | A N Z T M D R Q;P
G A W H X C J R N | C G A N X R J W;H
Z F M Q E L K J S | F J Z S Q L M E;K
C Q U M E K W Y V | C K Q E M U V W;Y
C R X N W Z I U G | W G X Z I U N R;C
L T A G B Z Q J V | Z A V G L J Q T;B
E K A R P F V U Q | U A Q V E R F P;K
A J I K U H B D C | I U H D C A B K;J
R M W J F I A K E | M R W F E I J K;A
I F A C X T P V Y | A P V X T I C F;Y
Q M W J N X A R V | W A J X V R M Q;N
E V F N U Z I W C | C I W N Z V E U;F
W X U G O T P S R | R U O G T S W X;P
Q J E O P H L A Y | L O H J Q Y P A;E
L D F P W C E V J | D L V E J C W F;P
K H R X S D E T I | S H R K E T X I;D
Y I T G N H L C U | Y G N I H U C T;L
F A K Y O G X L B | B F X O L K A G;Y
Q G Z U O F H S T | O S Z G H Q T F;U
C J N S U T Z H L | Z N T H J L U C;S
B T Z N V Y G H A | H G A Y B V T N;Z
X Y W J C B K S L | X B C K W L J Y;S
E N K S J Q M D P | Q D S K J M P N;E
L Q S A V O N P G | O G N V S Q P A;L
W J I L A Z Y V O | I Y J W Z A O L;V
E M D U B L I F W | E M I W D L B U;F
R W Z Y F L J V H | H V Y L W J R Z;F
F N C H L G Z D E | L G N C H F Z E;D
G Q D U M C S A E | G D A M C Q S U;E
X P D G Z T M F Y | F Z M D X Y P T;G
W M C L T B O D H | O D M C H T W L;B
Y W R K H F T J I | H J I T W Y K F;R
I W H D G Q M N X | W I H X D N Q M;G
Y B S L W A R T V | B R T L V A Y W;S
G K E C W A V Z M | M E G C W Z K A;V
U P M D N B S V Q | B S V U N P M D;Q
U D N L T C M O J | U L O C J N D M;T
U G W Z C T E B H | H Z E B C W T G;U
F O A Y S H P N V | A V N O P Y F H;S
C T Y P J H U E D | Y P T J D H C U;E
X C B Y J Q S L V | C Y X J Q L S V;B
Z B R Y W Q A X T | W Q T A Y Z R X;B
H W Q G O C P U T | C O P W T G Q H;U
E L G B W X Y T R | L B Y X G R E W;T
L T V G D F A K O | F T D O L K G A;V
B Y U R X E M W A | M A U W B X R E;Y
Y D C M A E P W K | D E A P C W Y K;M
F D W R E Y J C S | W C D S E Y F R;J
E W T Z P U H Y M | H Y W T Z E P M;U
G E H Q F T X U B | E H T B F X Q G;U
W N Y V O K A X F | O K N W Y F V X;A
F M Y E V D G B N | N Y D E V F B M;G
F V W Q S O B Y R | O B V R F W S Y;Q
A X H S B F K M G | A G X H M K F B;S
T S K I P Z W H N | Z S T W K I P H;N
S P B M T A R N U | N S A B R U M T;P
Z N M L I W A C G | Z M G A C W L N;I
B M F T I R N A O | M B I R A F N O;T
M A N D U P I K E | E P D I M A K N;U
B M N K A P T I S | M N K A I T S P;B
N H S V C K W L X | N H K L W V C S;X
Z E A U C O J Q P | P E A Q J C O U;Z
J D Y M X N K S C | S C J N X M D Y;K
F Z T N P U L X J | U F Z J T N X P;L
U Q M K D E T Z W | Z M D T E K U W;Q
F B P U R W N T S | R F U P S B W N;T
S V T K Q G A M Z | M K T A Q G V S;Z
D S V C U A Y M O | A M V Y O U D S;C
F A Q B P I N H Z | I A Z F P H B Q;N
M N R V T U G A Q | T R M U A Q G N;V
B F M U L D K G C | M L K C B U G F;D
E V K P N T L X R | V K X E R L P T;N
C J M L G E Z K V | G V M C K L Z J;E
G V E F J U Y N L | E U Y V J L N G;F
S X A E O Q P B Y | S Q O A Y B P E;X
O S I A V E M R Q | I M V O E R Q A;S
Q U T O F L A K J | O K L A U Q J T;F
H E W V R C Q K A | H E W Q A K V R;C
I Y O R A U C Q Z | Y Z A R I C O Q;U
E S U B K M Q R Z | Q U S K B R E Z;M
G B X W F J L D P | X P L G D F J W;B
L F M N Q I B P U | B I U F L M Q P;N
R Q S Z N K A U E | A Q U R E N K S;Z
N V J D S H C A T | S C V J T N D A;H
D Z V X P N O L E | V P O Z N E L X;D
U C N W F M Y R T | N Y R M U T W F;C
B X R C D V Y L E | E D R B X V Y L;C
T A L B Q H U J D | Q T B J H A L D;U
C U Q F A G Z W M | F M W Z Q A G U;C
G W D Y R S I F H | W G R I H F Y D;S
M K G W P E D C X | X W M P E G C D;K
F C S W Z E I X R | R W S E C Z X F;I
Z T N H L M P V S | M H S L T Z N V;P
P E N U S L C G X | G C U L X N P E;S
S M H K W L V G J | G H M K L S J W;V
V G L N P Q D U O | N O U G D L P V;Q
N K X R F M T J L | M X K R T F N L;J
O B E X D V Z L I | L Z O I X V B E;D
X E Y H C I U G V | Y U G E C X V H;I
O A I H G Q X S V | G S X Q H A O I;V
C L S X K O Y P A | X O C Y A S K P;L
G A Y K H O S T B | T G H A Y S K B;O
Y F S R P Z A O B | S Z R P A F B Y;O
A G I Q W Y B N H | N Y I W Q A B G;H
B Q T Z X U O C A | C U O Q T A Z X;B
U S W V E Q X R A | R S W E Q X V U;A
W M V P T F E Z G | P T W G Z E F M;V
J D G C S Y R E O | D G Y R E O C J;S
I H Q C W B G S P | G Q B P C H W S;I
E Q D C F J U S R | F E C Q S R D J;U
G M I V F X J C E | X C V I J M E G;F
G Q T R B D J F C | B R J C Q D F G;T
S O E I F W N J T | I F S T E O N J;W
P U R M Q A V J K | A J P R K U Q M;V
C G F I E L S W A | A W L E I C F S;G
W V T G H I B X P | X B T P V W I H;G
Z H C P K O E S Y | Z Y C O P S E H;K
B U S N E T Q R L | N E S U Q R L T;B
V K F N B M I R Y | M F I B K Y V R;N
H W C P O Y D Z T | Z H T Y P O C D;W
M S X K W Q J G Z | S K W J M G Z Q;X
C F B I U M V E W | C I W V E U M B;F
N W L Z B C O K U | Z U L K O C N W;B
O Z F P I Y U H S | P Z F U O H S Y;I
G U X O C V P Z B | B X V P Z C U G;O
U G F M J H T Q A | U J G M F H Q A;T
A P S I O T W B F | A F T W B O S I;P
Q U D J Y S H M L | Y H Q M J D U S;L
V J I Y A Q M L O | A O V J Y Q L M;I
R I X J P B G D Q | Q R B J P D I G;X
X K Y Z A R O Q G | A O Y Q K R Z G;X
S B D A V W K N E | E V N D W S A K;B
Y L V S F Q R U B | L R U S F Y B Q;V
L C X E J D B Y P | P B X J C E L D;Y
J L K X B R S I Z | B J X Z I S L K;R
C D I M A G R Z W | M C D I A R G W;Z
J Z R B D K G I X | G I D J R K B X;Z
X S G K H M V Q I | S Q K H V I M G;X
W H X L R C P K F | C P L R X H W K;F
I F D U G X H S Z | F S U I G D X Z;H
W Y C I F B G L Q | G W Q Y I F L C;B
R N I Y L B A G E | A L I G R Y B N;E
B N L U F T R Q V | R B V U N F Q T;L
J C T G D P M H Z | D M T Z G H J C;P
I A G D Z H Q O E | D I G O A Q H Z;E
P M A B N Q V H Y | V A P B H Y M Q;N
E R V G C H T L K | H K E C L T G R;V
J D B F Q G Y V L | G B Y Q V J F D;L
D P Z W O E J V B | W Z E J P B V D;O
L T Y V N I C H F | H L F T Y C I N;V
R S A J E Z Q H G | E R Z H S A Q G;J
H A B U C J M P L | J H L U M B P A;C
X J M G D Q E O B | M J X E O G Q D;B
V Z G R E C Y A U | Z A Y V U E G C;R
F Z S H W K I M G | I S W F K M Z H;G
K F I V P W N B D | I D V F N P W B;K
H I K Z Y S W O E | H E O Y Z W K I;S
Y N P C B G I X W | N X G B C W Y I;P
M K O S B N H W V | N S W K B M H O;V
I Q H G X W R P M | P R Q W G I X H;M
M J B A R Q E W D | A R B D W J M E;Q
H X U C A O K T R | A H T U X O K C;R
Y X H E R Q F M A | M F Q E X H R A;Y
X D P F N C Y V O | O N C D P Y X F;V
R S Q A F O C E Y | C E S A Y F Q O;R
R F A D U S Q K I | R D F Q K I S U;A
T R E O G W Y A S | S T R E G A O W;Y
M N I C E A G K V | M I C A N V E K;G
I G Q M T C D R H | I M Q D T H C G;R
G W B L Y X A H E | B G X A L W Y H;E
V E M A Y P T K U | K A Y M E T P V;U
A W V L K G P O T | V P O W G A K T;L
G X P Y C V I D S | Y D C V I S G P;X
N D O B R H T Y M | M H B Y D R O T;N
H S K A Y N W G C | A N W S G K Y H;C
D G A H E Y B F P | G F Y B D E P H;A
Z I T O Q M X N A | Z N A Q X O T I;M
G R I W Z X U J S | Z U W J S X I R;G
Z U C W Q H P E I | W C H Z P U I E;Q
F D M K E L G P H | H F P D M E G K;L
Y I R K Z O M X E | E O R X M Y I K;Z
G U O E A D H V X | X H G E U V D O;A
Q U T L R W V H S | U W R V T L H S;Q
T K G H W X E D Z | T E G H W X K D;Z
R Z H S M L A Q P | H P Z M Q R S L;A
I J Y M K P N D B | B D K N P Y M J;I
W D G Y P E T Z B | B G E D W T P Z;Y
K V R Q E W N M C | V R C K Q W N E;M
Z P M I A K Q F Y | Y M F K P I Z Q;A
I P C G T J X B S | I X S J T B P C;G
G N Q L C H D B R | N R C L G Q H B;D
O Q L U J V G A S | L G U A S O Q V;J
N W A E S C B J H | A C H B J W E N;S
N L O Z A K V M T | M Z A V O K L N;T
M R Z B O V S Y F | R Y F Z V B M S;O
F Q H A N G W Y B | N G Y Q W A B F;H
K O U T A H Y X D | D Y K U H A T X;O
E G P Z V K N Y X | G Y V X K P E N;Z
R T F L E B Z C S | C B T S Z R L E;F
P K A R U Q B C I | K P B I U C Q R;A
E M U O S X T W K | O T W U M K E S;X
D I Y L M H P K E | E D K L I M Y H;P
E L P G H U A W Q | P W H E L U Q G;A
Z J S Y D O I U N | D Y O Z J U N S;I
W B M A L I X U O | B U W X O L A I;M
O R Z L N K H I W | R L H K W I Z N;O
S G K T Y B C M D | Y K T B M C G S;D
K H V U I Y L X W | Y X U H L W V K;I
R H U A S T O C K | K A C S T O H R;U
O N P B J U I V M | I M U J B P V O;N
N K M R D T E Y V | K T R V D M N Y;E
I L K C Y H G U J | I C U J L K G H;Y
E Z D J X M R Y C | E X D R Y C Z M;J
D T S U O Q I C J | S I U D C O Q J;T
N C W T O L E B I | B I T W L C N O;E
C J H D B L Q U G | L B J D C U G H;Q
Y D U X P H K R I | Y D U R H I P K;X
G V B N X C A J Q | X Q G C A N J B;V
B Q F O E V P N Y | B Y E N F P Q V;O
O H L I Q X K Z Y | Q Z H I X O K L;Y
X W V T Q E G D U | Q D G E W U V X;T
W A Y H S Z P U T | H W P S T U Y A;Z
U P I J S A R M G | U I R M J A S P;G
E O D M Z C V Y P | C E D Z Y O P M;V
V G A R Q U H L X | A G Q V U L X H;R
F Y E K I O S X P | E K P I S F X Y;O
L T O P Q M W Z F | W M F O T L Q Z;P
V U G C Y I N K M | I Y U K V G M N;C
F T K R Q V Z D Y | T Z Q V D F Y R;K
C Z J N F U B I H | H J I C B F U N;Z
Y B I H M A O N Z | Y N H I M B A O;Z
F N O B C Q U R A | R C N O F Q A B;U
C Q M B U S X L Z | Z B Q S U M C X;L
D O F S H Y K G Z | F H D S K G Y Z;O
Z M Q W Y B H N G | Q H Z W N M G Y;B
P K A Q V Y T X U | Q Y T X U A K P;V
H B Z I P R W X F | R Z I W F B P X;H
Z R A D Q B X N L | L D B X A Z R N;Q
D A V L I U Y H B | U B V I A Y L D;H
R L M A K P U W T | R A K T L P U M;W
Q F W N B Z L G U | Q U N L W B F G;Z
L Y C Z N Q T M S | Z Q T M N Y S C;L
T Y D C I E B U A | C A Y B E T D I;U
F D H W Y K T B C | K H T Y C D B W;F
C S L Z E X O M I | Z C I S O E L X;M
O X F Q R S J C G | G J O Q C R X S;F
D S B W T K L Z U | T S L K D W Z U;B
O R Q P D H M F X | Q X M O H R P F;D
J P U K T A C F E | C K U E J A F T;P
I A E X W U G B Q | E I U B X Q W A;G
D W L I E S Q G H | H I Q L E W S G;D
H A D P T Q C Z N | D T Q P H N A C;Z
S B E X R C L W F | E W B L R S X F;C
W U J R M K C F H | W F H U M J C K;R
I O N D L K B R G | D N B R G L O I;K
P Q B G R F J N X | P R J X N F B Q;G
P B E L Q M I D V | E P D Q L I V M;B
B T V J G Z W M S | W V Z M T G S B;J
C V G S M E D R J | C D R E V S G M;J
M P F S O H I D N | M H D I F P O N;S
M G A R U F O L D | M R G F A O L U;D
P H G B E J A M F | G M A F J E B H;P
W E H I V C B S U | B U H W C S E V;I
G E B V A H Y K W | W B V Y A H K E;G
A P L B X R Y H Q | X A R H B P Y Q;L
T H Z X U O L G I | X Z I H T O G L;U
Q U D C H V E Z J | C D V H Q Z J E;U
V A E Y U R X J C | X U Y R A J V E;C
T F Q P Y G S A M | M G F S P T Y Q;A
Y U P F K R O G C | Y P R C G K U O;F
Y J B G O V P X H | V X B J H O Y G;P
Z Q A S G L B U H | L G A Q B H Z U;S
C D J Q R W P M E | W J P Q R C E D;M
Z U H C X P Q V F | V F C P Z X Q H;U
V E N J S Z F H G | E F N V J H S G;Z
M W H Y C P K Z G | Y C G M W H K Z;P
W B I E C F X D A | A B F X E W I D;C
Z R O I U Q G H A | A H R U Z G O I;Q
A B P X T Y D Z V | P Y V A X Z T B;D
P N S Z U M J H Q | J Q S P H N Z U;M
S T R J Y E U Q L | U Y E R S L T Q;J
C F M G L Q K X N | C L M K N F Q G;X
N M W Z J B I L E | I E Z J W N M L;B
S P X J T V F I H | V H I P J S X T;F
R E Y U M O Q A H | U Q R Y E O M H;A
F T J E Z L C U O | F C U J O L T E;Z
I X U A Q T V W Y | Q X V T Y A U W;I
Z D A T O I B W M | I Z A W D M T O;B
O P K C X V B Y I | X C O B V P K I;Y
U K A B N L S C G | L B C K S A N U;G
V G Y U Z N Q M P | Y P M Q N V U Z;G
J Y T I R B S V E | E V T J R S B I;Y
U I E A K G Q P V | K Q G E P A I U;V
Y D X Z L P S R N | Y Z L S R N X D;P
G E Y S K R B U D | S Y G K B U D E;R
Q W P F C U L O Y | P W O Y C U Q L;F
F J A X G N T D Y | Y A D G N X J F;T
P C X Z T I S D W | S P T C X Z W D;I
A P Z B E I U N X | A Z I U X N E P;B
J G S D U F P Y A | G S J U A F Y P;D
H M J U G S L X B | S X G M B J H L;U
D V H O X E A C F | H X D V C F E O;A
H V S R L K O E W | R S V O H W E L;K
O B J P X Y I A E | E X B P Y I O J;A
N I M B E J K U Z | N J U K I Z M E;B
A L B U H I N C T | A L U T H N I C;B
T C H V E P Q F U | H U E V Q P F T;C
L D T Y S H N R V | D Y R L S V H N;T
F C X L O M D J I | M D J X I C F L;O
S W A E G Y J V K | J Y G V W A K S;E
H O W M U I R L Z | O M W I H R Z U;L
B T Q C Z P A U R | C R Q Z T B A P;U
B T K I J X M F H | X J F K H I B M;T
I E N W K C T U X | X N U K W I T C;E
K N I J M G W H C | C I M G K W N J;H
S A K R M H Y F X | Y A S K F M R X;H
C H U N O I K X E | H U O K X C I E;N
X H F C K W V O G | X O C W H V G K;F
V M Y I Q N Z K W | V W M Q N K I Z;Y
V M Y L A U S K T | S M A L T U Y V;K
P H S V K R J A B | B P H S K R A J;V
F B M U A O Y J V | U O M Y A V J B;F
W R L E Q H C T M | W R E L M Q T C;H
V Y A H M O D T P | Y H M P O A D T;V
Q X Y A E G T Z U | X Z Y E G Q A U;T
H Y E O W Q U J L | Q H L Y O U W J;E
V I P Z C A E U W | Z W P E U I C V;A
I P G V K F D W Z | F Z W V P K D I;G
H M R N P S A L O | H O A R N L P S;M
T B M E A U H J P | T U B H J A E M;P
Z O L H Q T X E I | O Q T X I L Z H;E
O A R W L E C G J | O J G C A E W L;R
M J Y R I E H B S | R J I E S Y M H;B
B U T M X S D A I | M I B T D X S A;U
C N P O E V G X W | G W O C E V N X;P
L G O A R X J W H | J A H X W G O R;L
T V W G Z F H Y I | Z T V Y W F I H;G
X W N A H G S O Y | N W G Y H O A S;X
C W R G Z U K D T | W U T G R K C D;Z
L C Y N E H X B I | Y X B H C E I N;L
P Q M K O V F S D | M D S V Q F O K;P
W P H R C B N U K | N B H C K R U W;P
C L S F R K T A N | S R T F K N C A;L
B X E M O J N K V | E O V M N X B J;K
Q O Z C H M D F V | Q O V C D H Z F;M
J S E T Y A N W Q | Y J T Q E S W N;A
R S T C U D F Q O | C F U R T Q S O;D
Y P D A R G C I V | C P V G Y D A I;R
C E B D M G I R N | B C R D I M E N;G
R F L J D X U I H | L H R J I F X D;U
H G Z O Y R B L P | L B O Z P R G H;Y
A P F Q D M G V C | G M D A P Q V F;C
G S H B E A F M U | M B G E F S A H;U
K Q J B O P N X G | K N B O P J X Q;G
A G I J K E W M Y | A W I G J M K Y;E
S R E Z P J D T O | O S Z P D R E T;J
W F I M D E C U P | F D W C U I M E;P
V R N Y X A E U D | V D U R Y X N E;A
K T Q J D V R N P | D P K T N Q R J;V
K N V O W G S T J | O J K S N G T V;W
L T J S M Z V D G | L D G J M Z T S;V
Z H R K D A Q L I | H L I Z A Q R D;K
K A Q R E I Z V H | K I A E H R Q V;Z
V B F D X R I P U | R X D I B P U V;F
W P D O H B X A U | U D O X B H W P;A
K H J V T S R A Y | Y J V K H R S T;A
J S G Y X Q L T B | Y S Q G L J B T;X
V T O A F I Q J B | V F B I T Q A J;O
V R Z G T S U F O | V G U F O Z T R;S
S X D O Q V P C H | Q S X P H C D O;V
P C N A E L B H T | E P L B N A H C;T
V S Z O T R Y D C | C V Y O S T R D;Z
Q C H S U Y V M D | Q M H S U V Y C;D
O B G X S A Z D J | B X O A J D S Z;G
Q W C E G N T J L | C L T G J E N Q;W
R M G Z Q E U Y K | Z M E G Y R Q U;K
H E N F B I G C L | B H G C I E L F;N
A I J G U B O M Z | M O Z B I J G U;A
W X V P Z L D Q E | Q Z P L D W X V;E
V N P Z J A G H X | A G V Z J P N X;H
C I E G B L X D Q | Q D X L I E G B;C
G S V N E Y A D R | E N S R A D Y G;V
D I Q N P H L K C | C H N P I Q L K;D
D O U A V M H W N | W D N H U M O A;V
O H G X K B Q W V | W Q G B V H K O;X
I O N A V Z Q Y K | O V K Z N Q I Y;A
P E A D O X C B H | O E D H P B C X;A
Y G S R K E B L C | K C L G E S B Y;R
L V O C N H J R S | H O R L J S V N;C
P Y D T O J V Q I | T P J Y I D Q O;V
F A O S M V Z L K | F O S K L A M Z;V
O J M V R N L T W | L O R T W V M N;J
T M I V O J N B S | J M N I S O V B;T
S O J E T Q N Z A | Z T O S A Q J E;N
D L W K P J X M Y | K W J P D Y M L;X
P S C L V Z B W Q | C L Z S V W P Q;B
B Q K N L P H A R | R N K B P L Q H;A
U G K E Y M A D R | M G R U A E Y K;D
V U O T H P C J B | H V O P U T B J;C
O Z U N X K H Q E | U Z X E H Q N K;O
M I Z Y G N W U S | I G W Z N U Y M;S
N U O L Z F K J X | O X K U J N F L;Z
T A S F I D P V H | H F I S V P D A;T
O W P I S V H C K | S H C V P O K W;I
E H J K L I N C T | E N H K T J C I;L
I K F U A V S O N | N K F S U V I A;O
P K M V F I W H A | W A V F P I M H;K
N H I J R T D K P | K R N I J T H D;P
U S M N A I H O Z | O A N H M Z U S;I
A Q M J O P H E Z | Q H Z M O A E P;J
Q J N F V A R B I | J I N A Q V B F;R
P T J D E C K A R | P A R K D T J C;E
P T E W O D H V R | P T H V W E D R;O
C W D E R G T J S | R E J C T S G D;W
G J K P M S V Q Z | P S M Q K Z G J;V
L A N P H O J F Q | O L Q A P N H F;J
X L N O Y D R F K | Y R L X O F N D;K
A Q X D R N L W O | L O Q A D N X R;W
P U N G K Z O X Y | O P G U N Y X Z;K
O V G L Y I R D K | V Y K O R D G I;L
I H P U J V N W S | S V P H J I U W;N
L S Z U E O G A N | Z A U N E O G S;L
N S T A B O U K V | S B N A U V T O;K
Y G B K I J L E U | B I E Y L J G K;U
A N G J F H T I C | N I C J A F G T;H
M L P G R Z H B O | L P R O M Z H G;B
K J S M O A Q R D | S A K J O M R D;Q
H A R S Y F M I D | S I F A Y M R H;D
D G V J C E N L R | E D N C G J R L;V
L Z C X W A S I D | C L I Z A S W X;D
W E B V M L J N A | E N W A M L B V;J
P E K A B Y S U G | U G A B Y P E S;K
S L B P R I Z E F | S I P R L E B Z;F
E H J Z O U T Y X | Y X E H U T J Z;O
A I B K S J L O U | L S A K J O I U;B
F U K R C P W Y X | P R Y F K U X C;W
T N W Y S G F X C | N G S F X Y W T;C
U Q C S F Z G D W | D Q S F C Z W G;U
B J H D E C Y P K | K E H D J C B Y;P
N H G B T Z O V E | E T H N V G Z B;O
Z R S U F P V E N | U N R P Z V S E;F
Y P V B Q U T W A | T Q V W Y U P B;A
C F U J E Q M B N | N U J F B Q M C;E
G H U A L P B O X | U B A X H L G O;P
D W C Y E R X T Z | W D R Y C Z E X;T
C X K U F Y H Z S | Y Z H X C S K F;U
W E J H S P L I U | J P S L W U H I;E
O F S P G E C W B | B P F S G O C W;E
L E J W B M Z N K | L M E B J N Z K;W
S O R Q Y H Z W N | O W Z R S H Y N;Q
E T I P G J X S M | J M I S G X E T;P
L T A D C F V Y O | T Y F D V A O C;L
L K A S E H M W O | H L M A K W S E;O
X S B N A K Y H P | K H N S X A Y P;B
V I Q H S K P N M | S Q M I V P H K;N
Q R S C K F Z O B | F R Z Q S O K B;C
Y S P F N L O M T | P N O Y M T L F;S
M K J W Z V U N Y | J V N M K Z W Y;U
R Q Y P V F Z X K | Y P Q V R F K X;Z
T O V W P G L Z C | C T Z G W V P L;O
O Z F J V W N A S | J A Z S O V N W;F
C U M Q I Z W N F | N I M Q C Z F W;U
Q Y G Z A C I F N | Q A G Y I F C N;Z
N F X T I D E Y S | D N S F E X T I;Y
J U Z H O S G C Q | O U G H Q J Z C;S
B G L C D J Q F R | L B F C Q J G R;D
V R Y B T N F J E | R F Y E N V J T;B
G C B N I L Q U Y | B N I Y U Q G L;C
O W D M E S R T Y | S T M O R Y E D;W
H N D Y K M Z J B | N M B Z J Y H K;D
P K R Z X H W Y G | G Z P X W R K Y;H
T I N X V H J G Z | T G J H V Z I X;N
D R M V H E Q X Y | X H D E V Y R M;Q
G X Z A R M S Y D | M D Y X S R Z A;G
I T J X Y F D B E | B D Y J F E I X;T
Y K S P R W F I J | J W K S Y F P R;I
P R Q H V E L Y I | I Q V R H L Y E;P
S C Y I N E U V G | V C N S G U I Y;E
R D J W T Y G S A | W Y G D A J S T;R
H Y M A L G N E W | Y L H E A N M W;G
K U C T F E Q Z X | T U X Q F Z C E;K
X B J H I O C U D | I J D U C B X H;O
C D L G R Z Q J F | C L J F G Q R D;Z
V Q P L Z E S N I | I L Q S E P N V;Z
F Y Q Z C V A N T | T Y Z Q C N V F;A
Z G E Q X C O L M | L C E G Q M O Z;X
W H T V L I F C Q | W H V Q C I T F;L
R H G D U N E Q C | H D U N R G Q C;E
G J P N O E V L M | L O P J G E M V;N
M V K J H F L E A | V F M K E L J H;A
F E X P Z J H W U | U P W Z H J E F;X
U X T N V F J P B | B F V X T J U P;N
I W F V L R Q K T | T W F Q R L I V;K
U J Z W N O Q R D | Z Q W R D J O N;U
W D U O B P V Q H | O B P H U Q V W;D
X A D J S K H N F | J K F N X A H S;D
R N F S K U P G L | L S N F U P R G;K
M H U Q W V E Z S | W E H Q M V U Z;S
D J L V O F H Q P | Q H F P J D L O;V
K T R W I N F G U | I N W F G R U T;K
Z M N K B C P W V | Z V W K M N P B;C
X S R L V N H M O | R V N L S O M H;X
P Q B W N U T H R | R N T U P W Q H;B
T M B A K I L G R | A M K I L B G R;T
B P C H N O J E U | E B H P J O U N;C
R B V W C S Z T O | O C T V S W B R;Z
A N O M Y I P X L | M Y P X O A I L;N
X W S C I U N L Q | L I X C S N W U;Q
X B H O U Q E P V | Q U H B X O P V;E
S V K B T P O I U | B I K V U T P O;S
Y P X O T L B J C | T L O J X B P Y;C
Y V J Z U T K E M | Z Y T M U V J K;E
I T F G U M K W H | F W U K T M G H;I
E M G O Q Z H R N | N Q E M O H G R;Z
O W G K Z L A Q N | O Q N A Z W K L;G
D Z O B X I A G Y | G D Y B I A X Z;O
N H K F Y A U C S | S U H A K N C F;Y
G L U F B I P T V | L T G I U F B V;P
V C B M R P N X I | M V X C B I N R;P
T Y I V U C X N R | N T I U R C V X;Y
E V O K N X D A F | K X N O V E D A;F
J L Z D I H V G B | I Z J L B D G H;V
D S M T F Z H C W | Z H F T C M W S;D
I O P Z X E C S G | O P G I S Z C X;E
Z N T W K F M X B | Z F W K T N X M;B
B N I P F D E C K | F D P C N B I K;E
E U V R H X C K J | R V J C U X K E;H
Q P V B X D C H E | E B Q C X D H V;P
Z C S P H F J T D | P S C Z F D T H;J
C L D S E V B T J | E V D J S L T B;C
S A Z F V O M B U | V M O B S F A U;Z
B N W K E T L X F | E T B F L W N K;X
H V B D F M U G T | H M G T V F D U;B
C N K T L S F A I | L T F K A C N S;I
B L C W V A Q Z E | C V B E Z A L W;Q
K T U M O P D I S | D O M U T I S K;P
O Q U I X M G H R | M H U Q O X I G;R
E O T Z S D V A L | T O A S Z E L V;D
U J C T A E W O P | A E T P J U W C;O
M K N U Q P W Z I | Z N U P K I Q W;M
P L B N X W R D S | W P X N R B S D;L
Y C R B H M O S T | C S R B T Y H O;M
W G O M L F P E R | O P L E R G W M;F
H P N Z X E G J V | G H E J Z P V N;X
Y U L Q F M I K T | Q I F T L U M Y;K
V P H G Z A F K L | V G Z A K P F L;H
C X Z P N G S A B | N X G B C P S A;Z
F H R Z I V G S K | F R G H S I Z K;V
J C Z B I A H Y W | B Y I H A W Z J;C
O Q G X J P U W Z | Q Z J G X W U O;P
L U I B P T W Y G | Y U I P G B T W;L
D Z E N M K C B P | E N P Z M K B D;C
V E J N P B F H S | H E J B N S F P;V
I W J X Z C Q V O | Q V W Z O I C J;X
C V G Q S D R E X | E X R D C Q G S;V
D O P M C A L Q J | A L M D J Q P C;O
A Q X E J H B K O | H J K E O A B X;Q
R V S W C L U B G | L B C W R S V G;U
T W J U H O X I R | T J H X U O W R;I
E U H S Y I M R Q | M R I Y H Q E S;U
B Z D K T N P L M | M B Z T D K N P;L
D I X A E C Z S J | D I C Z S A X J;E
N O X B I Y J K W | W J N K B I X Y;O
D I Z P K F X M E | F E I K M Z D X;P
U L M X W K G P Q | M X P G L W Q U;K
U I T M C P X K E | P T E I U M X K;C
M R L U K X C N J | K U C L X R M N;J
T U M R W B A S Z | A S W M R T Z B;U
K Y N A H L R V F | L R V A K Y H F;N
Z V R K I C G M Q | R M I C Q K V G;Z
Q Z E M N F L Y D | Z N E M Q D F Y;L
S K U L T Y N P B | K N L B Y U S T;P
H Z J V B Q N Y E | Q H V B Z J N Y;E
A T O Y S W Q J V | Q S V T J Y O W;A
F L W H A U I E C | L W H U C A F I;E
B D Z C T I J A L | D B J C L T I A;Z
W L O X V M T N C | T V W O X L C M;N
V L C R K O E U Y | U Y R V C E K L;O
O W R C E N V J K | N E O C W J K V;R
C Z U A B X O N E | X O A N U B C Z;E
O W E L B Y D V J | B E Y J L W V O;D
V S Z K R W X G Q | V R W K G X Z S;Q
C E F H L S Z R X | Z E H R C L S X;F
X A Y I G V U W K | Y X W V A G U K;I
S O B H L F P V I | F L B O P V I H;S
Z C T H B J L U O | O U T L C Z J B;H
S O G J Q T Y X D | T G D J Q S O Y;X
Y M U L Q O S D H | D U Y O H M S L;Q
C K F D G H R T J | G T F H D C R K;J
V H O N Q C Y S R | O C Q S N Y V H;R
F V O J K L R I B | F J I O V R B K;L
Q K C O Z M W L B | Z K Q B L W C M;O
B P A R V W U Z L | L Z R A W V B U;P
W V F I A D E Y Q | Q E V I A F W D;Y
S H J E Y Z L V I | H S E J V Z L Y;I
E I D Z T G J X F | X T D J I F G Z;E
U R H I Y D X B T | X H I Y U T R B;D
O Z N G M P R Y X | X N G P Y R M Z;O
M Z G F R W X I D | D R M Z X I G W;F
J A U Z N H T L I | N A H L J I T U;Z
H T F G R K X L A | A X F H R L K T;G
D L M U H W K Z A | Z K A U D W L M;H
R J H T Q C K P G | P J T K G Q C R;H
V I L W C Z H S E | W L Z S H V C E;I
V L Z O G H N W U | V N H O W Z G U;L
E X F P H A J O N | X E J O N P A F;H
H M C Z D V I B E | D I M Z B C V H;E
Y F G J R K M Z S | F Y J S K G R Z;M
R H D T J M O I K | I T K R H M D O;J
G S U E T X Y C J | T J Y C S U E G;X
V H D K B O Z R Y | H V Z Y R D B K;O
T Q X L F E K J N | T N X J Q E F L;K
K I X O W T J U D | O J I U K W T X;D
R W L E A H T M N | L A N T H R W E;M
D L B R E S M V H | D V S E M B H R;L
F Y W I Z M A R X | Z W Y M A F R I;X
S R F G O V J P Z | Z J O F S V P G;R
W Z E M G X P H Y | G Z H Y W E P M;X
T Z O L C N H D V | L C H N T O V Z;D
X Z G N Y K B S M | Y B M Z N S X G;K
M Q J V F C W Y L | J F C M Q L V W;Y
M Q V U N W L A P | Q A L W N V U P;M
K O N V F P H U I | U F H O I V P N;K
D T Q Z C E L M N | L E C Q Z D T N;M
M Q V O S X K D U | Q K V D O S U M;X
N E J Z W V A B I | A J B W I N V Z;E
E X Z J K V B A Q | A J B Q X Z V K;E
S H A I Q M B J E | E S H A B Q M I;J
P T A Y W M N K V | P T V N M Y W K;A
V K T I B U X P C | X K U B V I T P;C
G S T R V B Q A M | S T R G A Q M B;V
V J S D I H R L B | J R S H B L V I;D
K W C B Y M G Z L | G Z B L C W M K;Y
C E Z F W U Y B R | R Y Z F C W B U;E
U H T P S E L G A | T E U L P H A G;S
H Z X F A V P Y B | X A H Z F Y V P;B
Z P O N F J S M G | F N P J Z G M O;S
C B M U A V Y Z D | C Z A B U V M Y;D
Q T O X W J B M L | B O X Q T M W L;J
Z U A G L P O I C | G U I O C Z A L;P
X Q I H W T P O Y | I W H X P T Y Q;O
R B H I M X N L F | B M F R H N L X;I
T V I Z R S K Q W | S Q V T I W Z K;R
P L G E Y O R B H | Y O E H L G R P;B
T Q E R Y I A B X | T I X A R E Y Q;B
Z J V U B Q A L X | L U V J Q X Z A;B
F U C S G W E N V | F N C V S E G W;U
Z W Q E V F T L S | W L Q Z F T E S;V
W M E R D O Z L X | R W L Z D E M O;X
T R U N I M L K A | R N K T A M U L;I
J O Y E M G N H X | X O M N G J Y E;H
F R G B Y N V J L | V B F R Y L N J;G
B N M X V D W K A | A N D V W K X B;M
A L I Q F X G O W | X O Q W F A L G;I
H V A S U N B G C | A H B V C G N U;S
T G L W M N S H V | H L G S N T W M;V
P O H T U M C Q D | Q C D T M U H P;O
Y B P X Z L T M F | B X M P Z F T L;Y
O R L W J P G A B | L J W G O A P R;B
S A J Y D V C O N | Y N O J V S D A;C
Z J L A I W E M R | R A L I M E Z J;W
F Q T Z K G N I B | I Z F N G Q K B;T
S U K W N A M Z Q | S N Z M K Q U A;W
M F N W Y H I V L | M W V N Y F I L;H
L R X P Y V H I T | R P Y T H L V X;I
U R M N C Y Q K I | N Q C M K R U I;Y
Y J L N A G R I W | L W Y R G A J I;N
O W K A F S H B T | T F B K S W O H;A
X B C W R U K L I | C W L X U I K B;R
X L J V N G D R W | J N G W V D X L;R
T Z R Y I O L P N | N O Z Y R P L T;I
Q X W R N K B F C | C N Q K F X W R;B
A I L K X M D Q J | A J M L I K X Q;D
N J Q F S E V T Z | T E V J Z N S F;Q
U O F I Z S J N V | Z V S O U J N I;F
H E F V A R J Q C | A E F V J R Q H;C
C I E K T V H S X | I H T C S K E V;X
N J B P L F Y C A | N J L Y P F C B;A
I H B Y N M O F G | G H O N I F M Y;B
B M T A X F P Y I | T A F Y P X I M;B
X C Z G F L Q M P | Q F P M Z G C X;L
C S D W H F T Z M | Z T C F S D M H;W
K O H N Q W I S V | K O I Q W N V H;S
D G K O B P N H L | D O P N L G H K;B
N L R F W M V H G | R L V H N F M G;W
F V I K D Z A C E | V K I A D C Z E;F
U H A R W B T F Y | Y A W R H T U B;F
C U P E B L J R W | B L C J W U P R;E
N U F Y Q L Z M C | Q Z Y M C F L N;U
O R T M Z C F V Y | O T Z V M C Y F;R
D G H U M Q V C J | M D U Q C V J H;G
S K G N V P F M Z | N P S M Z V K F;G
Z I W S O T V C K | Z I C S T O V K;W
A R I C J H V E Z | J R A I V H C Z;E
C V D S K L A Z F | C S F D Z A L V;K
O X B D Y K Q Z C | O C K B Q X D Z;Y
C S Q F L M A T E | M L C E T A F S;Q
J K P Y G F H M U | K H F Y J U P G;M
V G M P Z H S Q W | M V Z P S W H Q;G
T H N G M J D Q U | T D U N H M Q J;G
E U D S Z V B J T | T U B S Z D J V;E
G J H Y Z A L P T | Y P J T L H G A;Z
X O Z L D T E Q F | Q D Z E T F X O;L
B A E L Y S R I Z | A S E B R I Z L;Y
T N V O K I X P M | M P T O X I V N;K
G M B Y E Q N S P | S B P M E Y Q G;N
R A Y W U M V E J | V E Y R A U M J;W
L J A P G F T X Q | G J F X A P L Q;T
M D F H N P Y T E | M D P Y H F N T;E
W Y K X Z G M P O | W Y M O G P K Z;X
U T A F H Z I D V | F I T D A V Z H;U
W J C B D Z O H N | O Z D B J H W N;C
C U I T X Q N Z A | A I N U Q C Z X;T
S O T G K P A V I | T O A V G S I K;P
V T N C J K I Z X | N I Z T K J V X;C
Z R U O C Q P V I | O U Z Q I V R P;C
D N L W F E X T I | F L D W E I X N;T
C O G K I S P T N | K C T S G I P O;N
B W M Y I P D K L | D B Y W L I P M;K
P T R J Q E C B Y | B Q Y J C R P E;T
F G J W N S C M O | F S C W O M N G;J
O Y A E S C G L M | G M E Y L S C A;O
O C J F W D Z K P | J D O F C K Z P;W
A Y U F O G C D R | O Y D G F A U R;C
X Y E V R S M B J | R V M E X S J B;Y
H S Y U E I J B F | J S I E H Y U F;B
I W T X B H Y Q A | Q T W X B Y I H;A
A F N C U H Y V S | N H F Y U V S A;C
Z I R F Y J G D C | Z I G D Y C J F;R
E F S K Q Z D M R | M Q D E S F K Z;R
U D S R K O N V W | V W U O S N K D;R
W Z V X Y E K B H | V H X B K E W Y;Z
M C K Q E Y I L H | Q C M H K E I L;Y
N D U C V K F B L | N K U D C B F V;L
Z N J M O A D E U | Z D A N U J O E;M
R S G O P L Y U Q | O R Q S U Y G P;L
C I V Z D O J A S | V C Z S I A O J;D
D N A L Z S U P T | S N P U Z D T A;L
J B W H P O C T U | T B O J C U P W;H
N A T I J R M K X | M N K X I R A J;T
H B N Y O E A Z M | Z N E Y O A B H;M
O M S L Y Z K X V | O Z V K M Y X S;L
X V N S A D Z C W | D N Z C W X A V;S
M N E T B Q W H Y | Q E B N H M T W;Y
Q Z F E I N X H J | N F E Q H I X Z;J
K Y V L A Q O R G | K V Y A Q L R O;G
X O Y N K Q L J E | X J Q K E N O L;Y
F D N O I U M L X | U M X O F L D N;I
J C R S L Y U K V | J S L R Y U C K;V
U S V N W T D A X | A T W D U X N V;S
H D B Z W S J Y Q | D Y W Q H S J Z;B
I E P F G O Q T A | I E G F O A T Q;P
V Z F C U L K T A | K U C Z F A T V;L
A B D J X Z V U W | U A D Z B J X V;W
O P F E Y Q K T J | Q F E P T Y J K;O
F W O Y C X S N V | N W F C S O V X;Y
Y G O R S C M L N | C M S G N L O Y;R
S D Q K E N A P Y | K P Q S E D A N;Y
O N G E X L V T K | V K T L X G N E;O
H D G V U M S P T | G T V M H D P S;U
E Q U L R V S D C | C Q L R D S U E;V
V D W M N C A B E | B C N D W E V A;M
F C B Z M L N O I | M Z F O N B L C;I
P R E C I J U M O | M R C U E J O I;P
X G E L B D T A U | T G L X A B E U;D
M L H V B S O F E | L E B V H S F M;O
C H U I P T R S M | R U H M P T S I;C
S R J Q B F M X W | M J R W X Q S B;F
L O D P F R J S Y | D O F S L P R Y;J
W K N F T Y R L S | K F T S N W R L;Y
Z U D F A P C R E | Z P R D F A E C;U
I M E T N D Z S R | E N T Z S I R D;M
N K D U P A O S T | U N D O A P T K;S
P C H N Q X F I A | C X I P H Q A N;F
I Y W C P R O T E | O T P R C I Y W;E
Q G P V C K O A E | E G A V O P C Q;K
K Q A M C J Y B I | I M Q Y B A C J;K
Z V P N J U G L R | Z J G U L P V R;N
P Q I O Z A X H U | P U Q Z H A O X;I
B P T L C I U N D | I T D N C B P L;U
Z W H R Y A E T N | N E Y H R Z T W;A
F N X O A P H M U | U N F A H X O M;P
C O P W R A Q T Z | O T Q R W C Z A;P
H I A L S E P Y X | E L H Y S A X P;I
G E T B C O L W D | G W B O E L C D;T
Q V C N A K S X R | A S R N X K Q C;V
Y S E P J B T W O | B O P Y T W S E;J
O W R C E T H A J | E O C H A W J T;R
J L A M T P I C E | P T L J M A C I;E
G K Y O A Z P B I | Z O P G A I K Y;B
N X U A Y T V B J | A U J N X V B T;Y
W F B Q L R E H Y | Y L R W B F Q H;E
R A D C B P G I N | A N G R I B C D;P
N O I Z H S Y E W | Y E S W H O N I;Z
E J B D H C U G N | J H C D E U N G;B
G N D M E A F T Z | Z T G F D M A E;N
V T R Z F I C A X | X F V R C A Z T;I
V C A Q B T P M Y | M P Q Y A V T C;B
T I E D N J G R K | G E D R J I T N;K
C I F V A Q T L Z | Z L A I F C V Q;T
W K O I Z S G N A | Z S K I W A G N;O
H L U B M T K V G | H K T B L U G V;M
H B M W D K L Z Q | K Z M W H B D Q;L
V E R F B Q K T H | R V F T Q K H B;E
R K M U E C X O N | U O K R E N M C;X
E M A J L R X B T | E R T J A M L X;B
E P Z Q L V I K R | P I E Z V K R L;Q
G O E F Q D V T P | V G D F O Q T P;E
X R B Z W V Y D H | B X Y D H R W Z;V
I R U A N H J D X | X H J D R U N A;I
A K B O S F L Z W | W S L Z O K A B;F
S P U J L W B M V | V L W P M S U B;J
F C R H W E K G P | E W K F H R C G;P
C T A F R P Q I Z | F I Z C P T R Q;A
J B G Q R M D U O | U G M B Q R O J;D
K W C O Q S V H D | Q K H V C O S D;W
N T I J A P O G L | P I T A G L J N;O
P Q S R N B M K V | Q N P S B V K M;R
T J O D K Y S A E | J D T Y K O S E;A
D M P R B W C A N | P B W A M R C N;D
Q S H G A P I N J | I G P N A Q H S;J
F L K Q I T M C N | T K F I M C Q N;L
O N M F X L D C T | M T X D O N F C;L
G A L T M U Y H K | G A T M L K Y U;H
T J K N V Y F H C | T F Y V C H J K;N
B M D N R V E Y J | D E M J R Y V N;B
L N J V F M Y R W | W V J F N Y R L;M
T A J O X Z N H L | L A H J T O Z N;X
I Y H E W X Z A V | E H I V X W Z Y;A
L T H P S A B D F | A T L F H S P B;D
D R J U C I V O H | R I H J U C D V;O
Z X D Q U S L I M | U I Z D L Q M S;X
J H I G D W V X M | W V M X H J D I;G
N K W G S D O L Y | G O N S W D Y K;L
Y H I P Z R C U K | K Z U H C P R I;Y
U O S B H C Z E F | F O Z U C S B E;H
A G Y B N S I K F | I A K Y G N B F;S
P L H W M Z I K T | W Z P K L T H I;M
R G C K U P E D N | U N C K R P D G;E
N Z H J M O T F G | O M G H F N T J;Z
P A H O K Y G E B | P O E B H A G K;Y
Q H R C B F G A T | G Q B A C T H F;R
R M S W C X A J V | V R X C M A J S;W
B R N L U F K O P | N K P B L F O R;U
T P X D K G M H F | X T K M H F G P;D
I O Q L X R V N B | O R L X Q V N I;B
H N B O R D Z V S | N S R Z V H D B;O
J G X T H U M L V | J X G V U M H T;L
G K F B V H D U C | K B D G U F V H;C
H U D X R O T Y Z | O T R H Y U Z X;D
A S Y J L Q K G F | K F L A G Q S Y;J
Q K M G O L X S A | G Q L O K X A M;S
T R E K C N B P G | N G R K C T B E;P
D R P I X S W V C | S R X V P I D C;W
U T O F V X N E H | E O V F N X T U;H
X E F C D B W Q V | D B X V E Q C F;W
Z S U T O K D R G | D Z O R K T U S;G
G E K I M R A X J | X G I R M K A J;E
J Y K Q X B Z R H | J X Z Y H K Q B;R
A E F K M B G C H | K A F G M C B E;H
Q R G S J W L V F | V Q J F S R W G;L
M O T E V R L D C | C D R V E T M O;L
V S H R F N C E Z | Z N R E C S V F;H
I U W V B G H E K | H B U V K G W E;I
M G O F B C U T Q | T G M B C F O Q;U
C I Y B A L S T M | L S M B Y C I A;T
O H Z I U K P Q A | A Q Z H P U I O;K
A E P J K U W O Y | O A K E U W J Y;P
T J C Y E V Z W M | Y E M T C J W V;Z
I A P G M N H L K | G P A I L N K H;M
J D A Y Z P Q G L | Y Q P D J G L A;Z
W R C L Z E P S N | E L R C Z N S P;W
I J C V M B T P E | B J C P T E I M;V
O G M N J I Q A Z | I Q Z O N M J A;G
X U L T C F H O M | O C L X H T M F;U
U F S R J V T M O | T O R M J F U S;V
L T B J K I A Q D | I B J T D A Q L;K
T F O N K X Q A H | O K H X A F Q T;N
J B C M T K E U S | C J E M K B U S;T
W Y L D O I V U Z | L V O I W U Y D;Z
R K V M D C A T O | V T R A C O M K;D
C W L B U Q M T H | B U M H C Q W T;L
Q R N O L I T D W | N L W Q R O I D;T
L K R A M D W N Y | D Y A N R M L W;K
Q I U C N H B T D | T N C U H B Q D;I
C G M U Q X B L Z | G B C Q M X Z L;U
F B E U Y H C R G | G R Y H E U C B;F
L J B T S N P Y Z | J Y L N Z T P B;S
E I O B Z H V K W | K H O W B Z V E;I
W M I B L X P K O | W I X P K L O M;B
O B Q Y F U R A H | U Y R H B O Q F;A
T L G A Z F K U C | T K L A C U Z G;F
C I D T J N B R Z | C R Z I D T N B;J
S D M V J N Z G P | Z P G V J N M S;D
J H X Z K W O N F | N K W F J O Z X;H
L R B Q A M T C K | R L C K T Q A B;M
G H P Y A N Z B Q | H Y N B A G Z P;Q
M J P B S C Y L D | M P J L Y D B C;S
T R C Y D N O S Q | D Q O C N R T S;Y
G X P Y F B E T Z | E F B T G X Z Y;P
M X Y T R L Q O F | F X M O T L Q R;Y
F P N K Q J O Y C | Q F N P J K Y O;C
K M H C E D A I R | R A E K I H M C;D
X Y G H Z O K C F | F Z X H G C K O;Y
M N A I B K E Z C | A I C K N Z B M;E
M E P O J Q B C G | M J O C B P E Q;G
Q A K H J W L V F | W H K J Q V F L;A
R L I O Q D F A U | R L O D A I Q U;F
C S Y G F N B J O | S Y F G C J N B;O
F H E I Q K S T O | F E K T O I Q S;H
A F T V O M U I K | T K V A O U I F;M
A Y E Q G K O R D | A O K Q R Y E G;D
J S F P B T H K I | T I K H P F S B;J
B R F T X E C M Y | Y X B M R F T E;C
M V K X P Q G S R | S M Q G R V K P;X
K V Y F B J I E Z | I V Z E K J F Y;B
G D K N L W R P Q | N L K D G Q P R;W
A Q X Y U S V T F | F X Q U Y A S V;T
H L G W Z M D E K | E G W H K D L M;Z
U J R V L K G Y Z | L Z V R J Y U G;K
D G J W H X U E Q | G D X J W U E Q;H
Q W K Y T F C P D | Q Y T C F W K D;P
K A R X N Z O F M | Z K X F R N M A;O
A W Q S L K N H U | L S H N A W K Q;U
N Z S Q M H U F Y | Z Q Y M U N S H;F
O T S W Q Z K I E | W I Z E T S O Q;K
Z F P X R J O Q L | L O Z R X J Q P;F
I H M L J Z U D V | V J I M D U L Z;H
U E G W P K M X D | M X G P U D E K;W
O I A D M U C F S | I M C F A S D U;O
W G M F R V Z Y N | G Z W Y M R V N;F
J A M G O V Z Y S | Z V S M A J G Y;O
K X R J L Y Q D G | G R X K Y Q J L;D
C O L K T Z U N Q | U C L O K N Q Z;T
B G J T O F N I X | B G T N O X J F;I
J K D L H E P B Y | J L K H P Y E B;D
R B D Q Z G W P A | P G Q D B R A Z;W
F M K N X L W Q C | M K F L N C W X;Q
Y B R O L S A V N | N R A Y B O V L;S
W U M Q O K L V P | P K U O W Q L V;M
R X F Y D U M G H | M G F D U X H Y;R
V A Y I Z W X N T | Y A Z I X V N T;W
H R V E Q B A G J | A J B V G H R Q;E
J Z Q F R E I N A | F E R J A I Q N;Z
A U D L E I Q P C | P A U E D Q L C;I
R M S Q C E Y V T | M V Q C E R S Y;T
J I X B O A G T R | T X G I O J R A;B
X V J G M F P E W | M F G V J X W E;P
L K R M C P E S A | R M K C P S E A;L
H Q O Y M D U T X | X M H T Q O Y D;U
W O D F X R A U N | N U D R A W F O;X
B N E C F U V H L | H B F V N C L U;E
C K G R B P A Y I | R B Y C I A G K;P
B T K C I J N Y W | W K Y I B C T J;N
N M W R B L G X U | G U B X L N W M;R
L T C R D P I E K | D K C T R E P I;L
J B Z W U G F R X | W G F B R Z U X;J
M I L Y R U N W C | W M L U N R Y C;I
P S J E Q M O D T | S D Q T O E M P;J
V F W J Y P K U G | V F J P G U Y W;K
Z K I A J H U N V | H V I N K Z U J;A
T O X F B I P C H | O X B F T C H I;P
S G F K B M Z N R | M Z K F B G R S;N
K J R Y E V C U T | K C R V J U E T;Y
L M B P U F O A X | P U B X L O A M;F
Y V D R K S U L T | Y K D L T V R U;S
M I B P X O E U R | U M X B R I O E;P
Z T P U Q M X N C | Q M P T C U Z N;X
Z T C V S W F I Q | I F Q W V C S T;Z
K M V L H T I D C | D L C M H K T V;I
M T J V Y X F U W | X Y M U F T W V;J
K H G J B P U V S | K B H V G J U P;S
T K X Z O Q R E V | V Q K X E R Z T;O
Y O M K G E F H P | H E G K M Y F O;P
C Q M L Z Y N B D | M C D Y Q L B Z;N
I D E G X W M J L | X E J W G I M D;L
V U L C R Q E Z I | Z L I U V R E Q;C
B Y P Z F H N A E | A N E P Z H B F;Y
O E N H A D Z I R | O Z N R D A I H;E
U T W C S J Q I N | U W S C I Q T N;J
X U N P O B Z A K | A Z N O P U B X;K
C V U G L Q X M A | L Q C M A U G X;V
E O R I A B L T F | E O R L A I B F;T
L X W H U I E V Y | U V X I E W H Y;L
O T R I Y Q V P N | R P V T I Y N O;Q
J U Q Y G N L O A | U O Y N Q L J G;A
D G T Z K N H R L | R T K H L G D N;Z
Q H R V N G O W X | O V R N Q G H W;X
W L H X M B K A V | H M A B K W X V;L
W N C L E G Q V X | Q W L V E G X C;N
F G Q T K W O B P | W F O T G P K Q;B
X H R S U M B Q P | Q U M X R H P B;S
B Z R N M Q H G L | M R N Q L H G Z;B
F A C I M G W Q Y | F Y G W M Q A I;C
G H J R T V F W K | J K W T R F H G;V
M O R A Q X K L V | K M A L R Q V O;X
D X F V Z R P M E | E R D F M X V Z;P
P T B R G W Y H A | H B P G W T Y R;A
H L U X N P I Q F | X F L N I H P U;Q
K U J T R L H X M | J R X T K H L U;M
B H I G S L A O T | I A S T H L O B;G
D Z M G S C O V K | G M C S O Z K V;D
C E U D T A H J M | U C A J M D H E;T
J Z D G O X H N E | O J H N X G D Z;E
Y G Z E H A P F I | F Y A P I H E Z;G
Z Y R Q I W P V U | W P Z U V Q I R;Y
Z Q X D F C I B R | I D Z F Q B R X;C
C B G U P Y M S T | S G B T U Y P M;C
N J K X L O I W G | G O W K X J I L;N
T A K Z U R J M H | J H T R M A K U;Z
S C E X G L U D M | G S L E D C M U;X
P E Q C O N F T H | H T F Q P C O E;N
Y D B E G N V U M | D G M B E U V Y;N
Y G J T K C F X A | C A T G Y F J K;X
G D H N Z K P W L | N K P W D H G Z;L
T F U C J W E V X | F W E X U T V C;J
I L E D Q R V T P | I Q T L P D E V;R
J L O V F I P K U | L P F I K V U O;J
L J K Y I S O R H | S O K Y R J L H;I
L S W Q F Z D C B | Q W F S B L D C;Z
I J S G T P V A X | V J X A G S T I;P
G T H Z J Y B E A | E Y A T J B Z H;G
Y T P G L I U E A | P U T I G A Y E;L
E R Y O Q U I A W | O U E Q A W R I;Y
Z J D I M C A N S | A D I M N J S C;Z
C Z R O M T H L W | Z L R H O C M T;W
V S C D K H L R P | P K C V S H L D;R
K L B T E M R N V | E T B L V M K R;N
M Q N H J X Y I S | J Q Y X N H I S;M
E Y C Z T F A O X | T Y C O A F E X;Z
L M O B R I C A K | R B A C L K O M;I
G H I U Q O T B V | T V B O H G I Q;U
G L I K Q B C H Z | C H B Q Z L G I;K
P R S G J I A C Q | A S R P C I J Q;G
I M C E O V G Z U | E G U V C I O Z;M
S L A M I R Z Q E | L Q M Z A E R S;I
S P J O D L X T Z | T O S P Z X D J;L
U Y K O D M Q P A | Y A Q M D P K U;O
E Z Y U F T V L S | L U Y T F Z S E;V
E D J H C U S B I | E D C U J I B H;S
I A P W R V G O S | R I P A O S V W;G
X J S R N K Y H V | K R V X N J H S;Y
V Q A B E I H W Z | B E H A Z V W I;Q
C G W D H R J P I | H W I R C P J G;D
E K F T U B J Y V | T Y U V B K E J;F
U O K R J S B X F | U R F J O S B K;X
A J D R C F B E S | C A R F J D S B;E
B R K I J M A F D | J R M B I F A K;D
A L C Z K T R Y J | A Y R L J Z K T;C
A V N M P D S F T | N F D S P M V A;T
V S L K W R A F E | V W S L E F A K;R
H G V L A E Q J Z | Z Q L E J G H A;V
G Q W H J B N Y K | J W H N K G Q Y;B
K C Z U B T X R W | B U K X T C W Z;R
E U T R Q S Y N J | U R J Y N E Q T;S
F N E A K Z M W C | M W N A K Z E F;C
L Q J V R D A K F | V F R A K L J Q;D
M H O A C P R Y L | Y C R O A P H M;L
U X D P M B C O K | D O C X M U K P;B
M Y F O W N Q T E | N F Y E M T Q O;W
O K Y E M C Q N A | M O E K N Y A C;Q
C T R H W D M K A | H T A W R M D K;C
L Y X J H T I B A | I H B X Y J A T;L
U N I J G B K Y M | N K J Y U B G I;M
E T O I D Z M R S | I O E D M Z R S;T
P Y A W U M X K N | Y P U K W A N X;M
Y C P I S V W A B | W A C Y P V I S;B
W U Q I Y M E S K | M Y I K Q S W U;E
A C B V Q W T J G | J B W G T Q C A;V
X Q A O R F J V C | X J R A O F Q C;V
J L D Q K U H W E | U L D W Q E J K;H
Q D U W I O P E T | P U D W O I Q E;T
X I A W F D O L H | A X F L H O W D;I
K T Z Y S P Q D A | Y K T Q D Z S A;P
Z B K A J W S I O | A J O K W I S Z;B
W I V D E M R T K | W D E M T I K R;V
N T Z W X R I S G | G Z T N I X S W;R
Z Y V O K B C N S | B Y C V Z N O S;K
H K P A I L Q G E | H K P I G E A L;Q
T H E D G U B C W | D W C T B H G E;U
F L K N W B P C R | R K B L C F W P;N
U G Y D N R B X T | R N U T G D B X;Y
C F W O Y K G M J | Y M C G K O F J;W
C V G D P N A M W | A W N V G C M P;D
J B R C E W Q Y O | W O J R B C E Q;Y
A F G J P H N L V | J L A P N H V F;G
J G I P O R B A D | B I G R A O J P;D
P J F T Q V B L G | J F B L G Q P T;V
X U F L J N V R W | U L X R N F J W;V
F D A S E X Z M J | S M J E F D A X;Z
J Q C F P E Z W N | E N Z W C P F J;Q
X N L U P W A J E | X J N A E P L W;U
F S U C R N J O B | J N R O U F C B;S
B L C I J G Y X M | X B Y M G J I C;L
B S A Y F M R Q W | Y A F Q M B W S;R
E R G D T W N Y M | W M D T E G R Y;N
Y K U G O N S D A | N O D G K A U S;Y
R M G F X S U A P | G P U S X A M F;R
E G O W J C Z Q U | Z G J U C W O E;Q
X Y H Q R N D V K | N Y X V R H K D;Q
L J E N H O Y Z X | Y H X N E O L J;Z
V O I M K X H G N | X I V H O M G N;K
D J I S C F V Q T | I Q F C V T D S;J
O E D L U C K P M | O U C D L E K P;M
L W Q E F V O R J | V W O J L R F Q;E
F S A P T V D U L | F T D U L S A V;P
V S W F Q U P D A | A D V S P W U F;Q
E J T B W R Q S P | W B J E P Q R T;S
I Q S M P B A E C | A Q S E P I B M;C
E S I L T G H Q D | T S L H I Q G E;D
M S C D W L Z E X | X C D L M Z W E;S
Q E X V P J T R M | J P X V Q R M E;T
T F H N J Y Q C I | Y I N H T Q F J;C
C T I E P U W O X | C X P W U T I E;O
X V K I B F S P Y | P I S V F X K Y;B
P O I G X A H D J | D H G J P I O X;A
J V R K Z P Q F C | F V P C J K Q R;Z
B G J I O F L H C | G F L O B I H J;C
Z F K U S R G P B | S K P U Z F G B;R
Z P F B Y G C W K | K C W Y P F B G;Z
P D S H Q N K A Y | Y S A P K N D H;Q
U S I V L B G F C | I C F B S L U V;G
A Y C K R X F H D | H D Y R C K X F;A
T G I E L S W J Q | Q L S T G J E I;W
G U D J X Y B M K | K M B X Y G U D;J
Y S N O E A B U D | N S O D U A B E;Y
W X N P A U G M I | I G P X U M W A;N
O Z D R J P M H U | J M Z H D O R U;P
F Y N L Q T P K U | L Y U F N T K Q;P
M N B L W T O V S | O S W N T M B V;L
D G O T H F Z N M | T H M D N O F Z;G
D T H J Z E Q X F | D Z Q E H X T F;J
Q A R Y E X I L U | Q A Y R X I U E;L
X J Y G P D T Q O | T D G Q O J P Y;X
W P R C D U H K N | K W C U P N D H;R
K E F J I L M R V | J I L E M K F R;V
G B N Q E L M K J | J K B N Q G E L;M
E S B V Y L W F U | E B L V F Y W S;U
T C L A F M S W Q | S C W L T M Q A;F
C Z P D R V F E S | V Z R C E F D P;S
M J O W I D E G H | E M H G I D J O;W
C U A N F T Y H Z | N C Z A F H T Y;U
G R M O N K Y S W | R Y W O N K M G;S
Q E J B A F Y U H | U H B Q E A F Y;J
P M B U K D W H G | B K W U H P D M;G
B Q N V G F U R M | V B Q N F M G U;R
L U P X V Z W A I | U X Z I P W L V;A
Y O X H M E F C K | Y E C K X F O H;M
N Y K P A L S U X | U K P A X N S L;Y
U O E H L X N C K | N L K C X U H O;E
I X W O Q R Z J P | X W O P Q Z I J;R
I A J L H G B O W | O G L I B W J H;A
O L K E G J W I S | O E L W J G S K;I
T F V E Q O J N I | F I T V J N E O;Q
H U W A O X N C E | U C N A X O H E;W
O A J N U M T K D | U O K M J A N T;D
O I Y G U C M S A | A I M Y C S G U;O
Z Q J I F D R P S | P S F R Z D Q I;J
N A E O V G Y J U | V E Y N G J O U;A
O U Y J Q D Z H I | Q Y O J U I D H;Z
R C W Y G B P L M | P W Y R C B L M;G
N F Z P X V I G R | P N F I V R G Z;X
P J K Y F H U L W | L K P J Y F H U;W
T H Y B C G M K I | B H K G T I M C;Y
L Z P E B C N G Y | E B Y N Z C P G;L
P L T C N H K R Y | K R C T P H Y N;L
L Q N F H O U P I | P O Q N H U F I;L
H C L E K R N W U | W N H C R U K E;L
F C J Z T K G S V | C T V Z S J F G;K
R B X S E D F N W | B N D X S W E R;F
Q Y I A J F T X H | F H J X Y Q I A;T
L U I N J T F Z E | L U E I J T Z F;N
Y G F R K Z L S P | Z P Y K F L R G;S
D Z S E I M V X A | V S D E I M Z X;A
F V P X Z L C I G | V Z I L G X P F;C
D V U K Z G B E C | U V E B C Z D G;K
D M U Z G K S E N | K U N E D S M G;Z
F A M Y X U Z S Q | Y Q M S A Z F X;U
H K T L P W G V S | H W L V P G S K;T
V W U Z R H A T C | H R U Z T W A V;C
V J I Y S F K M E | F M J S Y K E V;I
F H U V K J I Y A | A F I U K V J Y;H
K V S C L J T Y F | F J Y S T K V C;L
F M N A U D K P G | N P F K G U M A;D
W G M J S F B L Y | W J B G M S F L;Y
N Z E X M F I H O | I M H F Z O E X;N
K Z M V L O Y R W | M R O W L Z V K;Y
U W P K D N B V J | U N P J W K B D;V
E D Z U B P K R I | U P R K Z B D E;I
S D Q E U M Z W C | S Z E M U C W Q;D
Y S T N H M L K W | Y M S H W K L N;T
E U T B O F I S N | F B N T E U S I;O
N W Q O I T R D Y | D W O Y R N Q I;T
X Y F H U N T C L | F N H U L X C T;Y
I K U T V M Q A N | T A I K V U N Q;M
U P Q M C R S E T | P Q T M C R U E;S
K W L Q Z U D C G | Q L W K D G U C;Z
S D F Q T H G E P | T Q P E S H D F;G
C R H O J S E M G | G E J O H R S M;C
N E M I T V W Y K | I W N T V E K M;Y
Q Z B A D G H S I | G Q Z B D S H A;I
B U R M A P J T W | J T A B W P M U;R
G T F K W Y O C E | K W C T E F O Y;G
U Q P Z M S B V O | Q B Z U M P O V;S
W Q U F K P Z A B | B U P W K Q F A;Z
A W H C K E U V N | U V E C H W N K;A
J C L K T W Q F O | F T W O C J L Q;K
P Q L I A U N M K | P K U A I Q N L;M
I P Y K Q V L F M | K L V Y F I P Q;M
U I T K O J E L V | T E U O J I K V;L
K C E S R Y X I H | X C K R E H Y I;S
M L R E U I J G D | U M L J D G I R;E
Z M T Y P K Q N X | M T Z K X N Y Q;P
Q H C B D I L N G | Q L G B D N H I;C
N M S X C O P W G | O N G M C W S X;P
W M F S C H N E I | M E F W C N I H;S
G L A I D E B J N | J G L D A N B I;E
N G T M X D A H Q | A M Q G H N T D;X
X B I K W S F Q D | Q X W S D B I K;F
C K T L B G P M Z | K G Z P M C L B;T
I Q K Z B O F W N | F N O Z K W I B;Q
C Q S M J P R B A | B S M C A Q R P;J
E K I M F G C R B | K C R F M B E I;G
W G U R O B Q J S | Q J B O U W R G;S
K P V Q N E A M X | P M X V N Q K E;A
C V T S E O Y N R | Y S V C O T E N;R
J K T F D Q U M I | K U F D T I M J;Q
X L Y W A T F Q V | V Y T A F W Q X;L
L U H I D C E P M | I L M U P H D C;E
Z T J D N C L X V | C T J Z V X D L;N
S P J E F V B G Z | P Z V B F J S G;E
V I B D S Q L G P | G Q D V I B P L;S
D E T X M B H I Q | E T H Q M X I B;D
H O X Q U F J B P | O X P F U B H J;Q
D V J A T C R L O | O V L C D J T A;R
Y S J Q R G E A C | G A S R J Q C E;Y
S D W B F E Z L K | D F S Z L W B E;K
I Q K A Y V P N R | P Q I N R Y V K;A
Q K Z G V X W M L | L K Q X W M V Z;G
L U P C M B F R H | U B L P H C F R;M
V M E L J Z X K S | X Z J K V E M S;L
F R V G O N C K T | T R F O N V K C;G
D K O T R P V Y C | T K V P Y D R O;C
Q C X R J N M Y I | Y Q J I N R C M;X
N Z X I F U Y J O | F N O Z J I U Y;X
K E N Q T C Y I Z | K E Y Z Q C N I;T
N Q L X T W H S P | H T N P X Q W S;L
G D F K W I A O Z | A K F W I D O G;Z
I V E P M S F R D | I V R D S F M P;E
T J D N A V B L I | I T B D V J A L;N
H Z F C U S N G X | Z C U F G H S X;N
S Q G D N V O C H | H N V S G D C O;Q
F Z L A O X I E P | L P I E O Z A X;F
Y I M A U N C L T | L A M Y T I N C;U
N M H E C O B G F | N C F B E O M G;H
J P C V F A Q N R | P J C V A F Q R;N
J P H M D W A F N | M N D W J A F P;H
P D X A F Y B G H | B P H A F Y G X;D
Y R F Z P E X I U | F R Z X Y I E P;U
K Z C I S R H Q A | Q Z R S I K C A;H
Q V E R K Y X L C | V L C K Y Q R X;E
J Z S A N D V B M | Z M J S N A D B;V
X Y B C S H J T V | C V H J Y X S B;T
R U I X D A J F T | U D T I X F A J;R
E Q M H F X L R N | E F X R H Q M N;L
R E V U W J X H K | E W R U V X K J;H
X N P L J B W F A | W A J L N B F X;P
D P M N C L R Y S | S N D Y R M P C;L
Y K G F V C Q W P | Q C F K V P W Y;G
J R C M L F G P X | L G P J R F C X;M
Y L T D K P G V E | Y T V G K E P L;D
H Y K L W X T P O | P O L W Y H X T;K
Z X E A W J D K S | K J X W E D A S;Z
A K P S Z U D X W | X K S Z D A P W;U
G U Q W Y N L M V | V G M Q L Y W U;N
I M J Z G V C L W | C V W G I L J M;Z
T K D Z W O B H E | E W O D K B T H;Z
K B Y J H O L M A | Y L A B J H M K;O
L M R S Q I Y T F | S F I R M Y T L;Q
O U H L I G N D W | W N O H L I U D;G
O H F Q Z L T M W | T M W F H Z Q L;O
A O J P Z M G V U | V A G U J P O Z;M
N W D G P F H R T | D R H P F W N G;T
G J I E P T Z F O | P I J G O Z T E;F
V I A S R F T L N | F L S N I R V T;A
O U N H L T X R W | L T N X H W U O;R
R M D P W J Z O T | W Z P M J D O T;R
F M V G C S L E H | H S E F C M G V;L
X M Q Z U W T K G | K Q X W U T G M;Z
V X F T R C G S Z | Z C R X F S G T;V
L Q X D R C O B H | X Q O C B L R D;H
Z K O D B F J G Q | Q B O K F D J Z;G
V E S K N D F X C | X S E N V F D C;K
D Q V B L U X E Y | E X B D U Y Q L;V
D Z H S Q T K O P | S D O T K Q P H;Z
J R F V E N Z O T | F N O T E V R J;Z
V X A U M S T L B | X U L T M S V A;B
C O I K U S E G B | U E K C O I G B;S
R H K U C T Z Q I | Z I K T C U H Q;R
V D O M X J S P U | X O P V S U M J;D
D E N G C T M W B | C E W D N G M B;T
Q B O C F W A K H | K H W B C Q A F;O
C O V T Y Q S D A | C D O V A S T Y;Q
H J B X D P I G O | J G H B X P I D;O
G B S K O L F I V | G K F O V L S B;I
Q U W S I A N R P | N R A S P W I U;Q
Q N F Z D U M E C | E M Z C U D F N;Q
R J N U Y X Z V A | X A R N Z V Y U;J
P Z J D A X Y M U | D X J Y P A U Z;M
T W B Z L C R J Y | R C T Y Z J L B;W
I P E S C G A Z R | I A C R E G Z S;P
Q L V X T C N R J | L T J X C Q V N;R
K P Q A W X M Y B | Y A W K P X M B;Q
L K N Z A V H X O | H O V Z X K L A;N
C P J V M F W X A | J W V P M A X C;F
X K U F R W B N A | X W B N A F U R;K
N F I H R S K B P | K F B R S P H I;N
F W M A K D B C N | C N B K W A M D;F
P U D B O V Y C T | U P Y O D B C V;T
K J A U L O G R X | R O K G U X L A;J
W I X K N F Q Z U | I U Z N K F W X;Q
G V Y D R L P J A | P G A Y V L J D;R
J R G T Z U Y D X | G J T D R X Y U;Z
T O N V A B M L I | T L I V O B M N;A
O P A C T I E V J | E V I P C T O J;A
W J R Z A G V H B | G H J V Z B R A;W
X U B S P Z O V W | U Z S B O W P X;V
R H I V P D J A S | A D H S I R J P;V
H E P Q Y J O I M | I E Y H Q P O J;M
P A W Y G M J L N | Y A G P W N J L;M
X C I V R H O T Z | Z R X O V H I T;C
D P E H V U G Z W | G V P H D U W Z;E
G U A E C D L X R | C A D E L R X U;G
T U S H N P X F M | U N F H M X T S;P
T V M G Q A H U S | H G T V S U Q A;M
K D Q C G T I O A | A T Q D C K G O;I
C L I R M U X J Z | J Z L U M R I C;X
G E V C T R B A J | E V T B J G A R;C
H L D R M B O I Q | Q H B O M D R I;L
F Q N E X K H J T | T X Q J K N H E;F
F P S J M T H Q V | J H T M S Q F V;P
X R S K H A T E M | S K T E A M R H;X
C F Q H P U N V E | E C H P N U Q V;F
M U O Y L B Z W I | M Y Z O B U W I;L
Z D B L F W U H K | F W B K U D L Z;H
O Z U M X D J A B | B J M O A X D U;Z
V D Z C Y R U B P | Z B P Y V U D R;C
Y H G B I S Q R O | H G I Q Y R S O;B
S L R J O I C H E | C S R L I J E H;O
K B U I Y L M O Z | B Z M Y O L K U;I
L X D N O V S U K | N L D K U X O S;V
D U P Q E O Y M F | Y M Q D U F P O;E
A L M E O Y R B K | M Y O B K L E R;A
Z F A Q Y I N L T | A I T F Q N Z L;Y
X T S K H D F A Y | X K D A F Y T S;H
E N S F U I J B K | I U J F K N E S;B
K Y W R O A J I B | J I O K Y B W A;R
T I N H M K G V L | T G M N V I H L;K
P W T J U R Q B S | Q B S W P U J R;T
C Q O Z B L Y A S | A O L B C Y Q Z;S
J Y D A B G I E T | G D T I J A B Y;E
Q C U L E M J G R | C E G M R Q L J;U
S B O E K G R D L | S O B D R K G E;L
L W P D R V K F A | R K D A P V W L;F
E D N G H Y L U J | E H N D U L Y G;J
H B Y R D L K F M | K F L Y D R B H;M
D R B O K Q V A P | D V A P B R Q O;K
B E K D V Q T Y A | B A Y K V T D Q;E
C H S V K R E Z F | H E S R K V Z C;F
S O I Z X L R E Q | Z S L E Q R O I;X
U X K B L T V O C | K T O X V L U B;C
K U V O L X Q Z E | K V Z U X E L Q;O
J W Z H U K X D L | X W J K U L D H;Z
Z H S D L B M U I | H B D U I S Z M;L
I P R N J K A H X | J H A X P I R N;K
M K C U P W G B O | K C U M P O B W;G
L A H N F U R B W | N R W H F B U A;L
Q H Y F P T J I U | Y J F T H I U P;Q
I A L E H F D X N | A I H X F L N D;E
O Y M F G I W R K | F I O R Y M W K;G
M L D F V G Q A P | V G D A F L P Q;M
D K B F N J L A Y | L Y N F J K B D;A
F Y K R T I L G Q | I R L K G T Q Y;F
T Y C U M R X G A | R X M T C Y U G;A
P J F U Z V X E M | V P M F Z X U E;J
Y S R P A X D K J | R A Y X K S J D;P
V F A T J B Y R N | F A N Y R T B J;V
R X Q S W J Z H C | X Q W J R C Z S;H
O J Y L I N G S U | S Y J G O N I U;L
X E F L I G V B Y | X Y G I F B V E;L
B G T U R V H W Q | H B G Q T U W R;V
I D H U Z V T F G | H U V I D G Z F;T
N T J O C A P V S | O C S N J A V P;T
B T H L W V A C F | W A V H C B T F;L
O B N Q L J Z H S | Z S N H Q L B J;O
P S Z T U G A I D | G D A U P I T S;Z
A D H K P F E O N | A H E O K F N D;P
Z X P D R B V U E | D U Z E R X P V;B
C V A M E H Q I P | E M V A I H Q P;C
O P C Q E W B L V | B E W C P L Q O;V
P S W F H J U K V | F P K S H U V W;J
B V W F I T A C S | A C B T W F V I;S
N S L Q P G I J U | I S G J U P L Q;N
V A J W E F K G H | V J F H A W K E;G
J T C O M A S Y Z | M S Y Z C J O T;A
M X C Q P J F B W | F W P C X Q J B;M
R K I G B H O Y C | O H R G Y C I B;K
U Y T F A W I S X | W X S U I F A T;Y
Y A Q K N X M O E | Q Y M E A X K N;O
J T I F R V H L U | F U J H T L I V;R
M F K J B X E L O | X E F M J L K O;B
N C X U Z I P S B | P C N B U X S I;Z
J Q I O M U E X G | O Q I U E X J G;M
Y C P V G H Q T J | T C G H Q Y P V;J
D N F Y C T P Q G | G Y C P N T F Q;D
H A O G B T Q I L | L H I G T A B Q;O
A I O L N J C V Q | A L C J I V N Q;O
W T U C M L P O D | P W D L U O M T;C
S Z B K A O C I G | A O Z S I G K C;B
X E V P Z S F G A | E S P Z X F A V;G
K J Q X P B D O F | Q F P K D O B X;J
J X P V F U T O M | M O J F V P T U;X
V I T O W P F K X | K I X T W V O F;P
L F C O B N J P R | R L J P C B O N;F
L O E I G F W P M | L E W G O M F P;I
E Q A D G Z J Y K | G A Q Z K J E Y;D
L Z Q H S U F B V | Q U B F V S Z H;L
Q W Z O N Y U J P | J Q P Z O W U N;Y
S I R N E Y M B G | R S B I M E N Y;G
C Q S O E M D U H | H C S E D M U Q;O
E I C U N X Q M S | I S C N Q M E U;X
J R N B G X H E D | B J H R E D X N;G
Z C K P H U N T A | U P N C A H Z K;T
J S D G T N X M O | O M G N J X S T;D
Y J L M H Z B V W | V B L J M Y W Z;H
O Y V J T N F Q E | T V J O E Q F N;Y
L C T N S A Y X J | C T J A N L S X;Y
B G R C E X Y Z H | Z B H G Y X C R;E
D F J P G V K R A | G A J D R K F V;P
O Z R A T S D X L | D X L O Z R S T;A
J L G U Z R I Y W | U Y W R I Z J G;L
X A M F P E T H R | X F M H A E T P;R
K V X E Q C J I Y | C X V Y Q E J K;I
L X F H A S W M I | F H A W S X L I;M
W Z U R P M H C D | W U D R H M C P;Z
E Y Q P A X W T S | T Y P Q X A E S;W
O E A Y C N M J T | C J N M Y E O A;T
R A W T D B H O K | B D T W R H K O;A
X K B T Z V H O N | N H T X V B K Z;O
Z X I Y T L K O V | L V T Y K Z X I;O
V F I M Z Q W K D | F V Q Z D I K M;W
M T K L J B E O U | B K O L E U M J;T
W C S L A K F Z Y | F S C A Y L Z W;K
U W R K H P G S I | S W G I R K H U;P
I O X J R Y L M N | Y X L I O R N J;M
X L G C P W T Y M | G Y C T L M X P;W
M K N P D F T S C | D P M N C F S K;T
M T Q K N R X Z U | R T U N Q M K X;Z
W Z Q B U K J V O | Z V W B O K J Q;U
U F M Y P O N V I | P I F N O Y M U;V
C X A S H Z F I Q | F Z C I X A H Q;S
H F A W B J D G E | A J H G F D E W;B
O G F M T R B Z Y | T M F O B Y G R;Z
T D S H F L G Y M | Y L H F G S D M;T
G M I O K W H R C | K G W C M I R O;H
N E F G U P Z D W | G W U E F P Z N;D
I W J T U O Z K B | B W T J K I Z U;O
R F T A Q B E G I | A F Q E G T I R;B
A Z T U Q L C G B | G L C Z B A Q T;U
M N H D L U Z J Y | L Y H N J Z D M;U
V J D C U M K I P | P M D V U C K I;J
I N C X W Y T H Q | T I Q W H N C X;Y
P C Y B V F H K T | K T P B V Y F C;H
J A W B G P S X D | D X W G P B A J;S
I P S O B N W J R | B O W P N R I J;S
E D I O A J T L K | O A K J L E D T;I
U Z P G F A O C Y | Z O C A G Y F U;P
Y J K R V N T H P | K R H T P N J Y;V
I N X Q M V H T L | I N H L V X T Q;M
G L W D K M Z O A | K M A O W G D L;Z
K B D R C S W M X | W D X K M C S B;R
X O K Q B T D V S | X S T B Q D O K;V
T I G B R H D F X | D I F T G B R X;H
U I H S P A G L J | P G L I J A U S;H
G K F J O X S P W | X F W S O K P G;J
D Y K L A F H E B | L K H F D B E A;Y
H S V T C Y J X W | J W Y X H V S T;C
K D Q E X P A J F | D J K A P E X F;Q
M X P F E Q A T O | Q M P T X A E O;F
Q O C D Y J R H V | R C D H Y O V J;Q
Z R F L G T A K Q | Z K R F A L T Q;G
W U T X J C Z M G | W M U G T Z J X;C
W F M J C G A K D | W F J G M C D K;A
F O H C D I W Q M | H W F C O I M Q;D
U M D V H L W K R | L U W H R M V D;K
D F H Y U A P J L | P Y A H J D L F;U
I H N U O T F L K | I K O T N H L U;F
C S F A E O H I P | H I E F A C P S;O
N Q S I V A G Y C | G I Q V C A Y N;S
Z F Y I K D X W L | Y L Z D X I K F;W
W L R A Y J N G E | W R G E L J Y A;N
Y W Z E U P V A O | A W U O Y V E Z;P
L X P C W J N V R | R N L W J X P C;V
R S J K I A Y M X | X S I R K A M J;Y
K L X F O Z J E N | Z F O K J L N X;E
S B K Y T I W V U | T K B S Y W V I;U
S H Y A P Q M Z J | S J Q Y A M Z H;P
N M T A K X B W I | B N W M K T X I;A
U F B W P G Z H L | W G F P H L U Z;B
V Q T F R M X B I | R F Q T I X M V;B
Z A K D O G R B T | B Z O K D G R A;T
Q M C S G O J F N | S G Q M O N F J;C
V Y J A N G X M Z | Z V A N G X M Y;J
G Y E M A B O S J | O A J E B Y G S;M
W H X V N I M U G | W N H X G I V M;U
M D Q C U F S Z T | Q F T Z U D M S;C
R O J B Y M S T I | J B M R O Y T I;S
P J C T G R Y U L | L J U G C P R Y;T
D K X J Z C W F S | S F K W D J X Z;C
X T C E U M O A I | A U I T X O E M;C
M X R O D V L N Z | V D L O N X M R;Z
C I T N R E J H M | T E J R I N H M;C
A I Z B P R T J N | I A R N Z P B J;T
V Z W G J Q S K F | Z Q W J S F V G;K
E P F V J T M U W | J E T W U F M P;V
H Q U C Y F J X V | H X V U J F Q C;Y
O R N Q W X K D J | D R W N J Q K O;X
C J M D S U L Z T | T D M Z U J S L;C
X K S U I C L H D | S K I D C X U H;L
W V R F C P Y D T | R P V F C D W Y;T
G L K H B X M Y R | R X Y M L K H B;G
D S L H A Q X O K | O A X L Q H D S;K
J E O T M D K P F | P F M J K E O D;T
K L B P M H Z V C | Z B C L M K V P;H
I M C K U Y R S F | I U K M R C F Y;S
I A S X U C Q Z R | Z A R Q C I S X;U
V D P Z R C N L K | V N R P Z K C L;D
V J Q E Y I A F P | P Y Q A J I F E;V
U N C O S T X K P | C O P U N X K T;S
X R C D Q W Y L U | R X L Y D W Q C;U
M J H X S A C R N | A R M S H N X J;C
Z L C O V N F G I | G Z L O F C V N;I
O J I N U P K M W | K M P J O N U I;W
G U H Y I F P Z Q | Y U Z H I G Q P;F
Y T Z W M V G N K | K W T N Z Y V M;G
I M R Z X V B U C | B I Z M C R X V;U
P Y M H S W K N V | Y V H W M K P N;S
A V K Q B L S C T | S Q K A B C L T;V
P V Q J L T C W E | P V Q L T W J E;C
X D O M J H Q S E | O Q E X J D S H;M
A U E D O N L Q B | E O B U L D A N;Q
B N Q G F J A O C | G Q F J C O A N;B
U W L Z R N C D H | U C L R H N D Z;W
I F Z Q G B C Y A | C G Q I B A Z F;Y
X A O W H U N R G | G O H U W A X N;R
D F G Q W V B U C | D U G F Q C W V;B
L G O A W N D Z M | A Z O M N G W D;L
W Y X I C L D V Q | C W Y X D I V Q;L
S T Z E B H M Q D | E M Z H T S Q D;B
I F B Q N Y M J P | N B P F M Y Q I;J
A Y S D M N B Q I | Q N B A Y S M D;I
S E W N F U A I L | L W E S U A I F;N
F T W H X Q O R S | T S Q F R O W X;H
I D Q V E C Z Y U | V Q I C Y U E Z;D
G N D L I P J F E | E G P N J F I L;D
S A Z W Y I H T X | I S Z H Y W X A;T
Q S Z C H D O F V | D F H S Q Z V O;C
M R Y O Z J E G H | H M E Z J G Y R;O
I W A F S L E Y Z | Z I E S W L F A;Y
